Account Number,Balance Date,Balance,Transaction Value,Flow
10005367,2023-01-31,728.25,,-
10005367,2023-02-02,1825.85,1097.6,Incoming
10005367,2023-02-04,1681.1,144.75,Outgoing
10005367,2023-02-04,1748.11,67.01,Incoming
10005367,2023-02-05,1856.37,108.26,Incoming
10005367,2023-02-08,1921.86,65.49,Incoming
10005367,2023-02-08,980.8599999999999,941.0,Outgoing
10005367,2023-02-10,1008.4699999999999,27.61,Incoming
10005367,2023-02-11,871.2199999999999,137.25,Outgoing
10011977,2023-01-31,676.54,,-
10011977,2023-02-02,727.54,51.0,Incoming
10011977,2023-02-03,606.66,120.88,Outgoing
10011977,2023-02-04,796.04,189.38,Incoming
10011977,2023-02-04,737.99,58.05,Outgoing
10011977,2023-02-04,908.55,170.56,Incoming
10011977,2023-02-05,1033.1599999999999,124.61,Incoming
10011977,2023-02-08,899.4199999999998,133.74,Outgoing
10011977,2023-02-10,1002.9699999999998,103.55,Incoming
10011977,2023-02-11,1046.86,43.89,Incoming
10011977,2023-02-14,-53.840000000000146,1100.7,Outgoing
10024680,2023-01-31,567.46,,-
10024680,2023-02-01,720.8900000000001,153.43,Incoming
10024680,2023-02-03,44.3900000000001,676.5,Outgoing
10024680,2023-02-07,136.31000000000012,91.92,Incoming
10024680,2023-02-07,263.7600000000001,127.45,Incoming
10024680,2023-02-08,401.9400000000001,138.18,Incoming
10031238,2023-01-31,576.52,,-
10031238,2023-02-05,686.5899999999999,110.07,Incoming
10031238,2023-02-05,564.8899999999999,121.7,Outgoing
10031238,2023-02-09,600.2799999999999,35.39,Incoming
10031238,2023-02-10,760.8799999999999,160.6,Incoming
10031238,2023-02-10,695.8599999999999,65.02,Outgoing
10031238,2023-02-11,853.8199999999999,157.96,Incoming
10034341,2023-01-31,390.39,,-
10034341,2023-02-03,-1176.21,1566.6,Outgoing
10034341,2023-02-05,-959.0600000000001,217.15,Incoming
10034341,2023-02-08,-848.8100000000001,110.25,Incoming
10034341,2023-02-12,-971.94,123.13,Outgoing
10034341,2023-02-14,-897.22,74.72,Incoming
10079965,2023-01-31,799.27,,-
10079965,2023-02-03,642.92,156.35,Outgoing
10079965,2023-02-08,1085.22,442.3,Incoming
10079965,2023-02-08,1149.1200000000001,63.9,Incoming
10079965,2023-02-08,1281.3200000000002,132.2,Incoming
10091076,2023-01-31,831.83,,-
10091076,2023-02-01,850.6,18.77,Incoming
10091076,2023-02-01,775.15,75.45,Outgoing
10091076,2023-02-01,859.11,83.96,Incoming
10091076,2023-02-05,805.19,53.92,Outgoing
10091076,2023-02-14,815.4100000000001,10.22,Incoming
10091076,2023-02-14,761.69,53.72,Outgoing
10231977,2023-01-31,61.63,,-
10231977,2023-02-01,-54.37,116.0,Outgoing
10231977,2023-02-08,13.940000000000005,68.31,Incoming
10231977,2023-02-09,1424.04,1410.1,Incoming
10231977,2023-02-14,2147.44,723.4,Incoming
10231977,2023-02-14,2068.52,78.92,Outgoing
10232603,2023-01-31,732.55,,-
10232603,2023-02-01,606.8699999999999,125.68,Outgoing
10232603,2023-02-02,1797.77,1190.9,Incoming
10232603,2023-02-04,2686.67,888.9,Incoming
10232603,2023-02-06,2598.4500000000003,88.22,Outgoing
10232603,2023-02-07,2783.92,185.47,Incoming
10232603,2023-02-10,2698.89,85.03,Outgoing
10232603,2023-02-10,3827.29,1128.4,Incoming
10243581,2023-01-31,104.27,,-
10243581,2023-02-04,213.92000000000002,109.65,Incoming
10243581,2023-02-06,292.85,78.93,Incoming
10243581,2023-02-10,209.55,83.3,Outgoing
10243581,2023-02-12,1692.45,1482.9,Incoming
10243581,2023-02-13,1712.6200000000001,20.17,Incoming
10243581,2023-02-14,1847.13,134.51,Incoming
10271519,2023-01-31,50.02,,-
10271519,2023-02-03,151.01,100.99,Incoming
10271519,2023-02-03,-2134.59,2285.6,Outgoing
10271519,2023-02-03,-2229.6400000000003,95.05,Outgoing
10271519,2023-02-03,-2247.2100000000005,17.57,Outgoing
10271519,2023-02-11,-2157.6600000000003,89.55,Incoming
10271519,2023-02-12,-2234.3700000000003,76.71,Outgoing
10271519,2023-02-12,-2333.1800000000003,98.81,Outgoing
10273387,2023-01-31,581.83,,-
10273387,2023-02-03,468.80000000000007,113.03,Outgoing
10273387,2023-02-03,1025.3000000000002,556.5,Incoming
10273387,2023-02-06,844.0600000000002,181.24,Outgoing
10273387,2023-02-07,882.4700000000001,38.41,Incoming
10273387,2023-02-08,1022.9200000000001,140.45,Incoming
10273387,2023-02-10,1094.03,71.11,Incoming
10273387,2023-02-10,955.23,138.8,Outgoing
10273387,2023-02-12,824.55,130.68,Outgoing
10273387,2023-02-14,546.15,278.4,Outgoing
10288821,2023-01-31,642.41,,-
10288821,2023-02-07,794.1099999999999,151.7,Incoming
10288821,2023-02-11,708.6999999999999,85.41,Outgoing
10288821,2023-02-12,480.17999999999995,228.52,Outgoing
10288821,2023-02-14,385.96999999999997,94.21,Outgoing
10295384,2023-01-31,153.85,,-
10295384,2023-02-03,143.20999999999998,10.64,Outgoing
10295384,2023-02-04,239.29999999999998,96.09,Incoming
10295384,2023-02-04,183.32,55.98,Outgoing
10295384,2023-02-06,82.97999999999999,100.34,Outgoing
10295384,2023-02-06,-4.590000000000003,87.57,Outgoing
10295384,2023-02-07,-137.68,133.09,Outgoing
10295384,2023-02-07,-323.83000000000004,186.15,Outgoing
10295384,2023-02-09,-213.82000000000005,110.01,Incoming
10295384,2023-02-11,-151.30000000000004,62.52,Incoming
10295384,2023-02-13,-279.30000000000007,128.0,Outgoing
10350324,2023-01-31,861.81,,-
10350324,2023-02-03,614.17,247.64,Outgoing
10350324,2023-02-04,566.78,47.39,Outgoing
10350324,2023-02-04,485.42999999999995,81.35,Outgoing
10350324,2023-02-07,527.6199999999999,42.19,Incoming
10350324,2023-02-10,618.6599999999999,91.04,Incoming
10350324,2023-02-11,486.46999999999986,132.19,Outgoing
10350324,2023-02-11,366.71999999999986,119.75,Outgoing
10350324,2023-02-13,509.34999999999985,142.63,Incoming
10437896,2023-01-31,661.08,,-
10437896,2023-02-04,712.9200000000001,51.84,Incoming
10437896,2023-02-04,657.6800000000001,55.24,Outgoing
10437896,2023-02-06,588.96,68.72,Outgoing
10437896,2023-02-09,472.62,116.34,Outgoing
10437896,2023-02-11,-634.4799999999999,1107.1,Outgoing
10437896,2023-02-13,-708.4499999999999,73.97,Outgoing
10449180,2023-01-31,228.24,,-
10449180,2023-02-01,179.25,48.99,Outgoing
10449180,2023-02-02,153.44,25.81,Outgoing
10449180,2023-02-06,-630.8599999999999,784.3,Outgoing
10449180,2023-02-11,-706.7399999999999,75.88,Outgoing
10464544,2023-01-31,755.99,,-
10464544,2023-02-01,845.55,89.56,Incoming
10464544,2023-02-07,709.78,135.77,Outgoing
10464544,2023-02-08,577.68,132.1,Outgoing
10464544,2023-02-12,1040.78,463.1,Incoming
10464544,2023-02-14,1122.04,81.26,Incoming
10464544,2023-02-14,134.14,987.9,Outgoing
10473116,2023-01-31,387.7,,-
10473116,2023-02-01,482.61,94.91,Incoming
10473116,2023-02-03,395.15000000000003,87.46,Outgoing
10473116,2023-02-06,1590.0500000000002,1194.9,Incoming
10473116,2023-02-08,1486.5600000000002,103.49,Outgoing
10473116,2023-02-10,1458.3300000000002,28.23,Outgoing
10473116,2023-02-12,1566.8400000000001,108.51,Incoming
10521885,2023-01-31,54.87,,-
10521885,2023-02-01,-72.53999999999999,127.41,Outgoing
10521885,2023-02-01,11.320000000000007,83.86,Incoming
10521885,2023-02-03,-109.00999999999999,120.33,Outgoing
10521885,2023-02-09,-146.14999999999998,37.14,Outgoing
10521885,2023-02-12,-216.74999999999997,70.6,Outgoing
10521885,2023-02-14,-366.93999999999994,150.19,Outgoing
10521885,2023-02-14,-420.28999999999996,53.35,Outgoing
10553619,2023-01-31,756.2,,-
10553619,2023-02-01,868.97,112.77,Incoming
10553619,2023-02-01,796.79,72.18,Outgoing
10553619,2023-02-03,662.8499999999999,133.94,Outgoing
10553619,2023-02-04,1926.75,1263.9,Incoming
10553619,2023-02-05,2016.37,89.62,Incoming
10553619,2023-02-06,3101.77,1085.4,Incoming
10553619,2023-02-11,2227.87,873.9,Outgoing
10553619,2023-02-14,2270.89,43.02,Incoming
10553619,2023-02-14,785.29,1485.6,Outgoing
10554116,2023-01-31,243.95,,-
10554116,2023-02-01,365.78,121.83,Incoming
10586481,2023-01-31,73.83,,-
10586481,2023-02-03,-26.590000000000003,100.42,Outgoing
10586481,2023-02-11,-169.15,142.56,Outgoing
10586481,2023-02-12,-119.62,49.53,Incoming
10586481,2023-02-12,-247.94,128.32,Outgoing
10586481,2023-02-14,-223.05,24.89,Incoming
10608220,2023-01-31,632.92,,-
10608220,2023-02-01,722.3299999999999,89.41,Incoming
10608220,2023-02-01,688.8399999999999,33.49,Outgoing
10608220,2023-02-04,806.0999999999999,117.26,Incoming
10608220,2023-02-05,727.3,78.8,Outgoing
10608220,2023-02-10,783.18,55.88,Incoming
10608220,2023-02-11,925.74,142.56,Incoming
10608220,2023-02-13,1023.9300000000001,98.19,Incoming
10608220,2023-02-13,1142.43,118.5,Incoming
10608220,2023-02-13,1055.64,86.79,Outgoing
10631690,2023-01-31,947.45,,-
10631690,2023-02-03,988.49,41.04,Incoming
10631690,2023-02-03,823.1,165.39,Outgoing
10631690,2023-02-11,974.12,151.02,Incoming
10675607,2023-01-31,284.84,,-
10675607,2023-02-01,399.04999999999995,114.21,Incoming
10675607,2023-02-08,418.15999999999997,19.11,Incoming
10675607,2023-02-14,1326.56,908.4,Incoming
10725127,2023-01-31,984.69,,-
10725127,2023-02-04,2253.3900000000003,1268.7,Incoming
10725127,2023-02-09,2105.0000000000005,148.39,Outgoing
10725127,2023-02-11,2002.9700000000005,102.03,Outgoing
10725127,2023-02-12,2231.4900000000007,228.52,Incoming
10725127,2023-02-13,2389.4800000000005,157.99,Incoming
10769769,2023-01-31,906.91,,-
10769769,2023-02-01,1000.1899999999999,93.28,Incoming
10769769,2023-02-02,1020.91,20.72,Incoming
10769769,2023-02-02,2523.11,1502.2,Incoming
10769769,2023-02-02,2484.33,38.78,Outgoing
10769769,2023-02-02,2581.13,96.8,Incoming
10769769,2023-02-03,2670.6400000000003,89.51,Incoming
10769769,2023-02-05,2729.7900000000004,59.15,Incoming
10769769,2023-02-05,2584.7100000000005,145.08,Outgoing
10769769,2023-02-08,2728.2800000000007,143.57,Incoming
10769769,2023-02-09,2669.4200000000005,58.86,Outgoing
10769769,2023-02-10,2721.2400000000007,51.82,Incoming
10769769,2023-02-10,2806.9400000000005,85.7,Incoming
10769769,2023-02-11,2634.6200000000003,172.32,Outgoing
10769769,2023-02-11,1968.1200000000003,666.5,Outgoing
10783139,2023-01-31,992.98,,-
10783139,2023-02-04,889.1700000000001,103.81,Outgoing
10783139,2023-02-05,981.95,92.78,Incoming
10783139,2023-02-08,1078.28,96.33,Incoming
10783139,2023-02-09,1068.59,9.69,Outgoing
10783139,2023-02-09,1198.35,129.76,Incoming
10783139,2023-02-10,1126.29,72.06,Outgoing
10783139,2023-02-12,1017.2099999999999,109.08,Outgoing
10799356,2023-01-31,915.04,,-
10799356,2023-02-06,787.1899999999999,127.85,Outgoing
10799356,2023-02-06,648.9499999999999,138.24,Outgoing
10799356,2023-02-11,769.93,120.98,Incoming
10799356,2023-02-11,1029.32,259.39,Incoming
10799356,2023-02-12,1123.48,94.16,Incoming
10799356,2023-02-14,2438.1800000000003,1314.7,Incoming
10819898,2023-01-31,750.25,,-
10819898,2023-02-01,646.5699999999999,103.68,Outgoing
10819898,2023-02-02,631.05,15.52,Outgoing
10819898,2023-02-03,722.0699999999999,91.02,Incoming
10819898,2023-02-05,758.1999999999999,36.13,Incoming
10819898,2023-02-08,634.91,123.29,Outgoing
10819898,2023-02-10,739.66,104.75,Incoming
10819898,2023-02-12,641.51,98.15,Outgoing
10819898,2023-02-14,593.68,47.83,Outgoing
10819898,2023-02-14,479.13999999999993,114.54,Outgoing
10842511,2023-01-31,651.77,,-
10842511,2023-02-02,807.6899999999999,155.92,Incoming
10842511,2023-02-13,705.25,102.44,Outgoing
10847941,2023-01-31,40.25,,-
10847941,2023-02-06,104.54,64.29,Incoming
10847941,2023-02-07,248.16000000000003,143.62,Incoming
10847941,2023-02-08,155.62,92.54,Outgoing
10847941,2023-02-10,301.74,146.12,Incoming
10847941,2023-02-11,-792.26,1094.0,Outgoing
10864084,2023-01-31,119.98,,-
10864084,2023-02-02,270.73,150.75,Incoming
10864084,2023-02-02,450.42,179.69,Incoming
10864084,2023-02-05,489.5,39.08,Incoming
10864084,2023-02-06,416.8,72.7,Outgoing
10864084,2023-02-06,261.88,154.92,Outgoing
10864084,2023-02-06,147.07,114.81,Outgoing
10864084,2023-02-10,48.75,98.32,Outgoing
10864084,2023-02-11,-16.400000000000006,65.15,Outgoing
10864084,2023-02-13,1529.1,1545.5,Incoming
10942334,2023-01-31,55.42,,-
10942334,2023-02-05,148.31,92.89,Incoming
10942334,2023-02-07,182.29,33.98,Incoming
10942334,2023-02-10,65.61999999999999,116.67,Outgoing
10942334,2023-02-11,-18.830000000000013,84.45,Outgoing
10949168,2023-01-31,471.8,,-
10949168,2023-02-04,577.69,105.89,Incoming
10949168,2023-02-04,705.4200000000001,127.73,Incoming
10949168,2023-02-07,633.4300000000001,71.99,Outgoing
10949168,2023-02-09,848.19,214.76,Incoming
10949168,2023-02-11,701.24,146.95,Outgoing
10949168,2023-02-12,648.4300000000001,52.81,Outgoing
10949168,2023-02-14,661.86,13.43,Incoming
10989769,2023-01-31,334.18,,-
10989769,2023-02-03,-520.22,854.4,Outgoing
10989769,2023-02-12,-365.66,154.56,Incoming
10989769,2023-02-13,-299.11,66.55,Incoming
10989769,2023-02-13,-401.33000000000004,102.22,Outgoing
11008868,2023-01-31,271.3,,-
11008868,2023-02-02,272.21000000000004,0.91,Incoming
11008868,2023-02-07,480.07000000000005,207.86,Incoming
11008868,2023-02-13,386.51000000000005,93.56,Outgoing
11008868,2023-02-13,289.53000000000003,96.98,Outgoing
11008868,2023-02-14,157.95000000000002,131.58,Outgoing
11026937,2023-01-31,303.44,,-
11026937,2023-02-02,351.15999999999997,47.72,Incoming
11026937,2023-02-02,260.25,90.91,Outgoing
11026937,2023-02-06,345.69,85.44,Incoming
11026937,2023-02-07,420.77,75.08,Incoming
11026937,2023-02-07,513.3199999999999,92.55,Incoming
11026937,2023-02-13,555.5799999999999,42.26,Incoming
11026937,2023-02-14,488.1099999999999,67.47,Outgoing
11061291,2023-01-31,72.7,,-
11061291,2023-02-01,235.11,162.41,Incoming
11061291,2023-02-03,384.65,149.54,Incoming
11061291,2023-02-03,438.07,53.42,Incoming
11061291,2023-02-04,251.12,186.95,Outgoing
11061291,2023-02-08,245.39000000000001,5.73,Outgoing
11061291,2023-02-08,183.98000000000002,61.41,Outgoing
11061291,2023-02-09,303.15000000000003,119.17,Incoming
11061291,2023-02-12,181.29000000000002,121.86,Outgoing
11061291,2023-02-14,260.27000000000004,78.98,Incoming
11067879,2023-01-31,481.56,,-
11067879,2023-02-01,1294.16,812.6,Incoming
11067879,2023-02-01,1107.15,187.01,Outgoing
11067879,2023-02-02,1122.67,15.52,Incoming
11067879,2023-02-04,1041.04,81.63,Outgoing
11067879,2023-02-06,943.9499999999999,97.09,Outgoing
11067879,2023-02-07,1040.8799999999999,96.93,Incoming
11067879,2023-02-07,889.5499999999998,151.33,Outgoing
11067879,2023-02-07,1012.9999999999999,123.45,Incoming
11067879,2023-02-08,1079.3899999999999,66.39,Incoming
11067879,2023-02-11,1166.55,87.16,Incoming
11067879,2023-02-11,993.98,172.57,Outgoing
11067879,2023-02-13,1072.89,78.91,Incoming
11110085,2023-01-31,861.29,,-
11110085,2023-02-03,753.39,107.9,Outgoing
11110085,2023-02-05,-958.8100000000001,1712.2,Outgoing
11110085,2023-02-06,-1056.14,97.33,Outgoing
11110085,2023-02-11,-1165.8000000000002,109.66,Outgoing
11110085,2023-02-12,-1099.5300000000002,66.27,Incoming
11110085,2023-02-12,-1221.89,122.36,Outgoing
11110085,2023-02-13,-1074.22,147.67,Incoming
11110085,2023-02-14,-2472.02,1397.8,Outgoing
11110085,2023-02-14,-2319.18,152.84,Incoming
11150945,2023-01-31,858.83,,-
11150945,2023-02-01,1204.13,345.3,Incoming
11150945,2023-02-01,963.9300000000001,240.2,Outgoing
11150945,2023-02-03,931.86,32.07,Outgoing
11150945,2023-02-03,1120.89,189.03,Incoming
11150945,2023-02-06,1077.3000000000002,43.59,Outgoing
11150945,2023-02-09,944.1400000000002,133.16,Outgoing
11150945,2023-02-09,846.1100000000002,98.03,Outgoing
11150945,2023-02-13,82.9100000000002,763.2,Outgoing
11150945,2023-02-13,209.6300000000002,126.72,Incoming
11228111,2023-01-31,130.36,,-
11228111,2023-02-01,272.56,142.2,Incoming
11228111,2023-02-02,1773.86,1501.3,Incoming
11228111,2023-02-09,1594.2099999999998,179.65,Outgoing
11228111,2023-02-10,1424.7399999999998,169.47,Outgoing
11228111,2023-02-11,1355.6299999999999,69.11,Outgoing
11228111,2023-02-11,1278.09,77.54,Outgoing
11242986,2023-01-31,344.68,,-
11242986,2023-02-01,505.08000000000004,160.4,Incoming
11242986,2023-02-06,526.2,21.12,Incoming
11242986,2023-02-08,619.97,93.77,Incoming
11242986,2023-02-09,564.1,55.87,Outgoing
11242986,2023-02-11,666.26,102.16,Incoming
11251776,2023-01-31,504.02,,-
11251776,2023-02-03,415.08,88.94,Outgoing
11251776,2023-02-04,330.92999999999995,84.15,Outgoing
11251776,2023-02-09,180.70999999999995,150.22,Outgoing
11251776,2023-02-10,248.39999999999995,67.69,Incoming
11251776,2023-02-11,169.31999999999994,79.08,Outgoing
11251776,2023-02-14,1120.02,950.7,Incoming
11302888,2023-01-31,458.83,,-
11302888,2023-02-04,341.23,117.6,Outgoing
11302888,2023-02-05,421.79,80.56,Incoming
11302888,2023-02-06,238.83,182.96,Outgoing
11302888,2023-02-10,258.55,19.72,Incoming
11306584,2023-01-31,522.4,,-
11306584,2023-02-01,470.4,52.0,Outgoing
11306584,2023-02-03,902.5999999999999,432.2,Incoming
11306584,2023-02-07,-296.3000000000002,1198.9,Outgoing
11306584,2023-02-07,-341.6800000000002,45.38,Outgoing
11306584,2023-02-09,-492.82000000000016,151.14,Outgoing
11306584,2023-02-10,-462.21000000000015,30.61,Incoming
11306584,2023-02-11,-526.0400000000002,63.83,Outgoing
11306584,2023-02-12,-2207.9400000000005,1681.9,Outgoing
11306584,2023-02-12,-2136.2000000000007,71.74,Incoming
11306584,2023-02-14,-1435.1000000000008,701.1,Incoming
11333185,2023-01-31,693.23,,-
11333185,2023-02-02,593.65,99.58,Outgoing
11333185,2023-02-06,1270.35,676.7,Incoming
11333185,2023-02-06,1157.1499999999999,113.2,Outgoing
11333185,2023-02-07,2598.05,1440.9,Incoming
11333185,2023-02-07,2411.9700000000003,186.08,Outgoing
11333185,2023-02-10,2479.26,67.29,Incoming
11333185,2023-02-11,2323.4500000000003,155.81,Outgoing
11333185,2023-02-11,2235.0400000000004,88.41,Outgoing
11333185,2023-02-11,2373.5200000000004,138.48,Incoming
11333185,2023-02-13,791.1200000000003,1582.4,Outgoing
11346696,2023-01-31,661.99,,-
11346696,2023-02-04,753.6800000000001,91.69,Incoming
11346696,2023-02-06,829.45,75.77,Incoming
11346696,2023-02-09,942.6,113.15,Incoming
11346696,2023-02-10,1755.4,812.8,Incoming
11346696,2023-02-13,3243.1000000000004,1487.7,Incoming
11359678,2023-01-31,837.17,,-
11359678,2023-02-07,772.01,65.16,Outgoing
11359678,2023-02-07,839.05,67.04,Incoming
11359678,2023-02-11,776.81,62.24,Outgoing
11359678,2023-02-14,851.3399999999999,74.53,Incoming
11360263,2023-01-31,136.79,,-
11360263,2023-02-01,36.769999999999996,100.02,Outgoing
11360263,2023-02-03,-65.03,101.8,Outgoing
11360263,2023-02-03,-195.56,130.53,Outgoing
11360263,2023-02-06,-368.59000000000003,173.03,Outgoing
11360263,2023-02-06,-448.74,80.15,Outgoing
11360263,2023-02-09,-380.49,68.25,Incoming
11360263,2023-02-12,-333.24,47.25,Incoming
11368995,2023-01-31,565.8,,-
11368995,2023-02-01,629.28,63.48,Incoming
11368995,2023-02-02,478.53,150.75,Outgoing
11368995,2023-02-02,619.14,140.61,Incoming
11368995,2023-02-04,740.63,121.49,Incoming
11368995,2023-02-05,833.23,92.6,Incoming
11368995,2023-02-06,781.01,52.22,Outgoing
11368995,2023-02-08,715.95,65.06,Outgoing
11437275,2023-01-31,115.34,,-
11437275,2023-02-05,16.870000000000005,98.47,Outgoing
11437275,2023-02-07,-95.63,112.5,Outgoing
11437275,2023-02-07,48.870000000000005,144.5,Incoming
11437275,2023-02-09,-45.19,94.06,Outgoing
11437275,2023-02-10,67.42,112.61,Incoming
11437275,2023-02-10,167.85000000000002,100.43,Incoming
11438427,2023-01-31,484.08,,-
11438427,2023-02-06,360.31,123.77,Outgoing
11438427,2023-02-07,384.21,23.9,Incoming
11438427,2023-02-08,574.3299999999999,190.12,Incoming
11438427,2023-02-08,2260.33,1686.0,Incoming
11463412,2023-01-31,342.53,,-
11463412,2023-02-07,440.34999999999997,97.82,Incoming
11463412,2023-02-09,-1141.95,1582.3,Outgoing
11475827,2023-01-31,363.88,,-
11475827,2023-02-01,315.49,48.39,Outgoing
11475827,2023-02-07,226.4,89.09,Outgoing
11475827,2023-02-08,271.94,45.54,Incoming
11475827,2023-02-11,-857.96,1129.9,Outgoing
11475827,2023-02-11,-944.82,86.86,Outgoing
11475827,2023-02-12,-1050.8400000000001,106.02,Outgoing
11522216,2023-01-31,590.37,,-
11522216,2023-02-03,546.76,43.61,Outgoing
11522216,2023-02-04,347.35,199.41,Outgoing
11522216,2023-02-10,264.38,82.97,Outgoing
11522216,2023-02-10,157.76,106.62,Outgoing
11522216,2023-02-14,76.38999999999999,81.37,Outgoing
11662506,2023-01-31,573.89,,-
11662506,2023-02-01,741.74,167.85,Incoming
11662506,2023-02-05,638.78,102.96,Outgoing
11662506,2023-02-05,549.06,89.72,Outgoing
11662506,2023-02-09,587.15,38.09,Incoming
11662506,2023-02-09,721.93,134.78,Incoming
11662506,2023-02-11,806.28,84.35,Incoming
11662506,2023-02-14,883.61,77.33,Incoming
11662506,2023-02-14,2281.41,1397.8,Incoming
11694020,2023-01-31,379.2,,-
11694020,2023-02-04,568.92,189.72,Incoming
11694020,2023-02-06,524.49,44.43,Outgoing
11694020,2023-02-09,1888.09,1363.6,Incoming
11694020,2023-02-12,1886.8,1.29,Outgoing
11694020,2023-02-14,1161.8,725.0,Outgoing
11717885,2023-01-31,6.06,,-
11717885,2023-02-05,78.59,72.53,Incoming
11717885,2023-02-13,165.10000000000002,86.51,Incoming
11728970,2023-01-31,711.65,,-
11728970,2023-02-06,626.86,84.79,Outgoing
11728970,2023-02-06,503.25,123.61,Outgoing
11728970,2023-02-09,638.4300000000001,135.18,Incoming
11728970,2023-02-14,545.08,93.35,Outgoing
11736814,2023-01-31,381.51,,-
11736814,2023-02-03,514.5699999999999,133.06,Incoming
11736814,2023-02-05,1305.07,790.5,Incoming
11736814,2023-02-06,1206.21,98.86,Outgoing
11736814,2023-02-11,3057.61,1851.4,Incoming
11744491,2023-01-31,105.92,,-
11744491,2023-02-01,-37.05999999999999,142.98,Outgoing
11744491,2023-02-01,-149.23,112.17,Outgoing
11744491,2023-02-03,-805.53,656.3,Outgoing
11744491,2023-02-04,-660.78,144.75,Incoming
11744491,2023-02-06,-568.39,92.39,Incoming
11744491,2023-02-09,-391.53999999999996,176.85,Incoming
11744491,2023-02-09,-478.68999999999994,87.15,Outgoing
11744491,2023-02-10,-438.98999999999995,39.7,Incoming
11744491,2023-02-11,-524.88,85.89,Outgoing
11744491,2023-02-12,-469.07,55.81,Incoming
11744491,2023-02-13,-584.93,115.86,Outgoing
11744491,2023-02-13,-463.53999999999996,121.39,Incoming
11764022,2023-01-31,286.66,,-
11764022,2023-02-01,403.90000000000003,117.24,Incoming
11764022,2023-02-03,400.25000000000006,3.65,Outgoing
11764022,2023-02-10,313.64000000000004,86.61,Outgoing
11778031,2023-01-31,514.7,,-
11778031,2023-02-08,552.3900000000001,37.69,Incoming
11778031,2023-02-09,616.8300000000002,64.44,Incoming
11778031,2023-02-11,514.7500000000001,102.08,Outgoing
11778031,2023-02-13,-54.84999999999991,569.6,Outgoing
11790056,2023-01-31,49.7,,-
11790056,2023-02-01,145.19,95.49,Incoming
11790056,2023-02-01,25.22,119.97,Outgoing
11790056,2023-02-03,13.219999999999999,12.0,Outgoing
11790056,2023-02-05,105.03,91.81,Incoming
11790056,2023-02-06,152.81,47.78,Incoming
11790056,2023-02-06,841.31,688.5,Incoming
11790056,2023-02-08,750.6099999999999,90.7,Outgoing
11790056,2023-02-08,792.18,41.57,Incoming
11790056,2023-02-09,1761.88,969.7,Incoming
11804173,2023-01-31,353.62,,-
11804173,2023-02-02,234.26,119.36,Outgoing
11804173,2023-02-04,393.67999999999995,159.42,Incoming
11804173,2023-02-04,293.42999999999995,100.25,Outgoing
11804173,2023-02-11,347.02,53.59,Incoming
11826060,2023-01-31,782.13,,-
11826060,2023-02-05,718.81,63.32,Outgoing
11826060,2023-02-07,637.17,81.64,Outgoing
11826060,2023-02-09,599.04,38.13,Outgoing
11826060,2023-02-11,662.87,63.83,Incoming
11826060,2023-02-13,544.2,118.67,Outgoing
11826060,2023-02-13,451.16,93.04,Outgoing
11831265,2023-01-31,292.14,,-
11831265,2023-02-01,383.90999999999997,91.77,Incoming
11831265,2023-02-01,487.30999999999995,103.4,Incoming
11831265,2023-02-01,627.9799999999999,140.67,Incoming
11831265,2023-02-09,726.29,98.31,Incoming
11831265,2023-02-10,636.31,89.98,Outgoing
11831265,2023-02-13,478.31999999999994,157.99,Outgoing
11831265,2023-02-14,563.9899999999999,85.67,Incoming
11836917,2023-01-31,650.14,,-
11836917,2023-02-01,788.3299999999999,138.19,Incoming
11836917,2023-02-12,697.67,90.66,Outgoing
11836917,2023-02-14,609.79,87.88,Outgoing
11836917,2023-02-14,444.23999999999995,165.55,Outgoing
11846043,2023-01-31,915.59,,-
11846043,2023-02-02,846.1,69.49,Outgoing
11846043,2023-02-06,758.28,87.82,Outgoing
11846043,2023-02-07,814.56,56.28,Incoming
11846043,2023-02-10,2454.96,1640.4,Incoming
11846043,2023-02-12,2315.2,139.76,Outgoing
11882775,2023-01-31,299.41,,-
11882775,2023-02-01,405.04,105.63,Incoming
11882775,2023-02-01,1463.74,1058.7,Incoming
11882775,2023-02-03,1344.98,118.76,Outgoing
11882775,2023-02-03,2098.48,753.5,Incoming
11882775,2023-02-05,2014.43,84.05,Outgoing
11882775,2023-02-06,2104.48,90.05,Incoming
11882775,2023-02-06,3896.38,1791.9,Incoming
11882775,2023-02-08,3686.65,209.73,Outgoing
11882775,2023-02-09,2483.75,1202.9,Outgoing
11910409,2023-01-31,241.22,,-
11910409,2023-02-01,321.65,80.43,Incoming
11910409,2023-02-04,400.58,78.93,Incoming
11910409,2023-02-05,322.21999999999997,78.36,Outgoing
11910409,2023-02-05,440.43999999999994,118.22,Incoming
11910409,2023-02-06,493.9699999999999,53.53,Incoming
11910409,2023-02-12,390.1799999999999,103.79,Outgoing
11910409,2023-02-13,277.8699999999999,112.31,Outgoing
11928523,2023-01-31,818.51,,-
11928523,2023-02-05,968.42,149.91,Incoming
11928523,2023-02-07,1045.0,76.58,Incoming
11928523,2023-02-08,1119.38,74.38,Incoming
11928523,2023-02-11,1020.0700000000002,99.31,Outgoing
11928523,2023-02-12,-1188.33,2208.4,Outgoing
11928523,2023-02-13,-1257.0,68.67,Outgoing
12035637,2023-01-31,461.35,,-
12035637,2023-02-02,1241.25,779.9,Incoming
12035637,2023-02-02,2379.25,1138.0,Incoming
12035637,2023-02-03,2415.39,36.14,Incoming
12035637,2023-02-07,2185.08,230.31,Outgoing
12035637,2023-02-07,994.28,1190.8,Outgoing
12035637,2023-02-07,733.46,260.82,Outgoing
12035637,2023-02-08,876.61,143.15,Incoming
12035637,2023-02-08,967.13,90.52,Incoming
12035637,2023-02-08,2136.73,1169.6,Incoming
12035637,2023-02-10,1585.13,551.6,Outgoing
12035637,2023-02-11,1722.44,137.31,Incoming
12035637,2023-02-12,1845.94,123.5,Incoming
12042151,2023-01-31,336.44,,-
12042151,2023-02-03,426.18,89.74,Incoming
12042151,2023-02-05,328.73,97.45,Outgoing
12042151,2023-02-07,227.23000000000002,101.5,Outgoing
12042151,2023-02-09,291.26,64.03,Incoming
12042151,2023-02-11,323.3,32.04,Incoming
12042151,2023-02-11,-948.2,1271.5,Outgoing
12042151,2023-02-13,-886.6700000000001,61.53,Incoming
12088180,2023-01-31,656.51,,-
12088180,2023-02-11,633.89,22.62,Outgoing
12088180,2023-02-12,442.99,190.9,Outgoing
12088180,2023-02-14,488.89,45.9,Incoming
12099406,2023-01-31,681.11,,-
12099406,2023-02-01,776.08,94.97,Incoming
12099406,2023-02-07,1710.2800000000002,934.2,Incoming
12099406,2023-02-10,1854.0100000000002,143.73,Incoming
12099406,2023-02-12,652.9100000000003,1201.1,Outgoing
12099406,2023-02-13,540.9100000000003,112.0,Outgoing
12111805,2023-01-31,890.99,,-
12111805,2023-02-01,780.09,110.9,Outgoing
12111805,2023-02-03,859.44,79.35,Incoming
12111805,2023-02-06,730.5300000000001,128.91,Outgoing
12111805,2023-02-10,915.7400000000001,185.21,Incoming
12111805,2023-02-11,993.5800000000002,77.84,Incoming
12111805,2023-02-13,1196.1200000000001,202.54,Incoming
12111805,2023-02-14,1290.5700000000002,94.45,Incoming
12172627,2023-01-31,550.41,,-
12172627,2023-02-02,413.38,137.03,Outgoing
12172627,2023-02-05,529.54,116.16,Incoming
12172627,2023-02-12,606.05,76.51,Incoming
12185627,2023-01-31,873.23,,-
12185627,2023-02-02,903.75,30.52,Incoming
12185627,2023-02-03,677.86,225.89,Outgoing
12185627,2023-02-04,728.05,50.19,Incoming
12185627,2023-02-05,808.7199999999999,80.67,Incoming
12185627,2023-02-10,601.7499999999999,206.97,Outgoing
12185627,2023-02-11,407.8599999999999,193.89,Outgoing
12185627,2023-02-11,306.9199999999999,100.94,Outgoing
12185627,2023-02-12,379.8599999999999,72.94,Incoming
12185627,2023-02-13,471.6599999999999,91.8,Incoming
12198380,2023-01-31,445.46,,-
12198380,2023-02-03,299.49,145.97,Outgoing
12198380,2023-02-04,165.25,134.24,Outgoing
12198380,2023-02-05,337.0,171.75,Incoming
12198380,2023-02-05,481.38,144.38,Incoming
12198380,2023-02-05,381.33,100.05,Outgoing
12198380,2023-02-07,415.79999999999995,34.47,Incoming
12198380,2023-02-09,270.0899999999999,145.71,Outgoing
12198380,2023-02-12,202.42999999999992,67.66,Outgoing
12198380,2023-02-14,287.79999999999995,85.37,Incoming
12199229,2023-01-31,804.0,,-
12199229,2023-02-11,835.4,31.4,Incoming
12199229,2023-02-11,865.87,30.47,Incoming
12233762,2023-01-31,386.05,,-
12233762,2023-02-05,501.02,114.97,Incoming
12233762,2023-02-06,603.37,102.35,Incoming
12233762,2023-02-07,713.42,110.05,Incoming
12233762,2023-02-07,848.04,134.62,Incoming
12233762,2023-02-10,764.1099999999999,83.93,Outgoing
12233762,2023-02-11,1134.5099999999998,370.4,Incoming
12233762,2023-02-12,983.6499999999997,150.86,Outgoing
12233762,2023-02-14,1160.0199999999998,176.37,Incoming
12240007,2023-01-31,894.48,,-
12240007,2023-02-02,800.5,93.98,Outgoing
12240007,2023-02-04,802.94,2.44,Incoming
12240007,2023-02-05,867.35,64.41,Incoming
12240007,2023-02-05,-881.2499999999999,1748.6,Outgoing
12240007,2023-02-12,-754.1199999999999,127.13,Incoming
12240007,2023-02-13,-191.7199999999999,562.4,Incoming
12241820,2023-01-31,207.29,,-
12388837,2023-01-31,463.31,,-
12388837,2023-02-03,407.84000000000003,55.47,Outgoing
12388837,2023-02-05,591.26,183.42,Incoming
12388837,2023-02-07,525.81,65.45,Outgoing
12388837,2023-02-13,414.43999999999994,111.37,Outgoing
12388837,2023-02-14,326.8299999999999,87.61,Outgoing
12420291,2023-01-31,578.47,,-
12420291,2023-02-03,1802.27,1223.8,Incoming
12420291,2023-02-08,2598.5699999999997,796.3,Incoming
12420291,2023-02-11,2704.0299999999997,105.46,Incoming
12420291,2023-02-12,2774.08,70.05,Incoming
12423613,2023-01-31,459.18,,-
12423613,2023-02-02,2264.68,1805.5,Incoming
12423613,2023-02-04,2169.5499999999997,95.13,Outgoing
12423613,2023-02-14,2095.8399999999997,73.71,Outgoing
12440230,2023-01-31,842.67,,-
12440230,2023-02-07,826.4,16.27,Outgoing
12440230,2023-02-07,1023.52,197.12,Incoming
12440230,2023-02-14,1198.58,175.06,Incoming
12493067,2023-01-31,404.61,,-
12493067,2023-02-03,318.12,86.49,Outgoing
12493067,2023-02-06,203.38,114.74,Outgoing
12493067,2023-02-08,308.7,105.32,Incoming
12493067,2023-02-13,401.74,93.04,Incoming
12493067,2023-02-14,356.78000000000003,44.96,Outgoing
12494185,2023-01-31,762.16,,-
12494185,2023-02-04,859.42,97.26,Incoming
12494185,2023-02-04,788.03,71.39,Outgoing
12494185,2023-02-07,905.3499999999999,117.32,Incoming
12494185,2023-02-07,1002.6399999999999,97.29,Incoming
12499656,2023-01-31,96.27,,-
12499656,2023-02-01,21.179999999999993,75.09,Outgoing
12499656,2023-02-01,-147.66000000000003,168.84,Outgoing
12499656,2023-02-02,-288.23,140.57,Outgoing
12499656,2023-02-03,-176.88000000000002,111.35,Incoming
12499656,2023-02-05,-324.63,147.75,Outgoing
12499656,2023-02-06,-236.41,88.22,Incoming
12499656,2023-02-07,-197.79,38.62,Incoming
12499656,2023-02-10,-350.71,152.92,Outgoing
12499656,2023-02-13,-449.04999999999995,98.34,Outgoing
12499656,2023-02-14,-292.78,156.27,Incoming
12560453,2023-01-31,85.03,,-
12560453,2023-02-01,-62.56999999999999,147.6,Outgoing
12560453,2023-02-05,-133.89999999999998,71.33,Outgoing
12560453,2023-02-05,-285.91999999999996,152.02,Outgoing
12560453,2023-02-08,-333.49999999999994,47.58,Outgoing
12560453,2023-02-08,-277.78999999999996,55.71,Incoming
12560453,2023-02-13,-228.73999999999995,49.05,Incoming
12583269,2023-01-31,910.46,,-
12583269,2023-02-02,785.0,125.46,Outgoing
12583269,2023-02-03,903.33,118.33,Incoming
12583269,2023-02-04,1032.44,129.11,Incoming
12583269,2023-02-05,951.5500000000001,80.89,Outgoing
12583269,2023-02-14,888.21,63.34,Outgoing
12666385,2023-01-31,554.24,,-
12666385,2023-02-01,447.78000000000003,106.46,Outgoing
12666385,2023-02-01,201.64000000000004,246.14,Outgoing
12666385,2023-02-04,-1392.1599999999999,1593.8,Outgoing
12666385,2023-02-12,-1541.7299999999998,149.57,Outgoing
12680102,2023-01-31,674.64,,-
12680102,2023-02-05,716.29,41.65,Incoming
12680102,2023-02-08,113.28999999999996,603.0,Outgoing
12680102,2023-02-09,210.57999999999998,97.29,Incoming
12680102,2023-02-11,1221.18,1010.6,Incoming
12680102,2023-02-12,1127.15,94.03,Outgoing
12680102,2023-02-13,1978.8500000000001,851.7,Incoming
12725274,2023-01-31,26.19,,-
12725274,2023-02-01,-141.66,167.85,Outgoing
12725274,2023-02-04,-266.77,125.11,Outgoing
12725274,2023-02-05,-208.48999999999998,58.28,Incoming
12725274,2023-02-14,-621.29,412.8,Outgoing
12725274,2023-02-14,-458.39,162.9,Incoming
12859818,2023-01-31,151.06,,-
12859818,2023-02-01,61.84,89.22,Outgoing
12859818,2023-02-03,191.22,129.38,Incoming
12859818,2023-02-04,301.52,110.3,Incoming
12859818,2023-02-04,382.53,81.01,Incoming
12859818,2023-02-07,488.77,106.24,Incoming
12859818,2023-02-10,525.68,36.91,Incoming
12859818,2023-02-10,657.06,131.38,Incoming
12859818,2023-02-13,860.43,203.37,Incoming
12859818,2023-02-14,835.54,24.89,Outgoing
12899540,2023-01-31,957.2,,-
12899540,2023-02-01,1040.55,83.35,Incoming
12899540,2023-02-04,915.3,125.25,Outgoing
12899540,2023-02-06,993.77,78.47,Incoming
12899540,2023-02-06,834.73,159.04,Outgoing
12899540,2023-02-10,919.76,85.03,Incoming
12964138,2023-01-31,557.04,,-
12964138,2023-02-01,455.41999999999996,101.62,Outgoing
12964138,2023-02-01,510.90999999999997,55.49,Incoming
12964138,2023-02-06,406.90999999999997,104.0,Outgoing
12964138,2023-02-13,764.21,357.3,Incoming
12985543,2023-01-31,402.94,,-
12985543,2023-02-01,543.21,140.27,Incoming
12985543,2023-02-07,642.72,99.51,Incoming
12985543,2023-02-09,524.3100000000001,118.41,Outgoing
12985543,2023-02-11,467.01000000000005,57.3,Outgoing
12985543,2023-02-13,529.1400000000001,62.13,Incoming
13058003,2023-01-31,218.0,,-
13058003,2023-02-02,253.9,35.9,Incoming
13058003,2023-02-09,1500.3000000000002,1246.4,Incoming
13058003,2023-02-11,1596.66,96.36,Incoming
13058003,2023-02-13,1031.06,565.6,Outgoing
13076932,2023-01-31,419.47,,-
13076932,2023-02-02,544.9300000000001,125.46,Incoming
13076932,2023-02-08,639.84,94.91,Incoming
13076932,2023-02-11,493.81000000000006,146.03,Outgoing
13076932,2023-02-13,357.09000000000003,136.72,Outgoing
13117442,2023-01-31,799.69,,-
13117442,2023-02-02,846.0,46.31,Incoming
13117442,2023-02-05,1010.35,164.35,Incoming
13117442,2023-02-05,908.51,101.84,Outgoing
13117442,2023-02-05,848.71,59.8,Outgoing
13117442,2023-02-08,958.4300000000001,109.72,Incoming
13117442,2023-02-11,-870.47,1828.9,Outgoing
13117442,2023-02-12,-738.19,132.28,Incoming
13167285,2023-01-31,301.93,,-
13167285,2023-02-01,501.92,199.99,Incoming
13167285,2023-02-01,505.81,3.89,Incoming
13167285,2023-02-03,1035.41,529.6,Incoming
13167285,2023-02-03,895.8100000000001,139.6,Outgoing
13167285,2023-02-05,917.48,21.67,Incoming
13167285,2023-02-06,712.62,204.86,Outgoing
13167285,2023-02-07,790.82,78.2,Incoming
13167285,2023-02-09,810.9200000000001,20.1,Incoming
13167285,2023-02-13,910.46,99.54,Incoming
13167285,2023-02-13,1047.3600000000001,136.9,Incoming
13167285,2023-02-14,1008.4400000000002,38.92,Outgoing
13176075,2023-01-31,67.3,,-
13176075,2023-02-04,-60.66,127.96,Outgoing
13176075,2023-02-08,107.11000000000001,167.77,Incoming
13176075,2023-02-12,256.38,149.27,Incoming
13182613,2023-01-31,384.42,,-
13182613,2023-02-05,164.42000000000002,220.0,Outgoing
13182613,2023-02-06,100.93,63.49,Outgoing
13182613,2023-02-08,214.39,113.46,Incoming
13182613,2023-02-09,158.51,55.88,Outgoing
13182613,2023-02-09,237.95999999999998,79.45,Incoming
13197335,2023-01-31,625.71,,-
13197335,2023-02-01,539.88,85.83,Outgoing
13197335,2023-02-01,441.43,98.45,Outgoing
13197335,2023-02-02,534.9300000000001,93.5,Incoming
13197335,2023-02-02,434.32000000000005,100.61,Outgoing
13197335,2023-02-08,354.46000000000004,79.86,Outgoing
13197335,2023-02-09,-689.3399999999999,1043.8,Outgoing
13197335,2023-02-10,-2501.84,1812.5,Outgoing
13197335,2023-02-11,-2286.01,215.83,Incoming
13267945,2023-01-31,299.77,,-
13267945,2023-02-03,197.42,102.35,Outgoing
13267945,2023-02-04,-882.7800000000001,1080.2,Outgoing
13267945,2023-02-07,-964.5300000000001,81.75,Outgoing
13267945,2023-02-08,-1119.13,154.6,Outgoing
13267945,2023-02-10,-1190.24,71.11,Outgoing
13274987,2023-01-31,902.06,,-
13274987,2023-02-01,935.5699999999999,33.51,Incoming
13274987,2023-02-03,988.9999999999999,53.43,Incoming
13274987,2023-02-03,1100.04,111.04,Incoming
13274987,2023-02-04,1193.82,93.78,Incoming
13274987,2023-02-05,1092.6599999999999,101.16,Outgoing
13274987,2023-02-08,-197.5400000000002,1290.2,Outgoing
13274987,2023-02-12,-80.06000000000019,117.48,Incoming
13274987,2023-02-12,-198.6700000000002,118.61,Outgoing
13277127,2023-01-31,793.22,,-
13277127,2023-02-03,775.96,17.26,Outgoing
13277127,2023-02-05,793.89,17.93,Incoming
13277127,2023-02-06,1831.19,1037.3,Incoming
13277127,2023-02-08,1579.29,251.9,Outgoing
13277127,2023-02-08,865.0899999999999,714.2,Outgoing
13322659,2023-01-31,690.27,,-
13322659,2023-02-01,844.17,153.9,Incoming
13322659,2023-02-02,989.4399999999999,145.27,Incoming
13322659,2023-02-04,865.9499999999999,123.49,Outgoing
13322659,2023-02-05,829.18,36.77,Outgoing
13322659,2023-02-05,883.0999999999999,53.92,Incoming
13322659,2023-02-09,968.8999999999999,85.8,Incoming
13322659,2023-02-09,1075.2799999999997,106.38,Incoming
13322659,2023-02-14,1188.7399999999998,113.46,Incoming
13388069,2023-01-31,13.45,,-
13388069,2023-02-07,-121.54,134.99,Outgoing
13388069,2023-02-08,-149.07,27.53,Outgoing
13388069,2023-02-12,-79.08,69.99,Incoming
13426667,2023-01-31,70.47,,-
13426667,2023-02-05,192.17000000000002,121.7,Incoming
13426667,2023-02-08,159.73000000000002,32.44,Outgoing
13426667,2023-02-12,-1064.87,1224.6,Outgoing
13426667,2023-02-13,-162.8699999999999,902.0,Incoming
13459523,2023-01-31,814.31,,-
13459523,2023-02-03,678.7199999999999,135.59,Outgoing
13459523,2023-02-03,1630.7199999999998,952.0,Incoming
13459523,2023-02-06,1802.3899999999999,171.67,Incoming
13459523,2023-02-07,1745.08,57.31,Outgoing
13459523,2023-02-08,846.8799999999999,898.2,Outgoing
13459523,2023-02-10,680.3399999999999,166.54,Outgoing
13459523,2023-02-10,812.6899999999999,132.35,Incoming
13459523,2023-02-13,649.77,162.92,Outgoing
13474543,2023-01-31,438.36,,-
13474543,2023-02-01,317.44,120.92,Outgoing
13474543,2023-02-05,425.31,107.87,Incoming
13474543,2023-02-06,337.98,87.33,Outgoing
13474543,2023-02-09,73.38,264.6,Outgoing
13474543,2023-02-14,-85.70000000000002,159.08,Outgoing
13474543,2023-02-14,-162.53000000000003,76.83,Outgoing
13537427,2023-01-31,556.98,,-
13537427,2023-02-01,504.42,52.56,Outgoing
13537427,2023-02-07,339.72,164.7,Outgoing
13537427,2023-02-11,93.30000000000004,246.42,Outgoing
13537427,2023-02-12,265.43000000000006,172.13,Incoming
13551717,2023-01-31,26.95,,-
13551717,2023-02-01,1387.95,1361.0,Incoming
13551717,2023-02-05,2015.0500000000002,627.1,Incoming
13551717,2023-02-11,2057.9,42.85,Incoming
13551717,2023-02-14,2173.2200000000003,115.32,Incoming
13558846,2023-01-31,598.45,,-
13558846,2023-02-01,548.12,50.33,Outgoing
13558846,2023-02-01,642.1800000000001,94.06,Incoming
13558846,2023-02-04,494.1,148.08,Outgoing
13558846,2023-02-05,642.5600000000001,148.46,Incoming
13558846,2023-02-09,757.6600000000001,115.1,Incoming
13558846,2023-02-13,869.8400000000001,112.18,Incoming
13563384,2023-01-31,952.65,,-
13563384,2023-02-02,912.9,39.75,Outgoing
13563384,2023-02-11,858.62,54.28,Outgoing
13563384,2023-02-12,788.57,70.05,Outgoing
13563384,2023-02-14,1648.67,860.1,Incoming
13584908,2023-01-31,162.0,,-
13584908,2023-02-02,237.16,75.16,Incoming
13584908,2023-02-05,322.21,85.05,Incoming
13584908,2023-02-10,186.99999999999997,135.21,Outgoing
13584908,2023-02-10,268.42999999999995,81.43,Incoming
13610259,2023-01-31,587.73,,-
13610259,2023-02-09,554.01,33.72,Outgoing
13610259,2023-02-10,-101.78999999999996,655.8,Outgoing
13610259,2023-02-11,-192.81999999999996,91.03,Outgoing
13610259,2023-02-12,-92.07999999999997,100.74,Incoming
13687711,2023-01-31,757.76,,-
13687711,2023-02-02,832.87,75.11,Incoming
13687711,2023-02-04,967.98,135.11,Incoming
13687711,2023-02-11,1041.59,73.61,Incoming
13687711,2023-02-13,307.28999999999996,734.3,Outgoing
13687711,2023-02-14,384.11999999999995,76.83,Incoming
13713704,2023-01-31,1.48,,-
13713704,2023-02-02,-90.36,91.84,Outgoing
13713704,2023-02-04,94.02,184.38,Incoming
13713704,2023-02-10,-28.799999999999997,122.82,Outgoing
13713704,2023-02-10,68.23,97.03,Incoming
13713704,2023-02-11,-9.969999999999999,78.2,Outgoing
13713704,2023-02-13,4.120000000000001,14.09,Incoming
13788234,2023-01-31,302.78,,-
13788234,2023-02-06,403.37,100.59,Incoming
13788234,2023-02-07,543.74,140.37,Incoming
13788234,2023-02-07,707.54,163.8,Incoming
13788234,2023-02-08,741.18,33.64,Incoming
13788234,2023-02-10,594.15,147.03,Outgoing
13788234,2023-02-14,481.67999999999995,112.47,Outgoing
13788234,2023-02-14,391.60999999999996,90.07,Outgoing
13945841,2023-01-31,339.81,,-
13945841,2023-02-01,-133.89,473.7,Outgoing
13945841,2023-02-14,-176.91,43.02,Outgoing
13965360,2023-01-31,299.46,,-
13965360,2023-02-11,1954.76,1655.3,Incoming
13997603,2023-01-31,516.79,,-
13997603,2023-02-03,482.06999999999994,34.72,Outgoing
13997603,2023-02-07,429.5199999999999,52.55,Outgoing
13997603,2023-02-07,-358.78000000000003,788.3,Outgoing
13997603,2023-02-10,-288.90000000000003,69.88,Incoming
13997603,2023-02-10,-133.62000000000003,155.28,Incoming
14000447,2023-01-31,443.94,,-
14000447,2023-02-01,346.15,97.79,Outgoing
14000447,2023-02-06,500.56999999999994,154.42,Incoming
14000447,2023-02-09,575.55,74.98,Incoming
14000447,2023-02-10,548.68,26.87,Outgoing
14000447,2023-02-13,603.9399999999999,55.26,Incoming
14000447,2023-02-13,456.27,147.67,Outgoing
14014401,2023-01-31,554.46,,-
14014401,2023-02-06,368.73,185.73,Outgoing
14014401,2023-02-08,328.65000000000003,40.08,Outgoing
14014401,2023-02-09,1877.75,1549.1,Incoming
14014401,2023-02-10,1804.59,73.16,Outgoing
14039438,2023-01-31,94.52,,-
14039438,2023-02-02,-154.18,248.7,Outgoing
14039438,2023-02-03,-271.35,117.17,Outgoing
14039438,2023-02-05,-306.65000000000003,35.3,Outgoing
14039438,2023-02-06,-150.77000000000004,155.88,Incoming
14039438,2023-02-09,-292.1700000000001,141.4,Outgoing
14045416,2023-01-31,265.63,,-
14045416,2023-02-01,319.09,53.46,Incoming
14045416,2023-02-02,166.14,152.95,Outgoing
14045416,2023-02-03,98.78999999999999,67.35,Outgoing
14045416,2023-02-03,187.82,89.03,Incoming
14045416,2023-02-08,230.7,42.88,Incoming
14052052,2023-01-31,915.74,,-
14052052,2023-02-05,1005.26,89.52,Incoming
14052052,2023-02-08,1197.76,192.5,Incoming
14052052,2023-02-09,1710.06,512.3,Incoming
14052052,2023-02-09,2376.46,666.4,Incoming
14052052,2023-02-12,2258.91,117.55,Outgoing
14052052,2023-02-14,2396.64,137.73,Incoming
14086187,2023-01-31,340.59,,-
14086187,2023-02-02,-210.61000000000007,551.2,Outgoing
14086187,2023-02-03,-376.74000000000007,166.13,Outgoing
14086187,2023-02-04,-523.0300000000001,146.29,Outgoing
14086187,2023-02-05,-424.8300000000001,98.2,Incoming
14086187,2023-02-06,-560.6000000000001,135.77,Outgoing
14086187,2023-02-08,-518.0400000000002,42.56,Incoming
14086187,2023-02-08,-576.9900000000002,58.95,Outgoing
14103210,2023-01-31,369.01,,-
14103210,2023-02-04,480.89,111.88,Incoming
14103210,2023-02-06,1625.3899999999999,1144.5,Incoming
14103210,2023-02-06,1626.53,1.14,Incoming
14103210,2023-02-08,1510.1599999999999,116.37,Outgoing
14103210,2023-02-09,1516.35,6.19,Incoming
14103210,2023-02-11,1667.52,151.17,Incoming
14103210,2023-02-11,1537.33,130.19,Outgoing
14103210,2023-02-13,130.62999999999988,1406.7,Outgoing
14136082,2023-01-31,219.84,,-
14136082,2023-02-01,137.66,82.18,Outgoing
14136082,2023-02-02,-389.14,526.8,Outgoing
14136082,2023-02-03,-479.07,89.93,Outgoing
14136082,2023-02-07,-528.83,49.76,Outgoing
14136082,2023-02-09,-654.46,125.63,Outgoing
14136082,2023-02-11,-485.13,169.33,Incoming
14136082,2023-02-11,-445.55,39.58,Incoming
14136082,2023-02-12,-797.1500000000001,351.6,Outgoing
14136082,2023-02-14,-937.95,140.8,Outgoing
14144267,2023-01-31,97.69,,-
14144267,2023-02-06,53.22,44.47,Outgoing
14144267,2023-02-08,-60.900000000000006,114.12,Outgoing
14144267,2023-02-09,-150.33,89.43,Outgoing
14183437,2023-01-31,779.47,,-
14183437,2023-02-02,874.5500000000001,95.08,Incoming
14183437,2023-02-02,844.5400000000001,30.01,Outgoing
14183437,2023-02-03,745.47,99.07,Outgoing
14183437,2023-02-10,-1230.1299999999999,1975.6,Outgoing
14183437,2023-02-11,-1273.3,43.17,Outgoing
14183437,2023-02-11,-1182.45,90.85,Incoming
14183437,2023-02-14,-1302.51,120.06,Outgoing
14253152,2023-01-31,43.85,,-
14253152,2023-02-03,-37.43,81.28,Outgoing
14253152,2023-02-04,73.69999999999999,111.13,Incoming
14253152,2023-02-06,-102.83000000000001,176.53,Outgoing
14253152,2023-02-08,-317.97,215.14,Outgoing
14253152,2023-02-09,-160.84000000000003,157.13,Incoming
14253152,2023-02-11,-30.410000000000025,130.43,Incoming
14253152,2023-02-14,933.0899999999999,963.5,Incoming
14253152,2023-02-14,832.93,100.16,Outgoing
14337606,2023-01-31,561.8,,-
14337606,2023-02-04,615.5999999999999,53.8,Incoming
14337606,2023-02-04,695.2199999999999,79.62,Incoming
14337606,2023-02-06,2487.92,1792.7,Incoming
14337606,2023-02-08,2648.91,160.99,Incoming
14337606,2023-02-09,2807.52,158.61,Incoming
14337606,2023-02-11,2978.24,170.72,Incoming
14337606,2023-02-11,2802.5499999999997,175.69,Outgoing
14337606,2023-02-12,2934.58,132.03,Incoming
14337606,2023-02-14,2858.09,76.49,Outgoing
14355869,2023-01-31,329.16,,-
14355869,2023-02-01,1381.76,1052.6,Incoming
14355869,2023-02-03,1258.37,123.39,Outgoing
14355869,2023-02-04,1773.9699999999998,515.6,Incoming
14355869,2023-02-12,1793.9299999999998,19.96,Incoming
14397662,2023-01-31,363.51,,-
14397662,2023-02-04,301.63,61.88,Outgoing
14397662,2023-02-08,-1499.17,1800.8,Outgoing
14397662,2023-02-08,-1536.8600000000001,37.69,Outgoing
14397662,2023-02-08,-1590.97,54.11,Outgoing
14397662,2023-02-08,-1717.08,126.11,Outgoing
14397662,2023-02-11,-1642.57,74.51,Incoming
14421453,2023-01-31,813.76,,-
14421453,2023-02-01,663.38,150.38,Outgoing
14421453,2023-02-04,619.3199999999999,44.06,Outgoing
14421453,2023-02-04,802.5699999999999,183.25,Incoming
14421453,2023-02-06,735.5699999999999,67.0,Outgoing
14421453,2023-02-08,700.06,35.51,Outgoing
14421453,2023-02-11,802.0799999999999,102.02,Incoming
14448009,2023-01-31,958.46,,-
14448009,2023-02-01,1060.8500000000001,102.39,Incoming
14448009,2023-02-01,1168.8200000000002,107.97,Incoming
14448009,2023-02-02,1046.44,122.38,Outgoing
14448009,2023-02-02,902.3900000000001,144.05,Outgoing
14448009,2023-02-04,2269.79,1367.4,Incoming
14448009,2023-02-08,4048.99,1779.2,Incoming
14448009,2023-02-09,5349.69,1300.7,Incoming
14448009,2023-02-09,5489.049999999999,139.36,Incoming
14448009,2023-02-14,5410.07,78.98,Outgoing
14448009,2023-02-14,5425.049999999999,14.98,Incoming
14505806,2023-01-31,689.25,,-
14505806,2023-02-01,-285.15,974.4,Outgoing
14505806,2023-02-08,-406.87,121.72,Outgoing
14505806,2023-02-09,-304.46000000000004,102.41,Incoming
14505806,2023-02-11,-342.83000000000004,38.37,Outgoing
14505806,2023-02-11,-473.26000000000005,130.43,Outgoing
14505806,2023-02-13,-401.75000000000006,71.51,Incoming
14505806,2023-02-14,-1357.95,956.2,Outgoing
14564252,2023-01-31,263.39,,-
14564252,2023-02-02,396.39,133.0,Incoming
14564252,2023-02-14,554.77,158.38,Incoming
14592080,2023-01-31,245.22,,-
14592080,2023-02-02,95.85999999999999,149.36,Outgoing
14592080,2023-02-02,209.58999999999997,113.73,Incoming
14592080,2023-02-02,280.46999999999997,70.88,Incoming
14592080,2023-02-04,494.27,213.8,Incoming
14592080,2023-02-05,394.7,99.57,Outgoing
14592080,2023-02-06,488.46,93.76,Incoming
14592080,2023-02-07,438.46,50.0,Outgoing
14594928,2023-01-31,470.64,,-
14594928,2023-02-03,615.96,145.32,Incoming
14594928,2023-02-07,492.26000000000005,123.7,Outgoing
14594928,2023-02-10,416.55000000000007,75.71,Outgoing
14594928,2023-02-12,557.2,140.65,Incoming
14600288,2023-01-31,622.77,,-
14600288,2023-02-02,579.22,43.55,Outgoing
14600288,2023-02-02,726.9300000000001,147.71,Incoming
14600288,2023-02-02,867.24,140.31,Incoming
14600288,2023-02-03,778.66,88.58,Outgoing
14600288,2023-02-05,667.74,110.92,Outgoing
14600288,2023-02-08,574.55,93.19,Outgoing
14600288,2023-02-13,712.6199999999999,138.07,Incoming
14600288,2023-02-14,629.5099999999999,83.11,Outgoing
14648004,2023-01-31,236.67,,-
14648004,2023-02-01,314.08,77.41,Incoming
14648004,2023-02-01,221.88,92.2,Outgoing
14648004,2023-02-04,149.01,72.87,Outgoing
14648004,2023-02-04,48.47999999999999,100.53,Outgoing
14648004,2023-02-05,64.71999999999998,16.24,Incoming
14648004,2023-02-07,-50.09000000000002,114.81,Outgoing
14648004,2023-02-07,61.16999999999999,111.26,Incoming
14648004,2023-02-07,40.14999999999999,21.02,Outgoing
14648004,2023-02-08,1370.8500000000001,1330.7,Incoming
14648004,2023-02-12,3179.75,1808.9,Incoming
14648004,2023-02-13,3292.99,113.24,Incoming
14685853,2023-01-31,45.2,,-
14685853,2023-02-01,187.57,142.37,Incoming
14685853,2023-02-04,78.49,109.08,Outgoing
14685853,2023-02-06,-0.8299999999999983,79.32,Outgoing
14685853,2023-02-07,-27.759999999999998,26.93,Outgoing
14685853,2023-02-11,-398.15999999999997,370.4,Outgoing
14723713,2023-01-31,378.07,,-
14723713,2023-02-10,310.51,67.56,Outgoing
14723713,2023-02-10,423.87,113.36,Incoming
14723713,2023-02-11,297.09000000000003,126.78,Outgoing
14723713,2023-02-13,147.18000000000004,149.91,Outgoing
14749214,2023-01-31,194.54,,-
14749214,2023-02-03,145.22,49.32,Outgoing
14749214,2023-02-07,290.74,145.52,Incoming
14749214,2023-02-12,82.93,207.81,Outgoing
14780986,2023-01-31,180.2,,-
14780986,2023-02-01,74.35,105.85,Outgoing
14780986,2023-02-04,-90.03,164.38,Outgoing
14780986,2023-02-06,875.1700000000001,965.2,Incoming
14780986,2023-02-07,742.3600000000001,132.81,Outgoing
14780986,2023-02-07,911.1400000000001,168.78,Incoming
14812157,2023-01-31,534.54,,-
14812157,2023-02-01,-110.96000000000004,645.5,Outgoing
14812157,2023-02-04,23.519999999999953,134.48,Incoming
14812157,2023-02-06,497.2199999999999,473.7,Incoming
14812157,2023-02-09,614.3199999999999,117.1,Incoming
14812157,2023-02-14,734.8599999999999,120.54,Incoming
14840078,2023-01-31,584.16,,-
14840078,2023-02-01,702.4,118.24,Incoming
14840078,2023-02-05,640.03,62.37,Outgoing
14840078,2023-02-06,828.3,188.27,Incoming
14840078,2023-02-07,915.49,87.19,Incoming
14840078,2023-02-09,1017.81,102.32,Incoming
14840078,2023-02-10,807.74,210.07,Outgoing
14840078,2023-02-10,951.84,144.1,Incoming
14840078,2023-02-13,1034.83,82.99,Incoming
14840078,2023-02-14,958.8499999999999,75.98,Outgoing
14866733,2023-01-31,249.35,,-
14866733,2023-02-01,327.13,77.78,Incoming
14866733,2023-02-02,310.39,16.74,Outgoing
14866733,2023-02-03,241.77999999999997,68.61,Outgoing
14866733,2023-02-07,158.09999999999997,83.68,Outgoing
14866733,2023-02-14,251.75999999999996,93.66,Incoming
14866733,2023-02-14,290.15999999999997,38.4,Incoming
14897645,2023-01-31,89.0,,-
14897645,2023-02-01,-24.689999999999998,113.69,Outgoing
14897645,2023-02-09,44.82000000000001,69.51,Incoming
14897645,2023-02-11,96.55000000000001,51.73,Incoming
14897645,2023-02-12,-10.36999999999999,106.92,Outgoing
14897645,2023-02-14,-154.15999999999997,143.79,Outgoing
14907946,2023-01-31,845.72,,-
14907946,2023-02-03,779.35,66.37,Outgoing
14907946,2023-02-07,929.45,150.1,Incoming
14907946,2023-02-07,1014.21,84.76,Incoming
14907946,2023-02-08,884.35,129.86,Outgoing
14907946,2023-02-10,872.62,11.73,Outgoing
14907946,2023-02-12,757.58,115.04,Outgoing
14907946,2023-02-14,918.9200000000001,161.34,Incoming
14907946,2023-02-14,728.7700000000001,190.15,Outgoing
14907946,2023-02-14,630.7400000000001,98.03,Outgoing
14907946,2023-02-14,698.4400000000002,67.7,Incoming
15033812,2023-01-31,504.58,,-
15044055,2023-01-31,204.3,,-
15044055,2023-02-04,110.52000000000001,93.78,Outgoing
15044055,2023-02-06,189.46,78.94,Incoming
15044055,2023-02-09,1623.56,1434.1,Incoming
15044055,2023-02-10,1805.27,181.71,Incoming
15044055,2023-02-14,1643.36,161.91,Outgoing
15044055,2023-02-14,1590.58,52.78,Outgoing
15052808,2023-01-31,786.05,,-
15052808,2023-02-02,-150.05000000000007,936.1,Outgoing
15052808,2023-02-09,-1103.95,953.9,Outgoing
15052808,2023-02-09,-1231.18,127.23,Outgoing
15052808,2023-02-14,56.819999999999936,1288.0,Incoming
15052808,2023-02-14,127.99999999999994,71.18,Incoming
15055504,2023-01-31,339.94,,-
15055504,2023-02-05,510.76,170.82,Incoming
15055504,2023-02-07,617.53,106.77,Incoming
15055504,2023-02-08,594.56,22.97,Outgoing
15055504,2023-02-11,702.05,107.49,Incoming
15055504,2023-02-11,828.1899999999999,126.14,Incoming
15077298,2023-01-31,507.62,,-
15077298,2023-02-01,588.64,81.02,Incoming
15077298,2023-02-01,666.1899999999999,77.55,Incoming
15077298,2023-02-04,590.7099999999999,75.48,Outgoing
15077298,2023-02-04,741.4699999999999,150.76,Incoming
15077298,2023-02-07,787.9799999999999,46.51,Incoming
15077298,2023-02-09,699.8199999999999,88.16,Outgoing
15077298,2023-02-09,756.1099999999999,56.29,Incoming
15077298,2023-02-11,632.0299999999999,124.08,Outgoing
15100785,2023-01-31,934.1,,-
15100785,2023-02-02,908.49,25.61,Outgoing
15100785,2023-02-05,854.0,54.49,Outgoing
15100785,2023-02-06,1003.0699999999999,149.07,Incoming
15100785,2023-02-06,1117.37,114.3,Incoming
15100785,2023-02-07,951.0799999999999,166.29,Outgoing
15100785,2023-02-09,-87.42000000000007,1038.5,Outgoing
15100785,2023-02-11,90.58999999999992,178.01,Incoming
15100785,2023-02-12,-38.220000000000084,128.81,Outgoing
15163829,2023-01-31,458.6,,-
15163829,2023-02-04,338.41,120.19,Outgoing
15163829,2023-02-07,436.05,97.64,Incoming
15163829,2023-02-08,577.08,141.03,Incoming
15163829,2023-02-12,675.3100000000001,98.23,Incoming
15163829,2023-02-13,631.75,43.56,Outgoing
15258886,2023-01-31,689.34,,-
15258886,2023-02-01,814.2,124.86,Incoming
15258886,2023-02-05,969.96,155.76,Incoming
15258886,2023-02-08,1072.99,103.03,Incoming
15258886,2023-02-08,1207.17,134.18,Incoming
15258886,2023-02-10,1160.16,47.01,Outgoing
15258886,2023-02-11,-573.4399999999998,1733.6,Outgoing
15258886,2023-02-12,-438.3899999999998,135.05,Incoming
15258886,2023-02-13,-350.80999999999983,87.58,Incoming
15265650,2023-01-31,147.72,,-
15265650,2023-02-01,1.6200000000000045,146.1,Outgoing
15265650,2023-02-03,83.35000000000001,81.73,Incoming
15265650,2023-02-04,146.89000000000001,63.54,Incoming
15265650,2023-02-05,244.92000000000002,98.03,Incoming
15265650,2023-02-08,255.50000000000003,10.58,Incoming
15265650,2023-02-11,356.36,100.86,Incoming
15265650,2023-02-11,462.02,105.66,Incoming
15265650,2023-02-12,398.01,64.01,Outgoing
15265650,2023-02-13,423.58,25.57,Incoming
15265650,2023-02-14,541.79,118.21,Incoming
15265700,2023-01-31,829.86,,-
15265700,2023-02-01,809.98,19.88,Outgoing
15265700,2023-02-02,893.4200000000001,83.44,Incoming
15265700,2023-02-02,816.3800000000001,77.04,Outgoing
15265700,2023-02-08,1714.5800000000002,898.2,Incoming
15265700,2023-02-12,1623.5100000000002,91.07,Outgoing
15290238,2023-01-31,93.23,,-
15290238,2023-02-01,9.27000000000001,83.96,Outgoing
15290238,2023-02-04,68.4,59.13,Incoming
15290238,2023-02-09,188.17000000000002,119.77,Incoming
15290238,2023-02-13,291.61,103.44,Incoming
15296624,2023-01-31,731.68,,-
15296624,2023-02-01,812.54,80.86,Incoming
15296624,2023-02-01,870.5899999999999,58.05,Incoming
15296624,2023-02-06,717.7599999999999,152.83,Outgoing
15296624,2023-02-09,859.5799999999999,141.82,Incoming
15296624,2023-02-09,755.2499999999999,104.33,Outgoing
15296624,2023-02-14,634.8299999999999,120.42,Outgoing
15324178,2023-01-31,833.62,,-
15324178,2023-02-05,741.84,91.78,Outgoing
15324178,2023-02-07,824.75,82.91,Incoming
15324178,2023-02-08,666.99,157.76,Outgoing
15324178,2023-02-09,1565.0900000000001,898.1,Incoming
15324178,2023-02-13,1699.69,134.6,Incoming
15324178,2023-02-13,1795.73,96.04,Incoming
15334737,2023-01-31,197.12,,-
15334737,2023-02-01,94.91000000000001,102.21,Outgoing
15334737,2023-02-01,-20.22999999999999,115.14,Outgoing
15334737,2023-02-04,-111.91999999999999,91.69,Outgoing
15334737,2023-02-04,-20.219999999999985,91.7,Incoming
15334737,2023-02-06,156.31,176.53,Incoming
15334737,2023-02-07,93.19,63.12,Outgoing
15334737,2023-02-12,6.920000000000002,86.27,Outgoing
15377274,2023-01-31,902.14,,-
15377274,2023-02-04,1026.28,124.14,Incoming
15377274,2023-02-07,1082.7,56.42,Incoming
15377274,2023-02-07,932.6,150.1,Outgoing
15377274,2023-02-12,829.87,102.73,Outgoing
15377274,2023-02-14,694.73,135.14,Outgoing
15428008,2023-01-31,131.02,,-
15428008,2023-02-07,330.88,199.86,Incoming
15428008,2023-02-09,879.18,548.3,Incoming
15428008,2023-02-12,1956.48,1077.3,Incoming
15428008,2023-02-13,2004.3700000000001,47.89,Incoming
15428008,2023-02-14,2166.28,161.91,Incoming
15468532,2023-01-31,819.87,,-
15468532,2023-02-03,860.0,40.13,Incoming
15468532,2023-02-03,1001.04,141.04,Incoming
15468532,2023-02-09,868.29,132.75,Outgoing
15522788,2023-01-31,154.26,,-
15522788,2023-02-01,255.88,101.62,Incoming
15522788,2023-02-02,138.14999999999998,117.73,Outgoing
15522788,2023-02-04,57.13999999999997,81.01,Outgoing
15522788,2023-02-04,-52.51000000000003,109.65,Outgoing
15522788,2023-02-05,-29.380000000000035,23.13,Incoming
15522788,2023-02-06,69.88999999999996,99.27,Incoming
15522788,2023-02-08,3.839999999999961,66.05,Outgoing
15529292,2023-01-31,382.95,,-
15529292,2023-02-01,500.54999999999995,117.6,Incoming
15529292,2023-02-06,424.54999999999995,76.0,Outgoing
15529292,2023-02-12,269.80999999999995,154.74,Outgoing
15563919,2023-01-31,492.34,,-
15563919,2023-02-01,583.05,90.71,Incoming
15563919,2023-02-02,536.5899999999999,46.46,Outgoing
15563919,2023-02-04,362.0399999999999,174.55,Outgoing
15563919,2023-02-05,296.3599999999999,65.68,Outgoing
15563919,2023-02-06,117.5399999999999,178.82,Outgoing
15563919,2023-02-10,80.62999999999991,36.91,Outgoing
15563919,2023-02-14,-1002.3700000000001,1083.0,Outgoing
15665459,2023-01-31,68.94,,-
15665459,2023-02-02,143.64999999999998,74.71,Incoming
15665459,2023-02-03,-390.95000000000005,534.6,Outgoing
15665459,2023-02-05,-458.90000000000003,67.95,Outgoing
15665459,2023-02-07,-620.63,161.73,Outgoing
15665459,2023-02-13,-554.4,66.23,Incoming
15668160,2023-01-31,810.02,,-
15668160,2023-02-05,631.0,179.02,Outgoing
15668160,2023-02-09,787.67,156.67,Incoming
15668160,2023-02-13,585.72,201.95,Outgoing
15732629,2023-01-31,975.81,,-
15732629,2023-02-02,784.3699999999999,191.44,Outgoing
15732629,2023-02-04,1147.07,362.7,Incoming
15732629,2023-02-05,1068.25,78.82,Outgoing
15732629,2023-02-08,923.47,144.78,Outgoing
15732629,2023-02-08,780.32,143.15,Outgoing
15732629,2023-02-12,703.46,76.86,Outgoing
15732629,2023-02-13,2096.56,1393.1,Incoming
15768459,2023-01-31,997.4,,-
15768459,2023-02-02,1151.46,154.06,Incoming
15768459,2023-02-03,1195.46,44.0,Incoming
15768459,2023-02-08,1075.1100000000001,120.35,Outgoing
15768459,2023-02-08,956.5700000000002,118.54,Outgoing
15768459,2023-02-13,816.8100000000002,139.76,Outgoing
15768459,2023-02-13,948.4200000000002,131.61,Incoming
15779976,2023-01-31,129.01,,-
15779976,2023-02-03,249.76999999999998,120.76,Incoming
15779976,2023-02-12,377.03999999999996,127.27,Incoming
15779976,2023-02-14,505.42999999999995,128.39,Incoming
15779976,2023-02-14,606.26,100.83,Incoming
15793232,2023-01-31,45.88,,-
15793232,2023-02-02,166.58,120.7,Incoming
15793232,2023-02-05,-1414.22,1580.8,Outgoing
15793232,2023-02-12,-1471.64,57.42,Outgoing
15793232,2023-02-14,-1492.0500000000002,20.41,Outgoing
15796180,2023-01-31,755.58,,-
15796180,2023-02-07,861.5500000000001,105.97,Incoming
15796180,2023-02-07,974.7800000000001,113.23,Incoming
15796180,2023-02-10,860.19,114.59,Outgoing
15796180,2023-02-12,727.1500000000001,133.04,Outgoing
15801209,2023-01-31,8.84,,-
15801209,2023-02-01,704.14,695.3,Incoming
15801209,2023-02-05,749.56,45.42,Incoming
15801209,2023-02-08,623.53,126.03,Outgoing
15801209,2023-02-13,577.2099999999999,46.32,Outgoing
15801209,2023-02-13,657.81,80.6,Incoming
15801209,2023-02-13,523.0899999999999,134.72,Outgoing
15805500,2023-01-31,230.39,,-
15805500,2023-02-02,59.599999999999994,170.79,Outgoing
15805500,2023-02-06,234.96,175.36,Incoming
15805500,2023-02-09,306.08000000000004,71.12,Incoming
15810455,2023-01-31,81.69,,-
15810455,2023-02-06,-28.97,110.66,Outgoing
15810455,2023-02-08,-267.87,238.9,Outgoing
15810455,2023-02-08,-368.06,100.19,Outgoing
15810455,2023-02-11,-480.29,112.23,Outgoing
15810455,2023-02-11,-645.77,165.48,Outgoing
15810455,2023-02-12,-500.66999999999996,145.1,Incoming
15810455,2023-02-13,-581.54,80.87,Outgoing
15826579,2023-01-31,596.77,,-
15826579,2023-02-01,1544.97,948.2,Incoming
15826579,2023-02-09,1289.35,255.62,Outgoing
15826579,2023-02-10,2951.95,1662.6,Incoming
15826579,2023-02-11,1814.0499999999997,1137.9,Outgoing
15826579,2023-02-13,1685.9599999999998,128.09,Outgoing
15830962,2023-01-31,570.89,,-
15830962,2023-02-03,520.47,50.42,Outgoing
15830962,2023-02-07,454.5,65.97,Outgoing
15830962,2023-02-10,551.59,97.09,Incoming
15841031,2023-01-31,579.98,,-
15841031,2023-02-05,641.07,61.09,Incoming
15841031,2023-02-08,516.75,124.32,Outgoing
15841031,2023-02-14,383.56,133.19,Outgoing
15899774,2023-01-31,773.38,,-
15899774,2023-02-06,622.05,151.33,Outgoing
15899774,2023-02-08,-760.45,1382.5,Outgoing
15899774,2023-02-09,-695.9000000000001,64.55,Incoming
15914466,2023-01-31,436.62,,-
15914466,2023-02-08,279.56,157.06,Outgoing
15914466,2023-02-09,389.23,109.67,Incoming
15914466,2023-02-09,1597.23,1208.0,Incoming
15914466,2023-02-11,1722.24,125.01,Incoming
15918861,2023-01-31,781.97,,-
15918861,2023-02-03,659.0,122.97,Outgoing
15918861,2023-02-04,681.38,22.38,Incoming
15918861,2023-02-09,784.54,103.16,Incoming
15918861,2023-02-14,658.72,125.82,Outgoing
15922706,2023-01-31,478.87,,-
15922706,2023-02-02,328.67,150.2,Outgoing
15922706,2023-02-04,224.60000000000002,104.07,Outgoing
15922706,2023-02-04,269.15000000000003,44.55,Incoming
15922706,2023-02-06,393.56000000000006,124.41,Incoming
15922706,2023-02-06,316.34000000000003,77.22,Outgoing
15922706,2023-02-06,251.72000000000003,64.62,Outgoing
15922706,2023-02-08,170.95000000000005,80.77,Outgoing
15922706,2023-02-09,82.03000000000004,88.92,Outgoing
15922706,2023-02-11,-1288.17,1370.2,Outgoing
15922706,2023-02-14,-1317.5800000000002,29.41,Outgoing
15944303,2023-01-31,977.44,,-
15944303,2023-02-05,1085.75,108.31,Incoming
15944303,2023-02-06,1185.93,100.18,Incoming
15944303,2023-02-09,1004.9200000000001,181.01,Outgoing
15944303,2023-02-12,-262.98,1267.9,Outgoing
15944303,2023-02-13,-370.14,107.16,Outgoing
15960008,2023-01-31,455.42,,-
15960008,2023-02-07,588.23,132.81,Incoming
15960008,2023-02-10,631.75,43.52,Incoming
15960008,2023-02-13,678.78,47.03,Incoming
15980710,2023-01-31,955.7,,-
15980710,2023-02-03,797.12,158.58,Outgoing
15980710,2023-02-04,699.26,97.86,Outgoing
15980710,2023-02-11,757.26,58.0,Incoming
15980710,2023-02-13,622.9,134.36,Outgoing
15980710,2023-02-14,543.01,79.89,Outgoing
16013218,2023-01-31,322.63,,-
16013218,2023-02-02,238.74,83.89,Outgoing
16013218,2023-02-06,350.15,111.41,Incoming
16013218,2023-02-06,-1086.25,1436.4,Outgoing
16013218,2023-02-10,-1112.68,26.43,Outgoing
16013218,2023-02-10,-1035.5800000000002,77.1,Incoming
16013218,2023-02-12,-807.2000000000002,228.38,Incoming
16013218,2023-02-12,-922.3100000000002,115.11,Outgoing
16026987,2023-01-31,772.57,,-
16026987,2023-02-02,869.4200000000001,96.85,Incoming
16026987,2023-02-03,813.08,56.34,Outgoing
16026987,2023-02-07,712.01,101.07,Outgoing
16026987,2023-02-08,616.87,95.14,Outgoing
16026987,2023-02-13,-1061.9299999999998,1678.8,Outgoing
16030234,2023-01-31,174.55,,-
16030234,2023-02-01,363.87,189.32,Incoming
16030234,2023-02-01,456.68,92.81,Incoming
16030234,2023-02-06,627.11,170.43,Incoming
16030234,2023-02-08,497.12,129.99,Outgoing
16030234,2023-02-09,594.74,97.62,Incoming
16030234,2023-02-10,681.28,86.54,Incoming
16030234,2023-02-12,761.86,80.58,Incoming
16063411,2023-01-31,896.73,,-
16063411,2023-02-13,974.53,77.8,Incoming
16063411,2023-02-14,845.67,128.86,Outgoing
16063411,2023-02-14,828.56,17.11,Outgoing
16067516,2023-01-31,494.33,,-
16067516,2023-02-06,1140.83,646.5,Incoming
16067516,2023-02-08,2185.5299999999997,1044.7,Incoming
16067516,2023-02-12,2016.7999999999997,168.73,Outgoing
16087504,2023-01-31,56.65,,-
16087504,2023-02-01,-87.6,144.25,Outgoing
16087504,2023-02-03,-234.60999999999999,147.01,Outgoing
16087504,2023-02-12,660.59,895.2,Incoming
16087504,2023-02-13,641.74,18.85,Outgoing
16087504,2023-02-14,735.35,93.61,Incoming
16093178,2023-01-31,96.62,,-
16093178,2023-02-02,232.9,136.28,Incoming
16093178,2023-02-03,118.43,114.47,Outgoing
16093178,2023-02-05,60.56000000000001,57.87,Outgoing
16093178,2023-02-11,219.77,159.21,Incoming
16093178,2023-02-11,132.69,87.08,Outgoing
16093178,2023-02-13,251.05,118.36,Incoming
16118153,2023-01-31,829.58,,-
16118153,2023-02-03,656.57,173.01,Outgoing
16118153,2023-02-05,706.35,49.78,Incoming
16118153,2023-02-05,752.25,45.9,Incoming
16118153,2023-02-09,626.27,125.98,Outgoing
16118153,2023-02-09,512.91,113.36,Outgoing
16118153,2023-02-10,572.3499999999999,59.44,Incoming
16118153,2023-02-13,-1255.25,1827.6,Outgoing
16124993,2023-01-31,148.14,,-
16124993,2023-02-05,122.38999999999999,25.75,Outgoing
16124993,2023-02-06,76.05999999999999,46.33,Outgoing
16124993,2023-02-06,173.39999999999998,97.34,Incoming
16124993,2023-02-08,-1495.1,1668.5,Outgoing
16124993,2023-02-08,-1327.51,167.59,Incoming
16124993,2023-02-11,-1451.83,124.32,Outgoing
16124993,2023-02-11,-1696.87,245.04,Outgoing
16124993,2023-02-12,-1053.27,643.6,Incoming
16124993,2023-02-14,-948.49,104.78,Incoming
16124993,2023-02-14,-805.4200000000001,143.07,Incoming
16152779,2023-01-31,65.09,,-
16152779,2023-02-01,-66.02000000000001,131.11,Outgoing
16152779,2023-02-01,-162.28000000000003,96.26,Outgoing
16152779,2023-02-02,-26.33000000000004,135.95,Incoming
16152779,2023-02-04,-200.23000000000005,173.9,Outgoing
16152779,2023-02-12,-82.72000000000004,117.51,Incoming
16157014,2023-01-31,858.73,,-
16157014,2023-02-01,759.64,99.09,Outgoing
16157014,2023-02-03,835.75,76.11,Incoming
16157014,2023-02-08,732.06,103.69,Outgoing
16157014,2023-02-11,674.06,58.0,Outgoing
16157014,2023-02-13,785.42,111.36,Incoming
16181964,2023-01-31,979.44,,-
16181964,2023-02-01,1029.13,49.69,Incoming
16181964,2023-02-03,1150.2800000000002,121.15,Incoming
16181964,2023-02-06,1090.5500000000002,59.73,Outgoing
16181964,2023-02-07,1170.91,80.36,Incoming
16181964,2023-02-13,1934.1100000000001,763.2,Incoming
16191280,2023-01-31,825.86,,-
16191280,2023-02-02,159.86,666.0,Outgoing
16191280,2023-02-03,138.39000000000001,21.47,Outgoing
16191280,2023-02-07,24.840000000000018,113.55,Outgoing
16191280,2023-02-08,-114.03999999999998,138.88,Outgoing
16191280,2023-02-09,-183.54999999999998,69.51,Outgoing
16191280,2023-02-10,-61.73999999999998,121.81,Incoming
16191280,2023-02-12,-148.39,86.65,Outgoing
16191280,2023-02-13,-70.61999999999999,77.77,Incoming
16191280,2023-02-14,-243.65999999999997,173.04,Outgoing
16223952,2023-01-31,222.18,,-
16223952,2023-02-03,24.54000000000002,197.64,Outgoing
16223952,2023-02-05,-1150.26,1174.8,Outgoing
16223952,2023-02-08,-1233.76,83.5,Outgoing
16223952,2023-02-09,-1401.95,168.19,Outgoing
16223952,2023-02-11,-1307.3600000000001,94.59,Incoming
16229373,2023-01-31,256.89,,-
16229373,2023-02-01,353.15,96.26,Incoming
16229373,2023-02-03,1484.75,1131.6,Incoming
16229373,2023-02-05,1323.74,161.01,Outgoing
16229373,2023-02-09,1196.21,127.53,Outgoing
16229373,2023-02-13,1349.3700000000001,153.16,Incoming
16229373,2023-02-13,1265.5300000000002,83.84,Outgoing
16270746,2023-01-31,904.31,,-
16270746,2023-02-01,854.4699999999999,49.84,Outgoing
16270746,2023-02-07,627.31,227.16,Outgoing
16270746,2023-02-14,517.18,110.13,Outgoing
16306280,2023-01-31,921.83,,-
16306280,2023-02-04,782.32,139.51,Outgoing
16306280,2023-02-06,645.83,136.49,Outgoing
16306280,2023-02-08,575.6800000000001,70.15,Outgoing
16306280,2023-02-13,495.84000000000003,79.84,Outgoing
16306280,2023-02-14,352.81000000000006,143.03,Outgoing
16312979,2023-01-31,833.92,,-
16312979,2023-02-02,891.76,57.84,Incoming
16312979,2023-02-05,844.25,47.51,Outgoing
16312979,2023-02-06,689.21,155.04,Outgoing
16312979,2023-02-07,789.61,100.4,Incoming
16312979,2023-02-08,-1323.69,2113.3,Outgoing
16334793,2023-01-31,297.75,,-
16334793,2023-02-02,423.87,126.12,Incoming
16334793,2023-02-08,501.67,77.8,Incoming
16334793,2023-02-09,590.59,88.92,Incoming
16334793,2023-02-11,2581.89,1991.3,Incoming
16334793,2023-02-12,2663.7599999999998,81.87,Incoming
16453812,2023-01-31,356.9,,-
16453812,2023-02-04,293.64,63.26,Outgoing
16453812,2023-02-09,147.30999999999997,146.33,Outgoing
16453812,2023-02-13,307.19999999999993,159.89,Incoming
16453812,2023-02-14,354.44999999999993,47.25,Incoming
16506904,2023-01-31,602.17,,-
16506904,2023-02-01,708.8499999999999,106.68,Incoming
16506904,2023-02-03,583.81,125.04,Outgoing
16506904,2023-02-06,606.4699999999999,22.66,Incoming
16506904,2023-02-07,740.5799999999999,134.11,Incoming
16506904,2023-02-09,905.3,164.72,Incoming
16506904,2023-02-12,827.8299999999999,77.47,Outgoing
16506904,2023-02-13,881.52,53.69,Incoming
16506904,2023-02-14,1159.92,278.4,Incoming
16584745,2023-01-31,129.46,,-
16584745,2023-02-01,265.97,136.51,Incoming
16584745,2023-02-04,156.76000000000005,109.21,Outgoing
16584745,2023-02-05,219.10000000000005,62.34,Incoming
16584745,2023-02-06,295.14000000000004,76.04,Incoming
16584745,2023-02-09,1207.94,912.8,Incoming
16584745,2023-02-10,1152.92,55.02,Outgoing
16584745,2023-02-11,1337.42,184.5,Incoming
16584745,2023-02-12,1167.42,170.0,Outgoing
16584745,2023-02-13,1278.79,111.37,Incoming
16628269,2023-01-31,27.11,,-
16628269,2023-02-04,80.14,53.03,Incoming
16628269,2023-02-04,-75.64999999999999,155.79,Outgoing
16628269,2023-02-05,-131.17,55.52,Outgoing
16628269,2023-02-05,-219.44,88.27,Outgoing
16628269,2023-02-11,-140.38,79.06,Incoming
16628269,2023-02-12,-291.72,151.34,Outgoing
16628269,2023-02-13,-333.47,41.75,Outgoing
16633794,2023-01-31,263.05,,-
16633794,2023-02-02,187.21,75.84,Outgoing
16633794,2023-02-08,73.79,113.42,Outgoing
16633794,2023-02-09,-15.599999999999994,89.39,Outgoing
16633794,2023-02-10,-101.99,86.39,Outgoing
16633794,2023-02-13,-163.68,61.69,Outgoing
16676577,2023-01-31,407.24,,-
16676577,2023-02-01,329.83000000000004,77.41,Outgoing
16676577,2023-02-04,407.53000000000003,77.7,Incoming
16676577,2023-02-06,1843.93,1436.4,Incoming
16676577,2023-02-09,1949.5,105.57,Incoming
16676577,2023-02-10,2053.09,103.59,Incoming
16927652,2023-01-31,637.58,,-
16927652,2023-02-01,651.8000000000001,14.22,Incoming
16927652,2023-02-04,497.84000000000003,153.96,Outgoing
16927652,2023-02-05,375.22,122.62,Outgoing
16977372,2023-01-31,675.5,,-
16977372,2023-02-01,856.61,181.11,Incoming
16977372,2023-02-08,660.71,195.9,Outgoing
16977372,2023-02-10,750.1800000000001,89.47,Incoming
16977372,2023-02-14,447.2800000000001,302.9,Outgoing
16984772,2023-01-31,823.43,,-
16984772,2023-02-02,-527.7700000000001,1351.2,Outgoing
16984772,2023-02-05,-451.5400000000001,76.23,Incoming
16984772,2023-02-05,-338.24000000000007,113.3,Incoming
16984772,2023-02-05,-158.90000000000006,179.34,Incoming
16984772,2023-02-07,-65.83000000000007,93.07,Incoming
16984772,2023-02-07,-128.00000000000006,62.17,Outgoing
16984772,2023-02-07,-279.9100000000001,151.91,Outgoing
16984772,2023-02-08,-70.01000000000008,209.9,Incoming
16984772,2023-02-10,23.27999999999993,93.29,Incoming
17024652,2023-01-31,918.84,,-
17024652,2023-02-02,817.45,101.39,Outgoing
17024652,2023-02-07,806.1,11.35,Outgoing
17024652,2023-02-09,-752.6,1558.7,Outgoing
17024652,2023-02-13,-782.97,30.37,Outgoing
17039422,2023-01-31,941.44,,-
17039422,2023-02-02,817.21,124.23,Outgoing
17039422,2023-02-03,1025.77,208.56,Incoming
17039422,2023-02-03,1224.86,199.09,Incoming
17039422,2023-02-06,2278.3599999999997,1053.5,Incoming
17051223,2023-01-31,558.16,,-
17051223,2023-02-08,619.5699999999999,61.41,Incoming
17051223,2023-02-08,493.7799999999999,125.79,Outgoing
17085651,2023-01-31,945.51,,-
17085651,2023-02-05,826.03,119.48,Outgoing
17085651,2023-02-08,907.37,81.34,Incoming
17085651,2023-02-11,2542.97,1635.6,Incoming
17085651,2023-02-11,3711.17,1168.2,Incoming
17085651,2023-02-12,3870.9900000000002,159.82,Incoming
17085651,2023-02-14,5454.39,1583.4,Incoming
17138963,2023-01-31,131.95,,-
17138963,2023-02-01,1632.65,1500.7,Incoming
17138963,2023-02-05,1521.93,110.72,Outgoing
17138963,2023-02-06,1463.14,58.79,Outgoing
17138963,2023-02-08,1498.6200000000001,35.48,Incoming
17138963,2023-02-14,1434.7700000000002,63.85,Outgoing
17144855,2023-01-31,355.14,,-
17144855,2023-02-01,172.77999999999997,182.36,Outgoing
17144855,2023-02-01,59.79999999999997,112.98,Outgoing
17144855,2023-02-02,111.07999999999997,51.28,Incoming
17144855,2023-02-02,207.14999999999998,96.07,Incoming
17144855,2023-02-03,155.73999999999998,51.41,Outgoing
17144855,2023-02-04,26.039999999999992,129.7,Outgoing
17144855,2023-02-06,130.62,104.58,Incoming
17144855,2023-02-09,270.88,140.26,Incoming
17144855,2023-02-13,436.54999999999995,165.67,Incoming
17144855,2023-02-13,495.59,59.04,Incoming
17191420,2023-01-31,717.28,,-
17191420,2023-02-01,586.5,130.78,Outgoing
17191420,2023-02-02,684.65,98.15,Incoming
17191420,2023-02-14,566.4399999999999,118.21,Outgoing
17228160,2023-01-31,567.87,,-
17228160,2023-02-01,673.48,105.61,Incoming
17228160,2023-02-01,1454.38,780.9,Incoming
17228160,2023-02-02,-102.51999999999998,1556.9,Outgoing
17228160,2023-02-02,-47.94999999999998,54.57,Incoming
17228160,2023-02-05,-227.36999999999998,179.42,Outgoing
17228160,2023-02-05,-351.15999999999997,123.79,Outgoing
17228160,2023-02-08,-315.96,35.2,Incoming
17228160,2023-02-10,-125.30999999999997,190.65,Incoming
17228160,2023-02-11,75.27000000000004,200.58,Incoming
17264146,2023-01-31,345.33,,-
17264146,2023-02-07,173.88,171.45,Outgoing
17264146,2023-02-10,212.76,38.88,Incoming
17264146,2023-02-11,364.40999999999997,151.65,Incoming
17264146,2023-02-12,441.34999999999997,76.94,Incoming
17264146,2023-02-14,382.66999999999996,58.68,Outgoing
17264146,2023-02-14,546.06,163.39,Incoming
17284705,2023-01-31,145.59,,-
17284705,2023-02-01,227.15,81.56,Incoming
17284705,2023-02-03,365.83000000000004,138.68,Incoming
17284705,2023-02-04,431.88000000000005,66.05,Incoming
17284705,2023-02-10,479.28000000000003,47.4,Incoming
17284705,2023-02-11,416.76000000000005,62.52,Outgoing
17284705,2023-02-11,258.80000000000007,157.96,Outgoing
17284705,2023-02-13,246.54000000000008,12.26,Outgoing
17301178,2023-01-31,311.47,,-
17301178,2023-02-02,431.79,120.32,Incoming
17301178,2023-02-03,278.84000000000003,152.95,Outgoing
17301178,2023-02-07,1426.2400000000002,1147.4,Incoming
17301178,2023-02-07,1319.4700000000003,106.77,Outgoing
17301178,2023-02-08,1263.7600000000002,55.71,Outgoing
17301178,2023-02-10,1288.6100000000001,24.85,Incoming
17301178,2023-02-13,1416.0400000000002,127.43,Incoming
17434670,2023-01-31,148.92,,-
17434670,2023-02-04,248.42,99.5,Incoming
17434670,2023-02-05,203.91,44.51,Outgoing
17434670,2023-02-07,123.44,80.47,Outgoing
17434670,2023-02-07,-45.81,169.25,Outgoing
17434670,2023-02-07,2.8399999999999963,48.65,Incoming
17434670,2023-02-10,708.74,705.9,Incoming
17434670,2023-02-10,1445.94,737.2,Incoming
17434670,2023-02-11,1230.1100000000001,215.83,Outgoing
17434670,2023-02-12,1090.5500000000002,139.56,Outgoing
17434670,2023-02-12,1046.8300000000002,43.72,Outgoing
17434670,2023-02-14,940.6200000000001,106.21,Outgoing
17469776,2023-01-31,443.18,,-
17469776,2023-02-05,538.13,94.95,Incoming
17469776,2023-02-05,448.9,89.23,Outgoing
17469776,2023-02-07,388.16999999999996,60.73,Outgoing
17469776,2023-02-08,449.55999999999995,61.39,Incoming
17469776,2023-02-12,372.9599999999999,76.6,Outgoing
17483941,2023-01-31,483.81,,-
17483941,2023-02-01,435.03,48.78,Outgoing
17483941,2023-02-01,599.0899999999999,164.06,Incoming
17483941,2023-02-01,709.54,110.45,Incoming
17483941,2023-02-02,607.14,102.4,Outgoing
17483941,2023-02-03,486.28,120.86,Outgoing
17483941,2023-02-03,409.62,76.66,Outgoing
17483941,2023-02-05,570.63,161.01,Incoming
17483941,2023-02-08,424.97,145.66,Outgoing
17483941,2023-02-11,415.76000000000005,9.21,Outgoing
17533114,2023-01-31,274.53,,-
17533114,2023-02-05,369.05999999999995,94.53,Incoming
17533114,2023-02-07,405.03999999999996,35.98,Incoming
17533114,2023-02-08,299.71999999999997,105.32,Outgoing
17533114,2023-02-13,422.98999999999995,123.27,Incoming
17533114,2023-02-14,556.42,133.43,Incoming
17534364,2023-01-31,758.41,,-
17534364,2023-02-05,878.89,120.48,Incoming
17534364,2023-02-08,836.3299999999999,42.56,Outgoing
17534364,2023-02-10,990.17,153.84,Incoming
17534364,2023-02-11,887.74,102.43,Outgoing
17534364,2023-02-14,947.54,59.8,Incoming
17543122,2023-01-31,681.64,,-
17543122,2023-02-04,730.04,48.4,Incoming
17543122,2023-02-05,923.9599999999999,193.92,Incoming
17543122,2023-02-05,961.9399999999999,37.98,Incoming
17543122,2023-02-05,1096.98,135.04,Incoming
17543122,2023-02-06,1116.43,19.45,Incoming
17543122,2023-02-08,997.6600000000001,118.77,Outgoing
17543122,2023-02-10,1147.27,149.61,Incoming
17543122,2023-02-13,963.48,183.79,Outgoing
17644586,2023-01-31,222.45,,-
17644586,2023-02-01,370.78999999999996,148.34,Incoming
17644586,2023-02-01,277.93999999999994,92.85,Outgoing
17644586,2023-02-02,400.1499999999999,122.21,Incoming
17644586,2023-02-03,253.75999999999993,146.39,Outgoing
17644586,2023-02-04,143.99999999999994,109.76,Outgoing
17644586,2023-02-09,93.97999999999993,50.02,Outgoing
17644586,2023-02-11,-31.350000000000065,125.33,Outgoing
17644586,2023-02-13,-141.69000000000005,110.34,Outgoing
17648252,2023-01-31,75.02,,-
17648252,2023-02-01,-571.1800000000001,646.2,Outgoing
17648252,2023-02-01,-0.8800000000001091,570.3,Incoming
17648252,2023-02-05,-125.71000000000011,124.83,Outgoing
17648252,2023-02-05,-107.58000000000011,18.13,Incoming
17648252,2023-02-06,-23.12000000000012,84.46,Incoming
17648252,2023-02-06,-118.43000000000012,95.31,Outgoing
17648252,2023-02-13,-250.73000000000013,132.3,Outgoing
17648252,2023-02-14,-804.3300000000002,553.6,Outgoing
17669623,2023-01-31,163.19,,-
17669623,2023-02-05,20.22,142.97,Outgoing
17669623,2023-02-07,-150.95,171.17,Outgoing
17669623,2023-02-09,-25.00999999999999,125.94,Incoming
17669623,2023-02-14,39.21000000000001,64.22,Incoming
17669623,2023-02-14,-67.13,106.34,Outgoing
17692892,2023-01-31,457.79,,-
17692892,2023-02-03,435.53000000000003,22.26,Outgoing
17692892,2023-02-03,524.47,88.94,Incoming
17692892,2023-02-06,570.02,45.55,Incoming
17692892,2023-02-09,395.1,174.92,Outgoing
17722231,2023-01-31,944.22,,-
17722231,2023-02-01,1011.23,67.01,Incoming
17722231,2023-02-02,988.84,22.39,Outgoing
17722231,2023-02-06,1451.04,462.2,Incoming
17722231,2023-02-09,1346.0,105.04,Outgoing
17749893,2023-01-31,889.45,,-
17749893,2023-02-01,1033.28,143.83,Incoming
17749893,2023-02-01,856.87,176.41,Outgoing
17749893,2023-02-07,1068.07,211.2,Incoming
17749893,2023-02-12,1096.49,28.42,Incoming
17749893,2023-02-12,2364.3900000000003,1267.9,Incoming
17749893,2023-02-13,2453.1800000000003,88.79,Incoming
17749893,2023-02-13,2362.38,90.8,Outgoing
17810734,2023-01-31,348.22,,-
17810734,2023-02-09,487.02000000000004,138.8,Incoming
17840180,2023-01-31,557.56,,-
17840180,2023-02-01,556.5999999999999,0.96,Outgoing
17840180,2023-02-04,432.4599999999999,124.14,Outgoing
17840180,2023-02-14,513.6099999999999,81.15,Incoming
17868317,2023-01-31,706.58,,-
17868317,2023-02-01,879.36,172.78,Incoming
17868317,2023-02-07,931.72,52.36,Incoming
17868317,2023-02-09,859.53,72.19,Outgoing
17868317,2023-02-13,735.1999999999999,124.33,Outgoing
17868317,2023-02-14,625.06,110.14,Outgoing
17881363,2023-01-31,415.27,,-
17881363,2023-02-02,462.03999999999996,46.77,Incoming
17881363,2023-02-03,526.0699999999999,64.03,Incoming
17881363,2023-02-04,503.68999999999994,22.38,Outgoing
17881363,2023-02-05,378.5199999999999,125.17,Outgoing
17881363,2023-02-13,1196.22,817.7,Incoming
17925406,2023-01-31,393.37,,-
17925406,2023-02-02,232.75,160.62,Outgoing
17925406,2023-02-03,284.15999999999997,51.41,Incoming
17925406,2023-02-06,366.15,81.99,Incoming
17925406,2023-02-06,256.63,109.52,Outgoing
17925406,2023-02-08,169.04,87.59,Outgoing
17925406,2023-02-10,243.76,74.72,Incoming
17925406,2023-02-13,131.38,112.38,Outgoing
17925406,2023-02-14,14.47999999999999,116.9,Outgoing
17933377,2023-01-31,189.05,,-
17933377,2023-02-02,93.78000000000002,95.27,Outgoing
17933377,2023-02-07,69.45000000000002,24.33,Outgoing
17933377,2023-02-07,-76.07,145.52,Outgoing
17933377,2023-02-08,33.22000000000001,109.29,Incoming
17938672,2023-01-31,904.99,,-
17938672,2023-02-01,802.04,102.95,Outgoing
17938672,2023-02-02,895.92,93.88,Incoming
17938672,2023-02-07,942.2099999999999,46.29,Incoming
17938672,2023-02-08,902.3599999999999,39.85,Outgoing
17938672,2023-02-11,772.6899999999999,129.67,Outgoing
17938672,2023-02-11,694.8499999999999,77.84,Outgoing
17939571,2023-01-31,396.93,,-
17939571,2023-02-02,328.3,68.63,Outgoing
17939571,2023-02-07,178.82000000000002,149.48,Outgoing
17939571,2023-02-07,70.73000000000002,108.09,Outgoing
17939571,2023-02-07,123.87000000000002,53.14,Incoming
17939571,2023-02-09,167.74,43.87,Incoming
17939571,2023-02-12,88.76,78.98,Outgoing
17939571,2023-02-12,38.11000000000001,50.65,Outgoing
17939571,2023-02-12,-38.90999999999999,77.02,Outgoing
17983851,2023-01-31,849.24,,-
17983851,2023-02-01,688.84,160.4,Outgoing
17983851,2023-02-02,488.41,200.43,Outgoing
17983851,2023-02-02,-306.48999999999995,794.9,Outgoing
17983851,2023-02-04,-280.00999999999993,26.48,Incoming
17983851,2023-02-06,-125.31999999999994,154.69,Incoming
17983851,2023-02-07,-225.04999999999995,99.73,Outgoing
17983851,2023-02-09,-157.93999999999994,67.11,Incoming
17983851,2023-02-12,-194.98999999999995,37.05,Outgoing
17983851,2023-02-12,-118.16999999999996,76.82,Incoming
17983851,2023-02-12,-207.78999999999996,89.62,Outgoing
18046225,2023-01-31,205.83,,-
18046225,2023-02-03,302.34000000000003,96.51,Incoming
18046225,2023-02-07,150.94000000000003,151.4,Outgoing
18046225,2023-02-10,87.62000000000003,63.32,Outgoing
18052851,2023-01-31,672.09,,-
18052851,2023-02-02,849.6,177.51,Incoming
18052851,2023-02-08,965.23,115.63,Incoming
18052851,2023-02-13,917.04,48.19,Outgoing
18052851,2023-02-14,758.01,159.03,Outgoing
18095448,2023-01-31,73.28,,-
18095448,2023-02-03,237.64000000000001,164.36,Incoming
18095448,2023-02-03,77.95000000000002,159.69,Outgoing
18095448,2023-02-05,-14.449999999999989,92.4,Outgoing
18095448,2023-02-12,-31.12999999999999,16.68,Outgoing
18095448,2023-02-12,-828.83,797.7,Outgoing
18133554,2023-01-31,733.1,,-
18133554,2023-02-02,847.39,114.29,Incoming
18133554,2023-02-03,1016.21,168.82,Incoming
18133554,2023-02-06,916.1600000000001,100.05,Outgoing
18133554,2023-02-06,239.46000000000004,676.7,Outgoing
18133554,2023-02-07,31.600000000000023,207.86,Outgoing
18133554,2023-02-07,-1245.8000000000002,1277.4,Outgoing
18133554,2023-02-07,-1355.0000000000002,109.2,Outgoing
18133554,2023-02-09,-1473.6200000000003,118.62,Outgoing
18133554,2023-02-09,-1650.4700000000003,176.85,Outgoing
18133554,2023-02-10,-1575.1700000000003,75.3,Incoming
18133554,2023-02-11,-1682.9800000000002,107.81,Outgoing
18133554,2023-02-11,-2786.9800000000005,1104.0,Outgoing
18133554,2023-02-14,-2768.4400000000005,18.54,Incoming
18179400,2023-01-31,768.78,,-
18179400,2023-02-03,750.16,18.62,Outgoing
18179400,2023-02-06,881.76,131.6,Incoming
18179400,2023-02-08,1079.72,197.96,Incoming
18179400,2023-02-11,519.52,560.2,Outgoing
18185362,2023-01-31,609.36,,-
18185362,2023-02-02,727.26,117.9,Incoming
18185362,2023-02-04,603.18,124.08,Outgoing
18185362,2023-02-11,614.17,10.99,Incoming
18185362,2023-02-12,2569.77,1955.6,Incoming
18185362,2023-02-14,2477.99,91.78,Outgoing
18198770,2023-01-31,108.23,,-
18198770,2023-02-02,32.09,76.14,Outgoing
18198770,2023-02-04,-114.79999999999998,146.89,Outgoing
18198770,2023-02-14,-69.83999999999997,44.96,Incoming
18305932,2023-01-31,834.42,,-
18305932,2023-02-08,964.1199999999999,129.7,Incoming
18305932,2023-02-11,1085.07,120.95,Incoming
18305932,2023-02-14,1005.9499999999999,79.12,Outgoing
18305932,2023-02-14,1024.1799999999998,18.23,Incoming
18308848,2023-01-31,570.65,,-
18308848,2023-02-07,423.28999999999996,147.36,Outgoing
18308848,2023-02-14,450.96999999999997,27.68,Incoming
18346988,2023-01-31,450.36,,-
18346988,2023-02-02,581.51,131.15,Incoming
18346988,2023-02-03,618.45,36.94,Incoming
18346988,2023-02-04,1054.95,436.5,Incoming
18346988,2023-02-07,1911.45,856.5,Incoming
18346988,2023-02-14,1984.64,73.19,Incoming
18348734,2023-01-31,579.93,,-
18348734,2023-02-01,727.51,147.58,Incoming
18348734,2023-02-02,1677.71,950.2,Incoming
18348734,2023-02-06,1830.54,152.83,Incoming
18348734,2023-02-06,1942.48,111.94,Incoming
18348734,2023-02-07,2154.25,211.77,Incoming
18348734,2023-02-08,2222.98,68.73,Incoming
18348734,2023-02-08,2279.81,56.83,Incoming
18348734,2023-02-08,3312.21,1032.4,Incoming
18348734,2023-02-09,2267.11,1045.1,Outgoing
18348734,2023-02-09,2343.57,76.46,Incoming
18348734,2023-02-11,4013.2700000000004,1669.7,Incoming
18348734,2023-02-11,3864.5300000000007,148.74,Outgoing
18348734,2023-02-13,3962.6800000000007,98.15,Incoming
18348734,2023-02-14,1952.6800000000007,2010.0,Outgoing
18447548,2023-01-31,574.24,,-
18447548,2023-02-01,474.83000000000004,99.41,Outgoing
18447548,2023-02-08,655.22,180.39,Incoming
18447548,2023-02-10,743.83,88.61,Incoming
18447548,2023-02-10,610.83,133.0,Outgoing
18447548,2023-02-12,566.74,44.09,Outgoing
18447548,2023-02-13,671.01,104.27,Incoming
18447548,2023-02-13,2041.81,1370.8,Incoming
18447548,2023-02-13,1966.25,75.56,Outgoing
18447548,2023-02-14,2068.16,101.91,Incoming
18451683,2023-01-31,501.75,,-
18451683,2023-02-03,344.32,157.43,Outgoing
18451683,2023-02-03,242.31,102.01,Outgoing
18451683,2023-02-05,129.97,112.34,Outgoing
18451683,2023-02-05,233.35,103.38,Incoming
18451683,2023-02-06,392.84000000000003,159.49,Incoming
18451683,2023-02-06,448.92,56.08,Incoming
18451683,2023-02-10,305.62,143.3,Outgoing
18451683,2023-02-11,370.84000000000003,65.22,Incoming
18451683,2023-02-12,1356.74,985.9,Incoming
18451683,2023-02-13,1294.66,62.08,Outgoing
18517970,2023-01-31,709.95,,-
18517970,2023-02-02,567.0,142.95,Outgoing
18517970,2023-02-03,1077.1,510.1,Incoming
18517970,2023-02-04,949.3699999999999,127.73,Outgoing
18517970,2023-02-08,980.5699999999999,31.2,Incoming
18517970,2023-02-09,925.9999999999999,54.57,Outgoing
18517970,2023-02-10,830.0199999999999,95.98,Outgoing
18517970,2023-02-12,922.1399999999999,92.12,Incoming
18517970,2023-02-14,1013.9199999999998,91.78,Incoming
18563743,2023-01-31,649.46,,-
18563743,2023-02-04,614.64,34.82,Outgoing
18563743,2023-02-07,739.34,124.7,Incoming
18563743,2023-02-09,775.83,36.49,Incoming
18563743,2023-02-11,638.57,137.26,Outgoing
18563743,2023-02-12,741.5200000000001,102.95,Incoming
18563743,2023-02-12,800.1500000000001,58.63,Incoming
18582171,2023-01-31,732.99,,-
18582171,2023-02-03,842.85,109.86,Incoming
18582171,2023-02-05,720.84,122.01,Outgoing
18582171,2023-02-06,615.5,105.34,Outgoing
18582171,2023-02-09,479.02,136.48,Outgoing
18582171,2023-02-11,626.3299999999999,147.31,Incoming
18582171,2023-02-11,553.51,72.82,Outgoing
18582171,2023-02-13,429.65,123.86,Outgoing
18582171,2023-02-14,515.03,85.38,Incoming
18582171,2023-02-14,469.13,45.9,Outgoing
18584434,2023-01-31,877.81,,-
18584434,2023-02-02,981.6899999999999,103.88,Incoming
18584434,2023-02-03,1076.52,94.83,Incoming
18584434,2023-02-05,997.9,78.62,Outgoing
18584434,2023-02-05,1120.52,122.62,Incoming
18584434,2023-02-08,1216.86,96.34,Incoming
18645136,2023-01-31,554.87,,-
18645136,2023-02-01,434.78,120.09,Outgoing
18645136,2023-02-03,323.78,111.0,Outgoing
18645136,2023-02-04,124.34999999999997,199.43,Outgoing
18645136,2023-02-05,126.59999999999997,2.25,Incoming
18645136,2023-02-13,65.44999999999996,61.15,Outgoing
18645136,2023-02-14,181.96999999999997,116.52,Incoming
18685463,2023-01-31,476.02,,-
18685463,2023-02-09,513.67,37.65,Incoming
18685463,2023-02-10,440.28,73.39,Outgoing
18685463,2023-02-14,321.59,118.69,Outgoing
18685463,2023-02-14,241.58999999999997,80.0,Outgoing
18718399,2023-01-31,716.22,,-
18718399,2023-02-04,596.26,119.96,Outgoing
18718399,2023-02-06,221.76,374.5,Outgoing
18718399,2023-02-10,-1578.94,1800.7,Outgoing
18850031,2023-01-31,191.3,,-
18850031,2023-02-03,90.31000000000002,100.99,Outgoing
18850031,2023-02-05,-91.10999999999997,181.42,Outgoing
18850031,2023-02-05,-211.58999999999997,120.48,Outgoing
18850031,2023-02-07,-40.18999999999997,171.4,Incoming
18850031,2023-02-11,-5.669999999999966,34.52,Incoming
18850031,2023-02-11,-178.16999999999996,172.5,Outgoing
18850031,2023-02-13,-283.90999999999997,105.74,Outgoing
18859451,2023-01-31,441.04,,-
18859451,2023-02-02,910.34,469.3,Incoming
18859451,2023-02-06,799.87,110.47,Outgoing
18859451,2023-02-06,902.07,102.2,Incoming
18859451,2023-02-13,855.9100000000001,46.16,Outgoing
18859451,2023-02-14,763.7400000000001,92.17,Outgoing
18899132,2023-01-31,244.46,,-
18899132,2023-02-05,314.04,69.58,Incoming
18899132,2023-02-06,216.70000000000002,97.34,Outgoing
18899132,2023-02-08,279.88,63.18,Incoming
18928638,2023-01-31,150.95,,-
18928638,2023-02-02,313.36,162.41,Incoming
18928638,2023-02-02,506.13,192.77,Incoming
18928638,2023-02-10,690.88,184.75,Incoming
19001745,2023-01-31,507.55,,-
19001745,2023-02-03,431.13,76.42,Outgoing
19001745,2023-02-04,375.59,55.54,Outgoing
19001745,2023-02-10,275.92999999999995,99.66,Outgoing
19001745,2023-02-10,-68.37000000000006,344.3,Outgoing
19001745,2023-02-11,104.77999999999994,173.15,Incoming
19001745,2023-02-13,187.66999999999996,82.89,Incoming
19001745,2023-02-14,85.60999999999996,102.06,Outgoing
19001745,2023-02-14,266.84999999999997,181.24,Incoming
19094015,2023-01-31,548.65,,-
19094015,2023-02-01,474.21999999999997,74.43,Outgoing
19094015,2023-02-02,698.3199999999999,224.1,Incoming
19094015,2023-02-06,2393.3199999999997,1695.0,Incoming
19094015,2023-02-06,2579.97,186.65,Incoming
19094015,2023-02-12,818.8699999999999,1761.1,Outgoing
19094015,2023-02-13,1586.1699999999998,767.3,Incoming
19154395,2023-01-31,274.06,,-
19154395,2023-02-01,-182.14,456.2,Outgoing
19154395,2023-02-01,-356.1,173.96,Outgoing
19154395,2023-02-05,-541.4000000000001,185.3,Outgoing
19154395,2023-02-05,-515.6500000000001,25.75,Incoming
19154395,2023-02-06,-492.5200000000001,23.13,Incoming
19160862,2023-01-31,211.53,,-
19160862,2023-02-02,321.90999999999997,110.38,Incoming
19160862,2023-02-11,459.15999999999997,137.25,Incoming
19201987,2023-01-31,624.55,,-
19201987,2023-02-04,678.92,54.37,Incoming
19201987,2023-02-04,786.3,107.38,Incoming
19201987,2023-02-06,927.0799999999999,140.78,Incoming
19201987,2023-02-09,846.4499999999999,80.63,Outgoing
19201987,2023-02-11,908.6899999999999,62.24,Incoming
19216744,2023-01-31,123.53,,-
19216744,2023-02-03,43.67,79.86,Outgoing
19220216,2023-01-31,628.89,,-
19220216,2023-02-04,777.24,148.35,Incoming
19220216,2023-02-04,727.05,50.19,Outgoing
19220216,2023-02-05,618.74,108.31,Outgoing
19220216,2023-02-05,690.07,71.33,Incoming
19220216,2023-02-06,-143.82999999999993,833.9,Outgoing
19220216,2023-02-06,18.300000000000068,162.13,Incoming
19220216,2023-02-11,120.56000000000007,102.26,Incoming
19220216,2023-02-12,69.54000000000008,51.02,Outgoing
19220216,2023-02-13,-118.25999999999993,187.8,Outgoing
19220216,2023-02-14,71.89000000000007,190.15,Incoming
19242274,2023-01-31,65.28,,-
19242274,2023-02-01,172.57,107.29,Incoming
19242274,2023-02-01,55.86,116.71,Outgoing
19242274,2023-02-08,150.01999999999998,94.16,Incoming
19242274,2023-02-09,182.84999999999997,32.83,Incoming
19242274,2023-02-10,-1142.0500000000002,1324.9,Outgoing
19242274,2023-02-10,-1043.2000000000003,98.85,Incoming
19283264,2023-01-31,301.31,,-
19283264,2023-02-07,428.25,126.94,Incoming
19283264,2023-02-07,513.69,85.44,Incoming
19283264,2023-02-10,410.07000000000005,103.62,Outgoing
19283264,2023-02-10,506.4100000000001,96.34,Incoming
19283264,2023-02-12,466.99000000000007,39.42,Outgoing
19315124,2023-01-31,447.16,,-
19315124,2023-02-11,382.46000000000004,64.7,Outgoing
19315124,2023-02-11,476.04,93.58,Incoming
19315124,2023-02-14,566.15,90.11,Incoming
19315124,2023-02-14,-67.85000000000002,634.0,Outgoing
19317267,2023-01-31,51.87,,-
19317267,2023-02-03,165.12,113.25,Incoming
19317267,2023-02-14,-1026.58,1191.7,Outgoing
19317267,2023-02-14,-828.3799999999999,198.2,Incoming
19317267,2023-02-14,-862.0399999999998,33.66,Outgoing
19334563,2023-01-31,525.45,,-
19334563,2023-02-01,1300.0500000000002,774.6,Incoming
19334563,2023-02-08,1169.67,130.38,Outgoing
19334563,2023-02-12,1128.0800000000002,41.59,Outgoing
19334563,2023-02-13,1235.2500000000002,107.17,Incoming
19334563,2023-02-14,-538.3499999999997,1773.6,Outgoing
19387921,2023-01-31,927.28,,-
19387921,2023-02-01,1014.25,86.97,Incoming
19387921,2023-02-02,889.91,124.34,Outgoing
19387921,2023-02-06,745.17,144.74,Outgoing
19387921,2023-02-11,804.1099999999999,58.94,Incoming
19387921,2023-02-14,733.5899999999999,70.52,Outgoing
19387921,2023-02-14,859.4099999999999,125.82,Incoming
19387921,2023-02-14,696.5099999999999,162.9,Outgoing
19429964,2023-01-31,694.43,,-
19429964,2023-02-04,473.65999999999997,220.77,Outgoing
19429964,2023-02-05,273.46,200.2,Outgoing
19429964,2023-02-08,332.06,58.6,Incoming
19429964,2023-02-13,129.52,202.54,Outgoing
19429964,2023-02-14,32.170000000000016,97.35,Outgoing
19432211,2023-01-31,24.19,,-
19432211,2023-02-02,-90.68,114.87,Outgoing
19432211,2023-02-02,34.099999999999994,124.78,Incoming
19432211,2023-02-07,141.3,107.2,Incoming
19432211,2023-02-08,64.70000000000002,76.6,Outgoing
19524427,2023-01-31,579.16,,-
19524427,2023-02-03,1351.96,772.8,Incoming
19524427,2023-02-06,1200.52,151.44,Outgoing
19524427,2023-02-09,912.72,287.8,Outgoing
19524427,2023-02-13,763.83,148.89,Outgoing
19530097,2023-01-31,960.21,,-
19530097,2023-02-05,915.4300000000001,44.78,Outgoing
19530097,2023-02-06,809.6200000000001,105.81,Outgoing
19530097,2023-02-10,909.8500000000001,100.23,Incoming
19530097,2023-02-10,829.9900000000001,79.86,Outgoing
19530097,2023-02-13,678.1500000000001,151.84,Outgoing
19559937,2023-01-31,727.4,,-
19559937,2023-02-01,814.12,86.72,Incoming
19559937,2023-02-01,-686.58,1500.7,Outgoing
19559937,2023-02-05,-572.5500000000001,114.03,Incoming
19559937,2023-02-09,-522.1400000000001,50.41,Incoming
19559937,2023-02-10,-586.4200000000001,64.28,Outgoing
19559937,2023-02-10,-497.8900000000001,88.53,Incoming
19559937,2023-02-11,-340.4900000000001,157.4,Incoming
19559937,2023-02-12,-1365.5900000000001,1025.1,Outgoing
19574610,2023-01-31,104.29,,-
19574610,2023-02-02,12.75,91.54,Outgoing
19574610,2023-02-04,-173.84,186.59,Outgoing
19574610,2023-02-04,-40.22999999999999,133.61,Incoming
19574610,2023-02-05,-855.9300000000001,815.7,Outgoing
19574610,2023-02-07,-669.7800000000001,186.15,Incoming
19574610,2023-02-10,-641.2,28.58,Incoming
19574610,2023-02-11,-458.52000000000004,182.68,Incoming
19574610,2023-02-13,-527.21,68.69,Outgoing
19574610,2023-02-13,-464.49,62.72,Incoming
19574610,2023-02-14,-387.16,77.33,Incoming
19647966,2023-01-31,849.89,,-
19647966,2023-02-05,673.01,176.88,Outgoing
19647966,2023-02-08,544.21,128.8,Outgoing
19647966,2023-02-10,437.49,106.72,Outgoing
19647966,2023-02-12,273.20000000000005,164.29,Outgoing
19647966,2023-02-14,367.75000000000006,94.55,Incoming
19647966,2023-02-14,284.4200000000001,83.33,Outgoing
19686460,2023-01-31,416.7,,-
19686460,2023-02-01,-401.7,818.4,Outgoing
19686460,2023-02-07,-517.09,115.39,Outgoing
19686460,2023-02-08,-1896.8899999999999,1379.8,Outgoing
19686460,2023-02-11,-2651.1899999999996,754.3,Outgoing
19686460,2023-02-14,-2578.2599999999998,72.93,Incoming
19705767,2023-01-31,997.48,,-
19705767,2023-02-04,1131.7,134.22,Incoming
19705767,2023-02-08,1268.08,136.38,Incoming
19705767,2023-02-10,1166.5,101.58,Outgoing
19705767,2023-02-11,1034.31,132.19,Outgoing
19705767,2023-02-13,988.2299999999999,46.08,Outgoing
19705767,2023-02-14,995.3199999999999,7.09,Incoming
19789505,2023-01-31,893.9,,-
19789505,2023-02-01,-148.0000000000001,1041.9,Outgoing
19789505,2023-02-04,-192.55000000000013,44.55,Outgoing
19789505,2023-02-08,-311.3100000000001,118.76,Outgoing
19789505,2023-02-08,-296.66000000000014,14.65,Incoming
19789505,2023-02-10,-336.6800000000001,40.02,Outgoing
19789505,2023-02-11,-454.35000000000014,117.67,Outgoing
19789505,2023-02-13,1211.05,1665.4,Incoming
19836996,2023-01-31,245.14,,-
19836996,2023-02-02,130.84999999999997,114.29,Outgoing
19836996,2023-02-04,-34.900000000000034,165.75,Outgoing
19836996,2023-02-06,69.41999999999996,104.32,Incoming
19836996,2023-02-07,1228.92,1159.5,Incoming
19836996,2023-02-07,1294.0800000000002,65.16,Incoming
19876635,2023-01-31,883.25,,-
19876635,2023-02-01,964.41,81.16,Incoming
19876635,2023-02-01,1065.69,101.28,Incoming
19876635,2023-02-02,1302.48,236.79,Incoming
19876635,2023-02-03,1438.07,135.59,Incoming
19876635,2023-02-03,1309.4499999999998,128.62,Outgoing
19876635,2023-02-10,1437.5099999999998,128.06,Incoming
19876635,2023-02-11,1289.6999999999998,147.81,Outgoing
19876635,2023-02-14,1425.3999999999999,135.7,Incoming
19920990,2023-01-31,70.95,,-
19920990,2023-02-03,216.08999999999997,145.14,Incoming
19920990,2023-02-07,1586.6899999999998,1370.6,Incoming
19920990,2023-02-08,1677.3899999999999,90.7,Incoming
19920990,2023-02-09,1623.83,53.56,Outgoing
19920990,2023-02-13,752.3299999999999,871.5,Outgoing
19920990,2023-02-14,714.15,38.18,Outgoing
19931073,2023-01-31,404.96,,-
19931073,2023-02-13,364.94,40.02,Outgoing
19956941,2023-01-31,723.33,,-
19956941,2023-02-03,-398.26999999999987,1121.6,Outgoing
19956941,2023-02-05,-224.58999999999986,173.68,Incoming
19956941,2023-02-08,-90.93999999999986,133.65,Incoming
19956941,2023-02-08,-1101.54,1010.6,Outgoing
19956941,2023-02-09,-1032.1499999999999,69.39,Incoming
19956941,2023-02-14,-963.1399999999999,69.01,Incoming
19980716,2023-01-31,432.98,,-
19980716,2023-02-02,547.85,114.87,Incoming
19980716,2023-02-02,-1226.85,1774.7,Outgoing
19980716,2023-02-03,-1067.1599999999999,159.69,Incoming
19980716,2023-02-07,-1087.2299999999998,20.07,Outgoing
19980716,2023-02-09,-1212.9099999999999,125.68,Outgoing
19980716,2023-02-09,-1326.9199999999998,114.01,Outgoing
19980716,2023-02-10,-644.7199999999998,682.2,Incoming
19980716,2023-02-11,-720.3699999999998,75.65,Outgoing
20015298,2023-01-31,953.82,,-
20015298,2023-02-01,795.3100000000001,158.51,Outgoing
20015298,2023-02-08,752.4300000000001,42.88,Outgoing
20015298,2023-02-08,880.85,128.42,Incoming
20015298,2023-02-11,1471.45,590.6,Incoming
20015298,2023-02-13,1522.1200000000001,50.67,Incoming
20067958,2023-01-31,38.05,,-
20067958,2023-02-07,-83.97,122.02,Outgoing
20067958,2023-02-07,-169.2,85.23,Outgoing
20067958,2023-02-08,-1143.5,974.3,Outgoing
20067958,2023-02-11,-1245.76,102.26,Outgoing
20067958,2023-02-12,-1340.12,94.36,Outgoing
20090784,2023-01-31,482.62,,-
20090784,2023-02-03,470.09000000000003,12.53,Outgoing
20090784,2023-02-04,-793.8100000000001,1263.9,Outgoing
20090784,2023-02-09,-879.61,85.8,Outgoing
20090784,2023-02-10,-871.32,8.29,Incoming
20090784,2023-02-13,-1582.22,710.9,Outgoing
20117480,2023-01-31,70.97,,-
20117480,2023-02-01,157.65,86.68,Incoming
20117480,2023-02-06,-29.0,186.65,Outgoing
20117480,2023-02-07,-217.36,188.36,Outgoing
20117480,2023-02-08,-63.160000000000025,154.2,Incoming
20117480,2023-02-11,-138.32000000000002,75.16,Outgoing
20129535,2023-01-31,446.41,,-
20129535,2023-02-01,302.56000000000006,143.85,Outgoing
20129535,2023-02-05,129.94000000000005,172.62,Outgoing
20129535,2023-02-06,84.93000000000006,45.01,Outgoing
20129535,2023-02-07,78.90000000000006,6.03,Outgoing
20129535,2023-02-10,178.64000000000004,99.74,Incoming
20129535,2023-02-11,208.78000000000003,30.14,Incoming
20129535,2023-02-13,95.54000000000003,113.24,Outgoing
20176338,2023-01-31,289.57,,-
20176338,2023-02-01,389.59,100.02,Incoming
20176338,2023-02-04,576.54,186.95,Incoming
20176338,2023-02-05,468.21,108.33,Outgoing
20176338,2023-02-05,405.33,62.88,Outgoing
20176338,2023-02-08,308.90999999999997,96.42,Outgoing
20176338,2023-02-09,120.76999999999998,188.14,Outgoing
20176338,2023-02-10,242.46999999999997,121.7,Incoming
20242626,2023-01-31,701.08,,-
20242626,2023-02-03,615.6,85.48,Outgoing
20242626,2023-02-09,533.5500000000001,82.05,Outgoing
20248053,2023-01-31,565.28,,-
20248053,2023-02-02,642.71,77.43,Incoming
20248053,2023-02-03,515.23,127.48,Outgoing
20248053,2023-02-04,405.18,110.05,Outgoing
20248053,2023-02-11,584.45,179.27,Incoming
20248053,2023-02-14,699.4300000000001,114.98,Incoming
20263437,2023-01-31,789.09,,-
20263437,2023-02-04,647.78,141.31,Outgoing
20263437,2023-02-05,747.1999999999999,99.42,Incoming
20263437,2023-02-05,788.53,41.33,Incoming
20263437,2023-02-08,681.12,107.41,Outgoing
20263437,2023-02-12,632.45,48.67,Outgoing
20280759,2023-01-31,838.7,,-
20280759,2023-02-03,905.07,66.37,Incoming
20280759,2023-02-04,1015.44,110.37,Incoming
20280759,2023-02-12,1081.8400000000001,66.4,Incoming
20280759,2023-02-12,963.0400000000002,118.8,Outgoing
20280759,2023-02-12,1073.3000000000002,110.26,Incoming
20280759,2023-02-13,962.5600000000002,110.74,Outgoing
20287993,2023-01-31,616.17,,-
20287993,2023-02-03,490.8299999999999,125.34,Outgoing
20287993,2023-02-04,-123.17000000000007,614.0,Outgoing
20287993,2023-02-06,-999.6700000000001,876.5,Outgoing
20287993,2023-02-07,-243.17000000000007,756.5,Incoming
20287993,2023-02-09,-324.6700000000001,81.5,Outgoing
20287993,2023-02-13,-232.89000000000007,91.78,Incoming
20287993,2023-02-13,-436.2600000000001,203.37,Outgoing
20316429,2023-01-31,697.84,,-
20316429,2023-02-02,792.76,94.92,Incoming
20316429,2023-02-09,959.46,166.7,Incoming
20345467,2023-01-31,852.5,,-
20345467,2023-02-01,924.85,72.35,Incoming
20345467,2023-02-02,1025.21,100.36,Incoming
20345467,2023-02-05,910.13,115.08,Outgoing
20345467,2023-02-08,755.5,154.63,Outgoing
20345467,2023-02-09,910.48,154.98,Incoming
20345467,2023-02-14,807.95,102.53,Outgoing
20369153,2023-01-31,293.78,,-
20369153,2023-02-01,-94.12,387.9,Outgoing
20369153,2023-02-03,-236.98000000000002,142.86,Outgoing
20369153,2023-02-04,-125.51000000000002,111.47,Incoming
20369153,2023-02-05,18.659999999999968,144.17,Incoming
20369153,2023-02-07,997.9599999999999,979.3,Incoming
20369153,2023-02-07,392.7599999999999,605.2,Outgoing
20369153,2023-02-11,452.0599999999999,59.3,Incoming
20369153,2023-02-11,584.2499999999999,132.19,Incoming
20369153,2023-02-11,730.81,146.56,Incoming
20372310,2023-01-31,366.41,,-
20372310,2023-02-02,490.21000000000004,123.8,Incoming
20372310,2023-02-05,347.88,142.33,Outgoing
20372310,2023-02-05,452.62,104.74,Incoming
20372310,2023-02-10,527.49,74.87,Incoming
20372310,2023-02-10,671.85,144.36,Incoming
20372310,2023-02-10,698.72,26.87,Incoming
20372310,2023-02-11,575.69,123.03,Outgoing
20372310,2023-02-11,1869.5900000000001,1293.9,Incoming
20413037,2023-01-31,235.79,,-
20413037,2023-02-02,355.34,119.55,Incoming
20413037,2023-02-02,448.9,93.56,Incoming
20413037,2023-02-02,350.80999999999995,98.09,Outgoing
20413037,2023-02-07,284.90999999999997,65.9,Outgoing
20413037,2023-02-11,333.68999999999994,48.78,Incoming
20413037,2023-02-11,212.21999999999994,121.47,Outgoing
20413037,2023-02-14,268.3399999999999,56.12,Incoming
20425065,2023-01-31,866.77,,-
20425065,2023-02-02,929.55,62.78,Incoming
20425065,2023-02-04,1095.3,165.75,Incoming
20425065,2023-02-14,3229.8999999999996,2134.6,Incoming
20464830,2023-01-31,181.25,,-
20464830,2023-02-03,347.38,166.13,Incoming
20464830,2023-02-04,226.33999999999997,121.04,Outgoing
20464830,2023-02-08,66.88999999999999,159.45,Outgoing
20632572,2023-01-31,286.44,,-
20632572,2023-02-02,306.55,20.11,Incoming
20632572,2023-02-06,290.47,16.08,Outgoing
20632572,2023-02-12,115.15000000000003,175.32,Outgoing
20704613,2023-01-31,71.59,,-
20704613,2023-02-01,-25.519999999999996,97.11,Outgoing
20704613,2023-02-06,-13.909999999999997,11.61,Incoming
20704613,2023-02-07,-107.82,93.91,Outgoing
20704613,2023-02-08,-138.39,30.57,Outgoing
20704613,2023-02-09,-268.75,130.36,Outgoing
20704613,2023-02-10,-67.78999999999999,200.96,Incoming
20704613,2023-02-11,-88.77999999999999,20.99,Outgoing
20704613,2023-02-13,66.03000000000002,154.81,Incoming
20705548,2023-01-31,184.81,,-
20705548,2023-02-02,-2084.39,2269.2,Outgoing
20705548,2023-02-03,-2292.95,208.56,Outgoing
20705548,2023-02-04,-2167.8399999999997,125.11,Incoming
20705548,2023-02-14,-2137.1,30.74,Incoming
20705548,2023-02-14,-2204.46,67.36,Outgoing
20705548,2023-02-14,-2251.07,46.61,Outgoing
20720894,2023-01-31,243.42,,-
20720894,2023-02-06,-218.78,462.2,Outgoing
20720894,2023-02-06,-398.6,179.82,Outgoing
20720894,2023-02-11,-290.79,107.81,Incoming
20838578,2023-01-31,620.7,,-
20838578,2023-02-09,676.57,55.87,Incoming
20838578,2023-02-10,773.44,96.87,Incoming
20838578,2023-02-12,716.48,56.96,Outgoing
20849721,2023-01-31,740.52,,-
20849721,2023-02-06,669.97,70.55,Outgoing
20849721,2023-02-06,650.52,19.45,Outgoing
20849721,2023-02-07,452.9,197.62,Outgoing
20849721,2023-02-08,524.88,71.98,Incoming
20849721,2023-02-13,407.46,117.42,Outgoing
20851460,2023-01-31,931.67,,-
20851460,2023-02-03,806.87,124.8,Outgoing
20851460,2023-02-10,953.9,147.03,Incoming
20878023,2023-01-31,648.19,,-
20878023,2023-02-04,797.3900000000001,149.2,Incoming
20878023,2023-02-06,900.9200000000001,103.53,Incoming
20878023,2023-02-06,1026.1200000000001,125.2,Incoming
20878023,2023-02-08,1133.7600000000002,107.64,Incoming
20878023,2023-02-08,1009.2600000000002,124.5,Outgoing
20878023,2023-02-10,1072.8400000000001,63.58,Incoming
20878023,2023-02-13,1099.5500000000002,26.71,Incoming
20908067,2023-01-31,607.53,,-
20908067,2023-02-05,427.63,179.9,Outgoing
20908067,2023-02-06,629.6800000000001,202.05,Incoming
20908067,2023-02-11,749.4300000000001,119.75,Incoming
20908067,2023-02-14,2887.4300000000003,2138.0,Incoming
20991411,2023-01-31,572.64,,-
20991411,2023-02-06,683.97,111.33,Incoming
20991411,2023-02-09,642.2,41.77,Outgoing
20991411,2023-02-10,757.0600000000001,114.86,Incoming
20992354,2023-01-31,87.26,,-
20992354,2023-02-01,169.44,82.18,Incoming
20992354,2023-02-03,174.57999999999998,5.14,Incoming
20992354,2023-02-04,45.46999999999997,129.11,Outgoing
20992354,2023-02-08,236.96999999999997,191.5,Incoming
20992354,2023-02-09,272.35999999999996,35.39,Incoming
20992354,2023-02-12,220.19999999999996,52.16,Outgoing
20992354,2023-02-13,319.3299999999999,99.13,Incoming
20992354,2023-02-13,161.77999999999992,157.55,Outgoing
21001872,2023-01-31,31.76,,-
21001872,2023-02-09,19.53,12.23,Outgoing
21001872,2023-02-10,126.25,106.72,Incoming
21001872,2023-02-12,224.9,98.65,Incoming
21001872,2023-02-14,123.21000000000001,101.69,Outgoing
21032760,2023-01-31,541.33,,-
21032760,2023-02-01,1178.43,637.1,Incoming
21032760,2023-02-03,1083.93,94.5,Outgoing
21032760,2023-02-03,1135.51,51.58,Incoming
21032760,2023-02-04,1007.71,127.8,Outgoing
21032760,2023-02-09,928.8100000000001,78.9,Outgoing
21032760,2023-02-09,1922.21,993.4,Incoming
21032760,2023-02-10,2854.51,932.3,Incoming
21032760,2023-02-11,2821.19,33.32,Outgoing
21032760,2023-02-11,3982.29,1161.1,Incoming
21032760,2023-02-13,3821.08,161.21,Outgoing
21047777,2023-01-31,699.12,,-
21047777,2023-02-03,658.57,40.55,Outgoing
21047777,2023-02-04,627.5,31.07,Outgoing
21047777,2023-02-05,756.44,128.94,Incoming
21047777,2023-02-06,664.0500000000001,92.39,Outgoing
21047777,2023-02-07,526.48,137.57,Outgoing
21047777,2023-02-08,541.0,14.52,Incoming
21047777,2023-02-08,377.95,163.05,Outgoing
21047777,2023-02-12,468.23,90.28,Incoming
21142911,2023-01-31,714.89,,-
21142911,2023-02-01,818.88,103.99,Incoming
21142911,2023-02-02,975.38,156.5,Incoming
21142911,2023-02-06,894.46,80.92,Outgoing
21142911,2023-02-10,946.48,52.02,Incoming
21142911,2023-02-10,1033.09,86.61,Incoming
21142911,2023-02-10,872.4899999999999,160.6,Outgoing
21293955,2023-01-31,232.88,,-
21293955,2023-02-05,-877.82,1110.7,Outgoing
21293955,2023-02-08,-963.72,85.9,Outgoing
21293955,2023-02-10,-1588.52,624.8,Outgoing
21314767,2023-01-31,438.19,,-
21314767,2023-02-01,471.55,33.36,Incoming
21314767,2023-02-01,602.48,130.93,Incoming
21314767,2023-02-07,745.52,143.04,Incoming
21314767,2023-02-11,880.24,134.72,Incoming
21314767,2023-02-12,2367.04,1486.8,Incoming
21314767,2023-02-12,2470.83,103.79,Incoming
21368735,2023-01-31,281.87,,-
21368735,2023-02-01,427.64,145.77,Incoming
21368735,2023-02-02,1214.24,786.6,Incoming
21368735,2023-02-03,1173.91,40.33,Outgoing
21368735,2023-02-04,1247.6100000000001,73.7,Incoming
21368735,2023-02-05,1297.46,49.85,Incoming
21368735,2023-02-06,1234.03,63.43,Outgoing
21368735,2023-02-13,1115.2,118.83,Outgoing
21392412,2023-01-31,708.46,,-
21392412,2023-02-02,590.5600000000001,117.9,Outgoing
21392412,2023-02-02,783.24,192.68,Incoming
21392412,2023-02-04,884.99,101.75,Incoming
21392412,2023-02-04,-482.4100000000001,1367.4,Outgoing
21392412,2023-02-12,-605.22,122.81,Outgoing
21392412,2023-02-14,-484.91,120.31,Incoming
21464772,2023-01-31,719.8,,-
21464772,2023-02-04,637.89,81.91,Outgoing
21464772,2023-02-08,585.59,52.3,Outgoing
21464772,2023-02-12,404.18000000000006,181.41,Outgoing
21464772,2023-02-12,278.71000000000004,125.47,Outgoing
21475060,2023-01-31,354.98,,-
21475060,2023-02-06,315.15000000000003,39.83,Outgoing
21475060,2023-02-06,747.05,431.9,Incoming
21475060,2023-02-10,864.3,117.25,Incoming
21475060,2023-02-12,1925.8,1061.5,Incoming
21475060,2023-02-13,1767.51,158.29,Outgoing
21475060,2023-02-14,1742.23,25.28,Outgoing
21515934,2023-01-31,543.38,,-
21515934,2023-02-01,670.13,126.75,Incoming
21515934,2023-02-02,882.73,212.6,Incoming
21515934,2023-02-02,283.43000000000006,599.3,Outgoing
21515934,2023-02-03,353.7200000000001,70.29,Incoming
21515934,2023-02-11,454.6000000000001,100.88,Incoming
21515934,2023-02-14,376.9100000000001,77.69,Outgoing
21550631,2023-01-31,84.96,,-
21550631,2023-02-03,267.31,182.35,Incoming
21550631,2023-02-04,147.78,119.53,Outgoing
21550631,2023-02-08,236.63,88.85,Incoming
21550631,2023-02-11,126.22,110.41,Outgoing
21558805,2023-01-31,586.63,,-
21558805,2023-02-02,518.22,68.41,Outgoing
21558805,2023-02-05,-1642.4799999999998,2160.7,Outgoing
21558805,2023-02-07,-3076.7799999999997,1434.3,Outgoing
21558805,2023-02-10,-3190.6,113.82,Outgoing
21558805,2023-02-12,-4124.6,934.0,Outgoing
21558805,2023-02-13,-4007.1800000000003,117.42,Incoming
21558805,2023-02-13,-4133.25,126.07,Outgoing
21601747,2023-01-31,410.62,,-
21601747,2023-02-01,468.8,58.18,Incoming
21601747,2023-02-06,445.81,22.99,Outgoing
21601747,2023-02-08,-151.58999999999997,597.4,Outgoing
21601747,2023-02-10,-255.49999999999997,103.91,Outgoing
21601747,2023-02-14,-115.49999999999997,140.0,Incoming
21618665,2023-01-31,291.59,,-
21618665,2023-02-01,515.53,223.94,Incoming
21618665,2023-02-02,691.26,175.73,Incoming
21618665,2023-02-02,601.39,89.87,Outgoing
21618665,2023-02-04,500.0,101.39,Outgoing
21618665,2023-02-05,642.33,142.33,Incoming
21618665,2023-02-05,578.37,63.96,Outgoing
21618665,2023-02-06,394.36,184.01,Outgoing
21618665,2023-02-06,459.41,65.05,Incoming
21618665,2023-02-07,631.05,171.64,Incoming
21618665,2023-02-09,534.6899999999999,96.36,Outgoing
21618665,2023-02-13,639.1999999999999,104.51,Incoming
21618665,2023-02-13,787.3699999999999,148.17,Incoming
21646418,2023-01-31,909.55,,-
21646418,2023-02-04,786.1199999999999,123.43,Outgoing
21646418,2023-02-06,860.8999999999999,74.78,Incoming
21646418,2023-02-09,796.4299999999998,64.47,Outgoing
21655728,2023-01-31,761.31,,-
21655728,2023-02-11,867.3299999999999,106.02,Incoming
21655728,2023-02-11,810.9599999999999,56.37,Outgoing
21675999,2023-01-31,893.27,,-
21675999,2023-02-01,783.95,109.32,Outgoing
21675999,2023-02-04,1382.35,598.4,Incoming
21675999,2023-02-09,1223.6899999999998,158.66,Outgoing
21675999,2023-02-10,1256.6799999999998,32.99,Incoming
21675999,2023-02-11,1199.9799999999998,56.7,Outgoing
21675999,2023-02-11,1134.5799999999997,65.4,Outgoing
21694967,2023-01-31,90.13,,-
21694967,2023-02-02,-43.53999999999999,133.67,Outgoing
21694967,2023-02-02,573.1600000000001,616.7,Incoming
21694967,2023-02-02,-446.3399999999999,1019.5,Outgoing
21694967,2023-02-03,-412.93999999999994,33.4,Incoming
21694967,2023-02-06,629.0600000000001,1042.0,Incoming
21694967,2023-02-07,-1179.44,1808.5,Outgoing
21694967,2023-02-08,-1019.99,159.45,Incoming
21694967,2023-02-09,-1032.68,12.69,Outgoing
21705004,2023-01-31,496.88,,-
21705004,2023-02-08,393.18,103.7,Outgoing
21705004,2023-02-13,268.73,124.45,Outgoing
21705004,2023-02-13,316.92,48.19,Incoming
21711501,2023-01-31,126.63,,-
21711501,2023-02-01,0.269999999999996,126.36,Outgoing
21711501,2023-02-03,1882.67,1882.4,Incoming
21711501,2023-02-04,2008.94,126.27,Incoming
21716351,2023-01-31,800.95,,-
21716351,2023-02-02,689.0400000000001,111.91,Outgoing
21716351,2023-02-05,469.7700000000001,219.27,Outgoing
21716351,2023-02-08,436.4500000000001,33.32,Outgoing
21716351,2023-02-12,-1063.1499999999999,1499.6,Outgoing
21719977,2023-01-31,758.81,,-
21719977,2023-02-05,619.91,138.9,Outgoing
21719977,2023-02-06,800.8,180.89,Incoming
21719977,2023-02-06,956.7199999999999,155.92,Incoming
21719977,2023-02-10,217.2199999999999,739.5,Outgoing
21719977,2023-02-12,177.4499999999999,39.77,Outgoing
21719977,2023-02-13,1298.7499999999998,1121.3,Incoming
21728352,2023-01-31,733.87,,-
21728352,2023-02-02,825.71,91.84,Incoming
21728352,2023-02-04,705.33,120.38,Outgoing
21728352,2023-02-08,822.4100000000001,117.08,Incoming
21728352,2023-02-10,755.47,66.94,Outgoing
21728352,2023-02-12,858.79,103.32,Incoming
21728352,2023-02-12,707.73,151.06,Outgoing
21728352,2023-02-13,656.16,51.57,Outgoing
21749252,2023-01-31,646.27,,-
21749252,2023-02-01,595.3199999999999,50.95,Outgoing
21749252,2023-02-02,760.6199999999999,165.3,Incoming
21749252,2023-02-03,633.8599999999999,126.76,Outgoing
21749252,2023-02-07,489.3599999999999,144.5,Outgoing
21749252,2023-02-08,599.5099999999999,110.15,Incoming
21749252,2023-02-10,755.7899999999998,156.28,Incoming
21749252,2023-02-10,1853.9899999999998,1098.2,Incoming
21749252,2023-02-13,1800.7099999999998,53.28,Outgoing
21750371,2023-01-31,329.19,,-
21750371,2023-02-05,417.74,88.55,Incoming
21750371,2023-02-06,285.78,131.96,Outgoing
21750371,2023-02-10,213.54999999999995,72.23,Outgoing
21816770,2023-01-31,693.8,,-
21816770,2023-02-03,511.44999999999993,182.35,Outgoing
21816770,2023-02-03,370.3999999999999,141.05,Outgoing
21816770,2023-02-03,427.25999999999993,56.86,Incoming
21816770,2023-02-05,353.0999999999999,74.16,Outgoing
21816770,2023-02-09,497.2399999999999,144.14,Incoming
21816770,2023-02-10,382.9999999999999,114.24,Outgoing
21844169,2023-01-31,463.51,,-
21844169,2023-02-01,466.55,3.04,Incoming
21844169,2023-02-04,605.83,139.28,Incoming
21844169,2023-02-06,501.1700000000001,104.66,Outgoing
21844169,2023-02-06,604.5400000000001,103.37,Incoming
21844169,2023-02-07,694.1400000000001,89.6,Incoming
21844169,2023-02-08,590.7700000000001,103.37,Outgoing
21844169,2023-02-09,523.6600000000001,67.11,Outgoing
21844169,2023-02-11,647.7400000000001,124.08,Incoming
21844169,2023-02-12,756.5500000000002,108.81,Incoming
21844651,2023-01-31,525.16,,-
21844651,2023-02-03,562.18,37.02,Incoming
21844651,2023-02-03,457.28999999999996,104.89,Outgoing
21844651,2023-02-04,383.78999999999996,73.5,Outgoing
21844651,2023-02-04,338.28,45.51,Outgoing
21844651,2023-02-13,294.75,43.53,Outgoing
21881168,2023-01-31,950.62,,-
21881168,2023-02-04,1029.01,78.39,Incoming
21881168,2023-02-04,1001.24,27.77,Outgoing
21881168,2023-02-04,1154.52,153.28,Incoming
21881168,2023-02-06,1122.61,31.91,Outgoing
21881168,2023-02-06,1308.34,185.73,Incoming
21881168,2023-02-10,2190.34,882.0,Incoming
21881168,2023-02-10,2068.9,121.44,Outgoing
21881168,2023-02-14,2147.82,78.92,Incoming
21898016,2023-01-31,117.42,,-
21898016,2023-02-09,4.269999999999996,113.15,Outgoing
21918195,2023-01-31,510.33,,-
21918195,2023-02-02,631.26,120.93,Incoming
21918195,2023-02-08,736.61,105.35,Incoming
21918195,2023-02-14,887.38,150.77,Incoming
21966927,2023-01-31,511.1,,-
21966927,2023-02-02,422.81,88.29,Outgoing
21966927,2023-02-05,346.87,75.94,Outgoing
21966927,2023-02-06,374.59000000000003,27.72,Incoming
21966927,2023-02-10,304.71000000000004,69.88,Outgoing
22027757,2023-01-31,438.85,,-
22027757,2023-02-01,541.0600000000001,102.21,Incoming
22027757,2023-02-01,561.1700000000001,20.11,Incoming
22027757,2023-02-01,776.19,215.02,Incoming
22027757,2023-02-05,1281.19,505.0,Incoming
22027757,2023-02-06,1267.5800000000002,13.61,Outgoing
22035411,2023-01-31,9.55,,-
22035411,2023-02-02,-112.66,122.21,Outgoing
22035411,2023-02-02,-150.5,37.84,Outgoing
22035411,2023-02-02,-1179.3,1028.8,Outgoing
22035411,2023-02-06,-1226.83,47.53,Outgoing
22035411,2023-02-07,-1094.69,132.14,Incoming
22035411,2023-02-09,-1079.3200000000002,15.37,Incoming
22035411,2023-02-10,-1176.6100000000001,97.29,Outgoing
22035411,2023-02-11,-1091.5900000000001,85.02,Incoming
22054113,2023-01-31,364.66,,-
22054113,2023-02-01,331.3,33.36,Outgoing
22054113,2023-02-03,397.39,66.09,Incoming
22054113,2023-02-04,339.43,57.96,Outgoing
22054113,2023-02-09,201.64000000000001,137.79,Outgoing
22054113,2023-02-11,311.40000000000003,109.76,Incoming
22054113,2023-02-11,267.62,43.78,Outgoing
22063978,2023-01-31,387.01,,-
22063978,2023-02-01,291.8,95.21,Outgoing
22063978,2023-02-01,1281.1,989.3,Incoming
22063978,2023-02-02,1241.9699999999998,39.13,Outgoing
22063978,2023-02-02,1191.2599999999998,50.71,Outgoing
22063978,2023-02-10,1082.4499999999998,108.81,Outgoing
22099256,2023-01-31,523.78,,-
22099256,2023-02-02,655.5799999999999,131.8,Incoming
22099256,2023-02-04,742.7099999999999,87.13,Incoming
22099256,2023-02-06,1745.9099999999999,1003.2,Incoming
22099256,2023-02-06,1873.7799999999997,127.87,Incoming
22099256,2023-02-09,1787.8999999999996,85.88,Outgoing
22099256,2023-02-14,386.0999999999997,1401.8,Outgoing
22137086,2023-01-31,410.35,,-
22137086,2023-02-04,-1712.35,2122.7,Outgoing
22137086,2023-02-05,-1596.82,115.53,Incoming
22137086,2023-02-07,-1564.56,32.26,Incoming
22137086,2023-02-08,-195.96000000000004,1368.6,Incoming
22137086,2023-02-08,-279.29,83.33,Outgoing
22137086,2023-02-08,-210.23000000000002,69.06,Incoming
22137086,2023-02-09,1078.37,1288.6,Incoming
22137086,2023-02-11,1036.51,41.86,Outgoing
22268314,2023-01-31,153.05,,-
22268314,2023-02-01,313.43,160.38,Incoming
22268314,2023-02-05,378.74,65.31,Incoming
22268314,2023-02-09,534.4300000000001,155.69,Incoming
22268314,2023-02-10,520.5300000000001,13.9,Outgoing
22268314,2023-02-11,558.33,37.8,Incoming
22268314,2023-02-13,572.6500000000001,14.32,Incoming
22292682,2023-01-31,874.32,,-
22292682,2023-02-01,1004.76,130.44,Incoming
22292682,2023-02-05,845.69,159.07,Outgoing
22292682,2023-02-05,1047.44,201.75,Incoming
22292682,2023-02-06,924.48,122.96,Outgoing
22292682,2023-02-07,820.74,103.74,Outgoing
22292682,2023-02-11,797.16,23.58,Outgoing
22292682,2023-02-12,731.11,66.05,Outgoing
22298371,2023-01-31,891.16,,-
22298371,2023-02-01,998.3399999999999,107.18,Incoming
22298371,2023-02-05,1217.61,219.27,Incoming
22298371,2023-02-07,1131.3899999999999,86.22,Outgoing
22298371,2023-02-12,1282.7299999999998,151.34,Incoming
22341160,2023-01-31,61.07,,-
22341160,2023-02-02,760.97,699.9,Incoming
22374612,2023-01-31,554.31,,-
22374612,2023-02-03,507.97999999999996,46.33,Outgoing
22374612,2023-02-05,1618.68,1110.7,Incoming
22374612,2023-02-07,1753.23,134.55,Incoming
22374612,2023-02-08,1943.15,189.92,Incoming
22374612,2023-02-11,200.45000000000005,1742.7,Outgoing
22374612,2023-02-12,292.35,91.9,Incoming
22374612,2023-02-14,1027.85,735.5,Incoming
22391508,2023-01-31,91.32,,-
22391508,2023-02-01,79.00999999999999,12.31,Outgoing
22391508,2023-02-02,-15.680000000000007,94.69,Outgoing
22391508,2023-02-07,55.92999999999999,71.61,Incoming
22393008,2023-01-31,753.5,,-
22393008,2023-02-07,2560.4,1806.9,Incoming
22393008,2023-02-09,2706.5,146.1,Incoming
22393008,2023-02-09,1446.5,1260.0,Outgoing
22393008,2023-02-10,-80.20000000000005,1526.7,Outgoing
22393008,2023-02-13,19.59999999999995,99.8,Incoming
22403299,2023-01-31,702.95,,-
22403299,2023-02-03,804.48,101.53,Incoming
22403299,2023-02-03,29.680000000000064,774.8,Outgoing
22403299,2023-02-04,-60.44999999999993,90.13,Outgoing
22403299,2023-02-04,35.19000000000007,95.64,Incoming
22403299,2023-02-05,92.98000000000008,57.79,Incoming
22403299,2023-02-08,-74.12999999999994,167.11,Outgoing
22403299,2023-02-09,-809.23,735.1,Outgoing
22403299,2023-02-09,-720.84,88.39,Incoming
22403299,2023-02-09,-863.28,142.44,Outgoing
22404690,2023-01-31,726.06,,-
22404690,2023-02-08,739.38,13.32,Incoming
22404690,2023-02-12,-195.32000000000005,934.7,Outgoing
22404690,2023-02-14,-68.61000000000006,126.71,Incoming
22412680,2023-01-31,637.99,,-
22412680,2023-02-02,720.89,82.9,Incoming
22412680,2023-02-03,805.39,84.5,Incoming
22412680,2023-02-08,650.93,154.46,Outgoing
22412680,2023-02-09,818.18,167.25,Incoming
22412680,2023-02-09,698.67,119.51,Outgoing
22412680,2023-02-09,663.28,35.39,Outgoing
22412680,2023-02-10,586.18,77.1,Outgoing
22412680,2023-02-10,501.02,85.16,Outgoing
22412680,2023-02-14,539.14,38.12,Incoming
22412680,2023-02-14,607.65,68.51,Incoming
22412680,2023-02-14,503.12,104.53,Outgoing
22483300,2023-01-31,763.23,,-
22483300,2023-02-05,815.57,52.34,Incoming
22483300,2023-02-07,955.69,140.12,Incoming
22483300,2023-02-09,1068.45,112.76,Incoming
22483300,2023-02-10,983.32,85.13,Outgoing
22683382,2023-01-31,987.13,,-
22683382,2023-02-01,1079.48,92.35,Incoming
22683382,2023-02-02,1047.84,31.64,Outgoing
22683382,2023-02-06,1158.6,110.76,Incoming
22683382,2023-02-07,1263.24,104.64,Incoming
22683382,2023-02-09,1405.85,142.61,Incoming
22696687,2023-01-31,133.52,,-
22696687,2023-02-03,-19.47999999999999,153.0,Outgoing
22696687,2023-02-08,60.38000000000001,79.86,Incoming
22696687,2023-02-10,122.69000000000001,62.31,Incoming
22696687,2023-02-10,211.81,89.12,Incoming
22696687,2023-02-12,150.45,61.36,Outgoing
22696687,2023-02-12,-911.05,1061.5,Outgoing
22696687,2023-02-12,-872.63,38.42,Incoming
22696687,2023-02-14,-811.47,61.16,Incoming
22730750,2023-01-31,473.56,,-
22730750,2023-02-01,460.19,13.37,Outgoing
22730750,2023-02-01,440.08,20.11,Outgoing
22730750,2023-02-04,535.13,95.05,Incoming
22730750,2023-02-05,406.35,128.78,Outgoing
22730750,2023-02-07,510.51,104.16,Incoming
22730750,2023-02-11,377.54999999999995,132.96,Outgoing
22730750,2023-02-12,181.59999999999997,195.95,Outgoing
22730750,2023-02-12,379.79999999999995,198.2,Incoming
22799719,2023-01-31,481.26,,-
22799719,2023-02-03,615.11,133.85,Incoming
22799719,2023-02-03,563.53,51.58,Outgoing
22799719,2023-02-06,393.09999999999997,170.43,Outgoing
22799719,2023-02-06,317.19999999999993,75.9,Outgoing
22799719,2023-02-07,361.2199999999999,44.02,Incoming
22799719,2023-02-11,334.3499999999999,26.87,Outgoing
22799719,2023-02-12,391.6799999999999,57.33,Incoming
22799719,2023-02-13,352.89999999999986,38.78,Outgoing
22799719,2023-02-13,533.7099999999998,180.81,Incoming
22799719,2023-02-14,479.9199999999998,53.79,Outgoing
22830156,2023-01-31,596.06,,-
22830156,2023-02-02,-38.1400000000001,634.2,Outgoing
22830156,2023-02-04,71.3599999999999,109.5,Incoming
22830156,2023-02-10,-1915.94,1987.3,Outgoing
22830156,2023-02-12,-762.04,1153.9,Incoming
22830156,2023-02-13,-731.12,30.92,Incoming
22830156,2023-02-14,-560.55,170.57,Incoming
22833010,2023-01-31,645.79,,-
22833010,2023-02-01,703.79,58.0,Incoming
22833010,2023-02-03,836.3199999999999,132.53,Incoming
22833010,2023-02-04,976.02,139.7,Incoming
22833010,2023-02-06,865.26,110.76,Outgoing
22833010,2023-02-08,1029.19,163.93,Incoming
22846221,2023-01-31,868.2,,-
22846221,2023-02-01,1047.8,179.6,Incoming
22846221,2023-02-02,-59.100000000000136,1106.9,Outgoing
22846221,2023-02-06,-185.93000000000012,126.83,Outgoing
22846221,2023-02-09,-198.64000000000013,12.71,Outgoing
22846221,2023-02-10,-54.37000000000012,144.27,Incoming
22884864,2023-01-31,521.87,,-
22884864,2023-02-02,413.36,108.51,Outgoing
22884864,2023-02-05,535.37,122.01,Incoming
22884864,2023-02-06,672.51,137.14,Incoming
22884864,2023-02-06,854.79,182.28,Incoming
22888798,2023-01-31,326.4,,-
22888798,2023-02-05,287.09,39.31,Outgoing
22888798,2023-02-06,211.27999999999997,75.81,Outgoing
22888798,2023-02-07,140.14,71.14,Outgoing
22888798,2023-02-08,193.79999999999998,53.66,Incoming
22888798,2023-02-08,86.15999999999998,107.64,Outgoing
22951653,2023-01-31,414.64,,-
22951653,2023-02-01,397.03,17.61,Outgoing
22951653,2023-02-02,215.40999999999997,181.62,Outgoing
22951653,2023-02-08,228.56999999999996,13.16,Incoming
22951653,2023-02-12,340.16999999999996,111.6,Incoming
22951653,2023-02-12,354.42999999999995,14.26,Incoming
22951653,2023-02-13,269.77,84.66,Outgoing
23030554,2023-01-31,196.97,,-
23030554,2023-02-03,48.02000000000001,148.95,Outgoing
23030554,2023-02-06,195.36,147.34,Incoming
23030554,2023-02-10,262.96000000000004,67.6,Incoming
23030554,2023-02-11,350.53000000000003,87.57,Incoming
23032852,2023-01-31,475.21,,-
23032852,2023-02-02,-357.29,832.5,Outgoing
23032852,2023-02-04,-433.23,75.94,Outgoing
23032852,2023-02-07,-573.95,140.72,Outgoing
23032852,2023-02-09,-1354.65,780.7,Outgoing
23032852,2023-02-09,-1199.3100000000002,155.34,Incoming
23032852,2023-02-10,-1042.6800000000003,156.63,Incoming
23045208,2023-01-31,359.49,,-
23045208,2023-02-02,1516.89,1157.4,Incoming
23045208,2023-02-02,2311.79,794.9,Incoming
23045208,2023-02-02,2249.75,62.04,Outgoing
23045208,2023-02-13,2368.42,118.67,Incoming
23093541,2023-01-31,326.05,,-
23093541,2023-02-04,381.75,55.7,Incoming
23093541,2023-02-05,478.7,96.95,Incoming
23093541,2023-02-05,588.8199999999999,110.12,Incoming
23093541,2023-02-10,502.2799999999999,86.54,Outgoing
23124345,2023-01-31,595.61,,-
23124345,2023-02-03,380.52,215.09,Outgoing
23124345,2023-02-04,254.25,126.27,Outgoing
23124345,2023-02-12,123.46000000000001,130.79,Outgoing
23141588,2023-01-31,281.28,,-
23141588,2023-02-02,2105.58,1824.3,Incoming
23141588,2023-02-14,2170.16,64.58,Incoming
23231848,2023-01-31,27.12,,-
23231848,2023-02-02,139.35,112.23,Incoming
23231848,2023-02-04,1594.25,1454.9,Incoming
23231848,2023-02-04,1683.76,89.51,Incoming
23231848,2023-02-04,1976.4,292.64,Incoming
23231848,2023-02-06,2073.92,97.52,Incoming
23231848,2023-02-09,1933.89,140.03,Outgoing
23231848,2023-02-11,2029.5700000000002,95.68,Incoming
23231848,2023-02-12,2510.77,481.2,Incoming
23231848,2023-02-13,2645.13,134.36,Incoming
23231848,2023-02-14,2607.76,37.37,Outgoing
23269253,2023-01-31,324.56,,-
23269253,2023-02-01,-575.24,899.8,Outgoing
23269253,2023-02-07,-423.33000000000004,151.91,Incoming
23269253,2023-02-08,-458.81000000000006,35.48,Outgoing
23269253,2023-02-10,-386.6000000000001,72.21,Incoming
23269253,2023-02-13,-352.30000000000007,34.3,Incoming
23269253,2023-02-14,-253.96000000000006,98.34,Incoming
23271383,2023-01-31,633.3,,-
23271383,2023-02-03,734.7199999999999,101.42,Incoming
23271383,2023-02-05,560.5899999999999,174.13,Outgoing
23271383,2023-02-06,-616.3100000000002,1176.9,Outgoing
23271383,2023-02-07,-754.9400000000002,138.63,Outgoing
23271383,2023-02-09,-620.9400000000002,134.0,Incoming
23271383,2023-02-09,-778.6300000000001,157.69,Outgoing
23271383,2023-02-09,-783.2400000000001,4.61,Outgoing
23271383,2023-02-11,-771.5500000000001,11.69,Incoming
23271383,2023-02-14,-889.9300000000001,118.38,Outgoing
23289647,2023-01-31,522.8,,-
23289647,2023-02-03,465.93999999999994,56.86,Outgoing
23289647,2023-02-07,552.9699999999999,87.03,Incoming
23289647,2023-02-07,678.68,125.71,Incoming
23289647,2023-02-10,832.8,154.12,Incoming
23289647,2023-02-10,662.25,170.55,Outgoing
23295106,2023-01-31,340.16,,-
23295106,2023-02-01,251.01000000000002,89.15,Outgoing
23295106,2023-02-02,147.13000000000002,103.88,Outgoing
23295106,2023-02-04,74.41000000000003,72.72,Outgoing
23295106,2023-02-06,180.44000000000003,106.03,Incoming
23295106,2023-02-11,142.64000000000004,37.8,Outgoing
23295106,2023-02-13,253.04000000000005,110.4,Incoming
23295106,2023-02-14,-1085.3600000000001,1338.4,Outgoing
23310842,2023-01-31,78.85,,-
23310842,2023-02-02,-12.690000000000012,91.54,Outgoing
23310842,2023-02-02,163.95,176.64,Incoming
23310842,2023-02-05,151.86999999999998,12.08,Outgoing
23310842,2023-02-05,287.26,135.39,Incoming
23310842,2023-02-06,1165.56,878.3,Incoming
23310842,2023-02-06,1256.54,90.98,Incoming
23310842,2023-02-09,1152.7,103.84,Outgoing
23310842,2023-02-12,1281.1000000000001,128.4,Incoming
23321929,2023-01-31,408.3,,-
23321929,2023-02-04,284.79,123.51,Outgoing
23321929,2023-02-11,399.13,114.34,Incoming
23321929,2023-02-13,613.74,214.61,Incoming
23321929,2023-02-13,566.59,47.15,Outgoing
23325248,2023-01-31,49.31,,-
23325248,2023-02-02,186.9,137.59,Incoming
23325248,2023-02-09,369.27,182.37,Incoming
23333877,2023-01-31,648.46,,-
23333877,2023-02-01,771.69,123.23,Incoming
23333877,2023-02-06,668.1600000000001,103.53,Outgoing
23333877,2023-02-06,590.08,78.08,Outgoing
23333877,2023-02-09,423.44000000000005,166.64,Outgoing
23333877,2023-02-10,36.64000000000004,386.8,Outgoing
23333877,2023-02-11,-48.37999999999995,85.02,Outgoing
23333877,2023-02-12,44.780000000000044,93.16,Incoming
23333877,2023-02-14,198.44000000000005,153.66,Incoming
23369902,2023-01-31,716.79,,-
23369902,2023-02-01,586.88,129.91,Outgoing
23369902,2023-02-05,421.84000000000003,165.04,Outgoing
23369902,2023-02-05,303.56000000000006,118.28,Outgoing
23369902,2023-02-08,428.36000000000007,124.8,Incoming
23369902,2023-02-11,540.24,111.88,Incoming
23369902,2023-02-13,724.03,183.79,Incoming
23369902,2023-02-13,579.5699999999999,144.46,Outgoing
23415061,2023-01-31,71.2,,-
23415061,2023-02-01,173.3,102.1,Incoming
23415061,2023-02-03,82.82000000000001,90.48,Outgoing
23415061,2023-02-04,-1619.88,1702.7,Outgoing
23415061,2023-02-04,-1496.3700000000001,123.51,Incoming
23415061,2023-02-10,-2716.87,1220.5,Outgoing
23445508,2023-01-31,373.43,,-
23445508,2023-02-04,318.86,54.57,Outgoing
23445508,2023-02-07,404.59000000000003,85.73,Incoming
23445508,2023-02-09,1056.5900000000001,652.0,Incoming
23445508,2023-02-11,1138.7400000000002,82.15,Incoming
23445508,2023-02-13,1115.5700000000002,23.17,Outgoing
23445508,2023-02-13,946.3400000000001,169.23,Outgoing
23445508,2023-02-13,994.7200000000001,48.38,Incoming
23479459,2023-01-31,176.23,,-
23479459,2023-02-02,54.69999999999999,121.53,Outgoing
23479459,2023-02-02,172.40999999999997,117.71,Incoming
23479459,2023-02-05,305.97999999999996,133.57,Incoming
23479459,2023-02-05,177.32999999999996,128.65,Outgoing
23479459,2023-02-06,126.46999999999996,50.86,Outgoing
23479459,2023-02-09,82.59999999999997,43.87,Outgoing
23490922,2023-01-31,934.35,,-
23490922,2023-02-06,1067.26,132.91,Incoming
23490922,2023-02-06,1144.21,76.95,Incoming
23490922,2023-02-07,1066.1100000000001,78.1,Outgoing
23490922,2023-02-10,990.1200000000001,75.99,Outgoing
23498368,2023-01-31,474.93,,-
23498368,2023-02-01,373.81,101.12,Outgoing
23498368,2023-02-06,532.87,159.06,Incoming
23498368,2023-02-06,425.55,107.32,Outgoing
23498368,2023-02-07,316.16,109.39,Outgoing
23498368,2023-02-11,223.62,92.54,Outgoing
23498368,2023-02-12,124.94,98.68,Outgoing
23498368,2023-02-12,113.52,11.42,Outgoing
23498368,2023-02-13,204.32,90.8,Incoming
23501735,2023-01-31,562.17,,-
23501735,2023-02-06,454.62999999999994,107.54,Outgoing
23501735,2023-02-08,605.1299999999999,150.5,Incoming
23501735,2023-02-09,647.3799999999999,42.25,Incoming
23501735,2023-02-10,696.2899999999998,48.91,Incoming
23501735,2023-02-11,772.0499999999998,75.76,Incoming
23501735,2023-02-12,629.2699999999999,142.78,Outgoing
23501735,2023-02-12,753.4399999999998,124.17,Incoming
23501735,2023-02-12,842.8799999999999,89.44,Incoming
23580422,2023-01-31,716.05,,-
23580422,2023-02-12,783.3,67.25,Incoming
23698615,2023-01-31,316.68,,-
23698615,2023-02-02,227.51,89.17,Outgoing
23698615,2023-02-05,113.02999999999999,114.48,Outgoing
23698615,2023-02-12,211.70999999999998,98.68,Incoming
23736501,2023-01-31,831.27,,-
23736501,2023-02-04,639.27,192.0,Outgoing
23736501,2023-02-04,796.95,157.68,Incoming
23736501,2023-02-07,871.72,74.77,Incoming
23736501,2023-02-09,689.35,182.37,Outgoing
23736501,2023-02-09,632.1600000000001,57.19,Outgoing
23736501,2023-02-09,668.22,36.06,Incoming
23736501,2023-02-10,875.19,206.97,Incoming
23736501,2023-02-11,917.6600000000001,42.47,Incoming
23736501,2023-02-14,832.1800000000001,85.48,Outgoing
23775829,2023-01-31,771.57,,-
23775829,2023-02-02,680.0,91.57,Outgoing
23775829,2023-02-02,614.47,65.53,Outgoing
23775829,2023-02-03,680.4100000000001,65.94,Incoming
23775829,2023-02-03,708.8800000000001,28.47,Incoming
23775829,2023-02-12,813.3900000000001,104.51,Incoming
23775829,2023-02-13,711.9000000000001,101.49,Outgoing
23815822,2023-01-31,835.0,,-
23815822,2023-02-03,-1047.4,1882.4,Outgoing
23815822,2023-02-03,-950.46,96.94,Incoming
23815822,2023-02-05,-839.49,110.97,Incoming
23815822,2023-02-13,-821.66,17.83,Incoming
23865100,2023-01-31,201.44,,-
23865100,2023-02-02,254.3,52.86,Incoming
23865100,2023-02-05,394.52,140.22,Incoming
23865100,2023-02-06,329.46999999999997,65.05,Outgoing
23865100,2023-02-07,243.01,86.46,Outgoing
23865100,2023-02-08,108.13,134.88,Outgoing
23865100,2023-02-08,24.929999999999993,83.2,Outgoing
23865100,2023-02-09,-39.620000000000005,64.55,Outgoing
23865100,2023-02-13,-57.540000000000006,17.92,Outgoing
23865100,2023-02-14,-125.09,67.55,Outgoing
23920423,2023-01-31,221.15,,-
23920423,2023-02-03,269.38,48.23,Incoming
23920423,2023-02-03,342.15,72.77,Incoming
23920423,2023-02-05,246.09999999999997,96.05,Outgoing
23920423,2023-02-05,309.30999999999995,63.21,Incoming
23920423,2023-02-08,296.35999999999996,12.95,Outgoing
23920423,2023-02-08,457.78999999999996,161.43,Incoming
23920423,2023-02-08,419.02,38.77,Outgoing
23920423,2023-02-11,277.30999999999995,141.71,Outgoing
23931414,2023-01-31,126.7,,-
23931414,2023-02-03,158.77,32.07,Incoming
23931414,2023-02-10,282.49,123.72,Incoming
23931414,2023-02-14,180.73000000000002,101.76,Outgoing
23932793,2023-01-31,962.8,,-
23932793,2023-02-13,1473.1999999999998,510.4,Incoming
23932793,2023-02-14,1508.1599999999999,34.96,Incoming
23935849,2023-01-31,888.11,,-
23935849,2023-02-11,784.1800000000001,103.93,Outgoing
23935849,2023-02-12,592.72,191.46,Outgoing
23935849,2023-02-14,549.82,42.9,Outgoing
23942646,2023-01-31,517.93,,-
23942646,2023-02-01,435.50999999999993,82.42,Outgoing
23942646,2023-02-04,539.5799999999999,104.07,Incoming
23942646,2023-02-06,641.5899999999999,102.01,Incoming
23942646,2023-02-07,536.4999999999999,105.09,Outgoing
23942646,2023-02-09,479.0499999999999,57.45,Outgoing
23959928,2023-01-31,878.83,,-
23959928,2023-02-03,-690.57,1569.4,Outgoing
23959928,2023-02-04,-687.09,3.48,Incoming
23959928,2023-02-07,-617.49,69.6,Incoming
23959928,2023-02-14,-658.61,41.12,Outgoing
23962863,2023-01-31,307.07,,-
23962863,2023-02-01,906.8699999999999,599.8,Incoming
23962863,2023-02-03,950.4799999999999,43.61,Incoming
23962863,2023-02-04,1486.2799999999997,535.8,Incoming
23962863,2023-02-05,1314.5299999999997,171.75,Outgoing
23962863,2023-02-07,2990.93,1676.4,Incoming
23962863,2023-02-11,2906.5699999999997,84.36,Outgoing
23962863,2023-02-13,2783.2999999999997,123.27,Outgoing
23962863,2023-02-13,2875.9399999999996,92.64,Incoming
23971753,2023-01-31,170.77,,-
23971753,2023-02-02,340.40999999999997,169.64,Incoming
23971753,2023-02-03,230.35999999999996,110.05,Outgoing
23971753,2023-02-08,54.38999999999996,175.97,Outgoing
23971753,2023-02-08,175.05999999999995,120.67,Incoming
23971753,2023-02-08,212.12999999999994,37.07,Incoming
23971753,2023-02-09,354.79999999999995,142.67,Incoming
23971753,2023-02-09,2012.8,1658.0,Incoming
23971753,2023-02-10,2061.34,48.54,Incoming
23971753,2023-02-14,1937.65,123.69,Outgoing
23971753,2023-02-14,2132.03,194.38,Incoming
24010877,2023-01-31,652.95,,-
24010877,2023-02-01,545.6600000000001,107.29,Outgoing
24010877,2023-02-02,634.83,89.17,Incoming
24010877,2023-02-05,789.8100000000001,154.98,Incoming
24010877,2023-02-10,777.33,12.48,Outgoing
24010877,2023-02-10,637.6800000000001,139.65,Outgoing
24010877,2023-02-10,662.99,25.31,Incoming
24010877,2023-02-11,540.03,122.96,Outgoing
24010877,2023-02-12,650.8399999999999,110.81,Incoming
24051672,2023-01-31,429.37,,-
24051672,2023-02-02,540.95,111.58,Incoming
24051672,2023-02-03,749.23,208.28,Incoming
24051672,2023-02-03,871.76,122.53,Incoming
24051672,2023-02-06,821.09,50.67,Outgoing
24051672,2023-02-06,1890.9900000000002,1069.9,Incoming
24051672,2023-02-08,1768.3400000000001,122.65,Outgoing
24051672,2023-02-08,1755.18,13.16,Outgoing
24076677,2023-01-31,494.74,,-
24076677,2023-02-04,351.82000000000005,142.92,Outgoing
24076677,2023-02-04,514.61,162.79,Incoming
24076677,2023-02-09,454.87,59.74,Outgoing
24076677,2023-02-12,334.09000000000003,120.78,Outgoing
24085667,2023-01-31,249.1,,-
24085667,2023-02-01,171.0,78.1,Outgoing
24085667,2023-02-03,210.9,39.9,Incoming
24085667,2023-02-07,113.26,97.64,Outgoing
24085667,2023-02-11,40.5,72.76,Outgoing
24085667,2023-02-12,-100.02000000000001,140.52,Outgoing
24085667,2023-02-13,2.329999999999984,102.35,Incoming
24085667,2023-02-14,-128.33,130.66,Outgoing
24113784,2023-01-31,47.67,,-
24113784,2023-02-03,1013.0699999999999,965.4,Incoming
24113784,2023-02-04,2039.77,1026.7,Incoming
24113784,2023-02-04,1863.78,175.99,Outgoing
24113784,2023-02-09,1826.25,37.53,Outgoing
24113784,2023-02-10,1694.87,131.38,Outgoing
24113784,2023-02-10,1596.1799999999998,98.69,Outgoing
24113784,2023-02-10,1651.56,55.38,Incoming
24113784,2023-02-11,2318.06,666.5,Incoming
24113784,2023-02-13,2240.83,77.23,Outgoing
24113784,2023-02-13,2316.9,76.07,Incoming
24113784,2023-02-13,2317.12,0.22,Incoming
24122572,2023-01-31,924.02,,-
24122572,2023-02-03,1002.3,78.28,Incoming
24122572,2023-02-04,842.03,160.27,Outgoing
24122572,2023-02-04,479.33,362.7,Outgoing
24122572,2023-02-06,329.91999999999996,149.41,Outgoing
24122572,2023-02-09,497.94999999999993,168.03,Incoming
24122572,2023-02-11,411.17999999999995,86.77,Outgoing
24122572,2023-02-11,552.93,141.75,Incoming
24122572,2023-02-13,455.15999999999997,97.77,Outgoing
24122572,2023-02-13,336.7,118.46,Outgoing
24123707,2023-01-31,327.69,,-
24123707,2023-02-02,207.43,120.26,Outgoing
24123707,2023-02-09,-1179.37,1386.8,Outgoing
24125563,2023-01-31,908.28,,-
24125563,2023-02-01,809.9499999999999,98.33,Outgoing
24125563,2023-02-06,883.4499999999999,73.5,Incoming
24125563,2023-02-10,758.9899999999999,124.46,Outgoing
24125563,2023-02-11,669.4899999999999,89.5,Outgoing
24125563,2023-02-13,651.6599999999999,17.83,Outgoing
24149353,2023-01-31,487.27,,-
24149353,2023-02-03,378.77,108.5,Outgoing
24149353,2023-02-06,215.11999999999998,163.65,Outgoing
24149353,2023-02-06,176.51,38.61,Outgoing
24149353,2023-02-06,1377.61,1201.1,Incoming
24150990,2023-01-31,365.31,,-
24150990,2023-02-02,253.73000000000002,111.58,Outgoing
24150990,2023-02-04,118.92000000000002,134.81,Outgoing
24150990,2023-02-04,166.31,47.39,Incoming
24150990,2023-02-05,250.36,84.05,Incoming
24150990,2023-02-06,168.26000000000002,82.1,Outgoing
24150990,2023-02-13,354.13,185.87,Incoming
24150990,2023-02-14,262.43,91.7,Outgoing
24178466,2023-01-31,330.91,,-
24178466,2023-02-06,251.44000000000003,79.47,Outgoing
24178466,2023-02-06,366.25,114.81,Incoming
24178466,2023-02-08,453.84000000000003,87.59,Incoming
24178466,2023-02-14,550.01,96.17,Incoming
24184530,2023-01-31,37.87,,-
24184530,2023-02-02,121.19999999999999,83.33,Incoming
24184530,2023-02-08,1482.1000000000001,1360.9,Incoming
24184530,2023-02-11,1657.2600000000002,175.16,Incoming
24184530,2023-02-12,1514.2600000000002,143.0,Outgoing
24198488,2023-01-31,578.35,,-
24198488,2023-02-02,747.33,168.98,Incoming
24198488,2023-02-05,652.95,94.38,Outgoing
24198488,2023-02-05,569.36,83.59,Outgoing
24198488,2023-02-05,435.79,133.57,Outgoing
24198488,2023-02-09,522.65,86.86,Incoming
24198488,2023-02-13,388.04999999999995,134.6,Outgoing
24250015,2023-01-31,592.59,,-
24250015,2023-02-01,460.13,132.46,Outgoing
24250015,2023-02-10,1331.33,871.2,Incoming
24250015,2023-02-10,1246.49,84.84,Outgoing
24250015,2023-02-11,1361.74,115.25,Incoming
24250015,2023-02-11,1253.88,107.86,Outgoing
24250015,2023-02-12,-100.51999999999998,1354.4,Outgoing
24285988,2023-01-31,783.9,,-
24285988,2023-02-02,625.62,158.28,Outgoing
24285988,2023-02-04,683.71,58.09,Incoming
24285988,2023-02-05,-279.5899999999999,963.3,Outgoing
24285988,2023-02-06,-130.5099999999999,149.08,Incoming
24285988,2023-02-06,-229.64999999999992,99.14,Outgoing
24285988,2023-02-14,-51.60999999999993,178.04,Incoming
24285988,2023-02-14,62.93000000000008,114.54,Incoming
24298516,2023-01-31,768.69,,-
24298516,2023-02-01,843.1200000000001,74.43,Incoming
24298516,2023-02-03,665.8900000000001,177.23,Outgoing
24298516,2023-02-09,602.1400000000001,63.75,Outgoing
24298516,2023-02-09,456.0400000000001,146.1,Outgoing
24299977,2023-01-31,199.33,,-
24299977,2023-02-01,417.47,218.14,Incoming
24299977,2023-02-01,430.84000000000003,13.37,Incoming
24299977,2023-02-01,493.79,62.95,Incoming
24299977,2023-02-01,582.78,88.99,Incoming
24299977,2023-02-02,467.9,114.88,Outgoing
24299977,2023-02-04,389.07,78.83,Outgoing
24299977,2023-02-06,566.7,177.63,Incoming
24299977,2023-02-08,655.1400000000001,88.44,Incoming
24299977,2023-02-10,794.6500000000001,139.51,Incoming
24299977,2023-02-11,897.4900000000001,102.84,Incoming
24299977,2023-02-13,779.0900000000001,118.4,Outgoing
24299977,2023-02-13,947.7700000000002,168.68,Incoming
24308337,2023-01-31,764.57,,-
24308337,2023-02-02,843.82,79.25,Incoming
24308337,2023-02-03,967.4200000000001,123.6,Incoming
24308337,2023-02-03,1854.02,886.6,Incoming
24308337,2023-02-07,3507.3199999999997,1653.3,Incoming
24308337,2023-02-09,3358.87,148.45,Outgoing
24308337,2023-02-11,3210.06,148.81,Outgoing
24308337,2023-02-12,3356.11,146.05,Incoming
24308337,2023-02-13,2396.51,959.6,Outgoing
24370240,2023-01-31,608.64,,-
24370240,2023-02-01,654.34,45.7,Incoming
24370240,2023-02-02,541.3100000000001,113.03,Outgoing
24370240,2023-02-06,678.6500000000001,137.34,Incoming
24370240,2023-02-07,718.19,39.54,Incoming
24370240,2023-02-08,-527.31,1245.5,Outgoing
24370240,2023-02-09,-616.04,88.73,Outgoing
24370240,2023-02-13,-752.9399999999999,136.9,Outgoing
24370240,2023-02-13,-906.56,153.62,Outgoing
24370240,2023-02-14,-970.3,63.74,Outgoing
24382889,2023-01-31,14.23,,-
24382889,2023-02-04,-54.53,68.76,Outgoing
24382889,2023-02-06,-124.21000000000001,69.68,Outgoing
24382889,2023-02-12,-192.58,68.37,Outgoing
24382889,2023-02-13,-146.26000000000002,46.32,Incoming
24406166,2023-01-31,746.97,,-
24406166,2023-02-09,614.49,132.48,Outgoing
24406166,2023-02-09,517.97,96.52,Outgoing
24406166,2023-02-10,368.36,149.61,Outgoing
24406166,2023-02-11,471.54,103.18,Incoming
24434457,2023-01-31,385.3,,-
24434457,2023-02-03,-1743.1000000000001,2128.4,Outgoing
24434457,2023-02-10,-1613.9900000000002,129.11,Incoming
24462859,2023-01-31,646.0,,-
24462859,2023-02-03,554.34,91.66,Outgoing
24462859,2023-02-04,453.40000000000003,100.94,Outgoing
24462859,2023-02-06,410.05,43.35,Outgoing
24462859,2023-02-07,530.69,120.64,Incoming
24462859,2023-02-08,394.31000000000006,136.38,Outgoing
24462859,2023-02-09,2249.81,1855.5,Incoming
24462859,2023-02-12,2270.02,20.21,Incoming
24510213,2023-01-31,142.59,,-
24510213,2023-02-10,275.59000000000003,133.0,Incoming
24510213,2023-02-14,219.47000000000003,56.12,Outgoing
24513968,2023-01-31,306.35,,-
24513968,2023-02-01,-970.85,1277.2,Outgoing
24513968,2023-02-03,-860.29,110.56,Incoming
24513968,2023-02-07,-748.92,111.37,Incoming
24513968,2023-02-13,-829.64,80.72,Outgoing
24516638,2023-01-31,426.16,,-
24516638,2023-02-04,507.02000000000004,80.86,Incoming
24516638,2023-02-09,385.68000000000006,121.34,Outgoing
24516638,2023-02-11,412.63000000000005,26.95,Incoming
24516638,2023-02-14,287.84000000000003,124.79,Outgoing
24516638,2023-02-14,170.60000000000002,117.24,Outgoing
24519138,2023-01-31,58.15,,-
24519138,2023-02-01,182.10999999999999,123.96,Incoming
24519138,2023-02-04,62.36999999999999,119.74,Outgoing
24519138,2023-02-06,804.67,742.3,Incoming
24519138,2023-02-10,764.9699999999999,39.7,Outgoing
24519138,2023-02-11,-122.83000000000004,887.8,Outgoing
24519138,2023-02-13,-289.81000000000006,166.98,Outgoing
24519138,2023-02-13,-237.04000000000005,52.77,Incoming
24519138,2023-02-13,-97.21000000000004,139.83,Incoming
24519138,2023-02-14,-223.57000000000005,126.36,Outgoing
24519138,2023-02-14,-67.19000000000005,156.38,Incoming
24529850,2023-01-31,800.79,,-
24529850,2023-02-03,695.72,105.07,Outgoing
24529850,2023-02-07,799.1500000000001,103.43,Incoming
24529850,2023-02-08,3082.35,2283.2,Incoming
24529850,2023-02-08,2946.47,135.88,Outgoing
24529850,2023-02-09,3082.77,136.3,Incoming
24529850,2023-02-09,3279.41,196.64,Incoming
24529850,2023-02-09,3382.6,103.19,Incoming
24529850,2023-02-09,3445.19,62.59,Incoming
24529850,2023-02-11,3567.9,122.71,Incoming
24529850,2023-02-14,3647.02,79.12,Incoming
24529850,2023-02-14,2981.7200000000003,665.3,Outgoing
24531428,2023-01-31,565.21,,-
24531428,2023-02-03,645.71,80.5,Incoming
24531428,2023-02-11,596.5600000000001,49.15,Outgoing
24531428,2023-02-12,685.6,89.04,Incoming
24533829,2023-01-31,190.8,,-
24533829,2023-02-01,72.18,118.62,Outgoing
24533829,2023-02-02,252.58,180.4,Incoming
24533829,2023-02-09,357.79,105.21,Incoming
24533829,2023-02-11,414.48,56.69,Incoming
24533829,2023-02-14,466.84000000000003,52.36,Incoming
24533935,2023-01-31,808.99,,-
24533935,2023-02-02,822.67,13.68,Incoming
24533935,2023-02-06,763.25,59.42,Outgoing
24533935,2023-02-06,878.11,114.86,Incoming
24533935,2023-02-07,759.9200000000001,118.19,Outgoing
24533935,2023-02-11,664.6500000000001,95.27,Outgoing
24533935,2023-02-12,702.0000000000001,37.35,Incoming
24533935,2023-02-14,616.8500000000001,85.15,Outgoing
24533935,2023-02-14,477.1100000000001,139.74,Outgoing
24539679,2023-01-31,768.68,,-
24539679,2023-02-02,-181.5200000000001,950.2,Outgoing
24539679,2023-02-02,-159.1300000000001,22.39,Incoming
24539679,2023-02-05,-217.6300000000001,58.5,Outgoing
24539679,2023-02-07,-1368.73,1151.1,Outgoing
24539679,2023-02-09,-1241.01,127.72,Incoming
24539679,2023-02-10,-1126.29,114.72,Incoming
24539679,2023-02-11,-1091.26,35.03,Incoming
24539679,2023-02-14,-1196.17,104.91,Outgoing
24539679,2023-02-14,-1127.5,68.67,Incoming
24539679,2023-02-14,-1001.56,125.94,Incoming
24577383,2023-01-31,911.96,,-
24577383,2023-02-02,823.86,88.1,Outgoing
24577383,2023-02-08,976.85,152.99,Incoming
24577383,2023-02-11,926.9100000000001,49.94,Outgoing
24577383,2023-02-11,806.3400000000001,120.57,Outgoing
24577383,2023-02-14,1998.0400000000002,1191.7,Incoming
24577383,2023-02-14,1866.5100000000002,131.53,Outgoing
24638469,2023-01-31,968.27,,-
24638469,2023-02-01,1178.1599999999999,209.89,Incoming
24638469,2023-02-11,1305.6499999999999,127.49,Incoming
24669065,2023-01-31,574.3,,-
24669065,2023-02-09,487.09,87.21,Outgoing
24669065,2023-02-11,561.6999999999999,74.61,Incoming
24669065,2023-02-11,626.7499999999999,65.05,Incoming
24669065,2023-02-14,788.8399999999999,162.09,Incoming
24715803,2023-01-31,684.75,,-
24715803,2023-02-06,553.15,131.6,Outgoing
24715803,2023-02-10,639.03,85.88,Incoming
24715803,2023-02-10,550.42,88.61,Outgoing
24715803,2023-02-13,668.38,117.96,Incoming
24715803,2023-02-14,748.84,80.46,Incoming
24725325,2023-01-31,567.17,,-
24725325,2023-02-04,594.9399999999999,27.77,Incoming
24725325,2023-02-06,673.2299999999999,78.29,Incoming
24725325,2023-02-06,816.53,143.3,Incoming
24725325,2023-02-08,967.0799999999999,150.55,Incoming
24725325,2023-02-09,837.2299999999999,129.85,Outgoing
24725325,2023-02-12,848.6499999999999,11.42,Incoming
24725325,2023-02-12,988.2099999999998,139.56,Incoming
24796881,2023-01-31,943.93,,-
24796881,2023-02-06,832.5999999999999,111.33,Outgoing
24796881,2023-02-08,743.5099999999999,89.09,Outgoing
24796881,2023-02-09,618.3799999999999,125.13,Outgoing
24796881,2023-02-10,707.9899999999999,89.61,Incoming
24796881,2023-02-14,565.81,142.18,Outgoing
24796881,2023-02-14,442.90999999999997,122.9,Outgoing
24796881,2023-02-14,495.64,52.73,Incoming
24826358,2023-01-31,923.46,,-
24826358,2023-02-06,1036.66,113.2,Incoming
24826358,2023-02-08,1188.13,151.47,Incoming
24826358,2023-02-08,1064.7,123.43,Outgoing
24826358,2023-02-09,1172.56,107.86,Incoming
24826358,2023-02-09,1342.75,170.19,Incoming
24826358,2023-02-10,987.55,355.2,Outgoing
24826358,2023-02-14,914.9399999999999,72.61,Outgoing
24849103,2023-01-31,381.36,,-
24849103,2023-02-01,464.77,83.41,Incoming
24849103,2023-02-02,569.05,104.28,Incoming
24849103,2023-02-05,743.18,174.13,Incoming
24849103,2023-02-10,599.4499999999999,143.73,Outgoing
24849103,2023-02-11,784.92,185.47,Incoming
24849103,2023-02-12,861.9399999999999,77.02,Incoming
24849103,2023-02-13,736.3299999999999,125.61,Outgoing
24849103,2023-02-13,878.53,142.2,Incoming
24849103,2023-02-14,860.3,18.23,Outgoing
24859951,2023-01-31,950.69,,-
24859951,2023-02-08,1155.6000000000001,204.91,Incoming
24859951,2023-02-09,1214.2900000000002,58.69,Incoming
24859951,2023-02-13,1289.0300000000002,74.74,Incoming
24860683,2023-01-31,982.97,,-
24860683,2023-02-01,1097.19,114.22,Incoming
24860683,2023-02-06,1105.54,8.35,Incoming
24860683,2023-02-06,941.64,163.9,Outgoing
24860683,2023-02-08,1882.6399999999999,941.0,Incoming
24860683,2023-02-09,1774.28,108.36,Outgoing
24860683,2023-02-10,1681.3799999999999,92.9,Outgoing
24860683,2023-02-10,1597.4399999999998,83.94,Outgoing
24976861,2023-01-31,982.53,,-
24976861,2023-02-01,890.5799999999999,91.95,Outgoing
24976861,2023-02-02,699.8999999999999,190.68,Outgoing
24976861,2023-02-04,764.8199999999998,64.92,Incoming
24976861,2023-02-04,897.8699999999999,133.05,Incoming
24976861,2023-02-06,793.7699999999999,104.1,Outgoing
24976861,2023-02-06,682.8699999999999,110.9,Outgoing
24976861,2023-02-10,537.3299999999999,145.54,Outgoing
24976861,2023-02-11,431.9099999999999,105.42,Outgoing
24976861,2023-02-14,397.8399999999999,34.07,Outgoing
24999129,2023-01-31,750.61,,-
24999129,2023-02-03,930.36,179.75,Incoming
24999129,2023-02-05,756.6800000000001,173.68,Outgoing
24999129,2023-02-09,832.47,75.79,Incoming
24999129,2023-02-09,870.6,38.13,Incoming
24999129,2023-02-13,800.3000000000001,70.3,Outgoing
24999129,2023-02-13,1531.7,731.4,Incoming
25004339,2023-01-31,120.44,,-
25004339,2023-02-03,41.19,79.25,Outgoing
25004339,2023-02-03,172.37,131.18,Incoming
25004339,2023-02-05,69.99000000000001,102.38,Outgoing
25004339,2023-02-05,13.480000000000011,56.51,Outgoing
25004339,2023-02-07,-78.64999999999998,92.13,Outgoing
25004339,2023-02-14,-157.92999999999998,79.28,Outgoing
25004339,2023-02-14,-68.50999999999998,89.42,Incoming
25006771,2023-01-31,600.16,,-
25006771,2023-02-01,-1427.54,2027.7,Outgoing
25006771,2023-02-01,-1571.37,143.83,Outgoing
25006771,2023-02-01,-1477.08,94.29,Incoming
25006771,2023-02-03,-1596.1799999999998,119.1,Outgoing
25006771,2023-02-04,-1701.9899999999998,105.81,Outgoing
25006771,2023-02-04,-1797.6299999999999,95.64,Outgoing
25006771,2023-02-12,-3945.5299999999997,2147.9,Outgoing
25033680,2023-01-31,639.47,,-
25033680,2023-02-01,1255.27,615.8,Incoming
25033680,2023-02-02,1667.57,412.3,Incoming
25033680,2023-02-02,1585.46,82.11,Outgoing
25033680,2023-02-07,1664.19,78.73,Incoming
25033680,2023-02-08,1833.5900000000001,169.4,Incoming
25033680,2023-02-09,1953.67,120.08,Incoming
25033680,2023-02-10,1811.1000000000001,142.57,Outgoing
25099734,2023-01-31,872.31,,-
25099734,2023-02-02,1050.19,177.88,Incoming
25099734,2023-02-03,1174.3700000000001,124.18,Incoming
25099734,2023-02-03,1292.23,117.86,Incoming
25099734,2023-02-04,1331.94,39.71,Incoming
25099734,2023-02-05,1138.02,193.92,Outgoing
25099734,2023-02-09,1293.24,155.22,Incoming
25099734,2023-02-14,1331.42,38.18,Incoming
25110012,2023-01-31,300.03,,-
25110012,2023-02-01,196.67999999999998,103.35,Outgoing
25110012,2023-02-06,301.53,104.85,Incoming
25110012,2023-02-08,431.39,129.86,Incoming
25110012,2023-02-09,425.2,6.19,Outgoing
25110012,2023-02-09,543.9,118.7,Incoming
25110012,2023-02-13,597.8299999999999,53.93,Incoming
25110012,2023-02-13,701.8499999999999,104.02,Incoming
25133996,2023-01-31,419.22,,-
25133996,2023-02-04,288.65000000000003,130.57,Outgoing
25133996,2023-02-04,391.98,103.33,Incoming
25133996,2023-02-07,566.75,174.77,Incoming
25133996,2023-02-08,601.13,34.38,Incoming
25133996,2023-02-11,493.73,107.4,Outgoing
25133996,2023-02-12,562.53,68.8,Incoming
25133996,2023-02-14,604.66,42.13,Incoming
25146667,2023-01-31,534.11,,-
25146667,2023-02-01,1364.81,830.7,Incoming
25146667,2023-02-10,1265.35,99.46,Outgoing
25146667,2023-02-11,1224.12,41.23,Outgoing
25146667,2023-02-12,1118.33,105.79,Outgoing
25146667,2023-02-13,889.1199999999999,229.21,Outgoing
25146667,2023-02-14,1090.8899999999999,201.77,Incoming
25146667,2023-02-14,1090.1599999999999,0.73,Outgoing
25146667,2023-02-14,960.9799999999998,129.18,Outgoing
25240031,2023-01-31,520.29,,-
25240031,2023-02-02,379.97999999999996,140.31,Outgoing
25240031,2023-02-03,254.20999999999998,125.77,Outgoing
25240031,2023-02-08,311.92999999999995,57.72,Incoming
25240031,2023-02-09,487.40999999999997,175.48,Incoming
25269707,2023-01-31,770.38,,-
25269707,2023-02-04,901.66,131.28,Incoming
25269707,2023-02-04,791.29,110.37,Outgoing
25269707,2023-02-04,880.18,88.89,Incoming
25269707,2023-02-08,812.25,67.93,Outgoing
25269707,2023-02-13,714.66,97.59,Outgoing
25281513,2023-01-31,618.78,,-
25281513,2023-02-02,540.5699999999999,78.21,Outgoing
25281513,2023-02-05,640.1399999999999,99.57,Incoming
25310962,2023-01-31,376.9,,-
25310962,2023-02-01,278.15999999999997,98.74,Outgoing
25310962,2023-02-02,336.85999999999996,58.7,Incoming
25310962,2023-02-05,471.80999999999995,134.95,Incoming
25310962,2023-02-06,693.93,222.12,Incoming
25318205,2023-01-31,582.9,,-
25318205,2023-02-03,723.41,140.51,Incoming
25318205,2023-02-07,885.14,161.73,Incoming
25318205,2023-02-07,982.81,97.67,Incoming
25318205,2023-02-10,892.7199999999999,90.09,Outgoing
25318205,2023-02-13,787.3199999999999,105.4,Outgoing
25406407,2023-01-31,394.05,,-
25406407,2023-02-01,337.99,56.06,Outgoing
25406407,2023-02-03,496.71000000000004,158.72,Incoming
25406407,2023-02-05,723.52,226.81,Incoming
25406407,2023-02-06,582.85,140.67,Outgoing
25406407,2023-02-07,462.23,120.62,Outgoing
25406407,2023-02-09,296.27,165.96,Outgoing
25406407,2023-02-10,471.21999999999997,174.95,Incoming
25406407,2023-02-10,501.14,29.92,Incoming
25406407,2023-02-11,434.52,66.62,Outgoing
25406407,2023-02-11,653.3299999999999,218.81,Incoming
25412464,2023-01-31,203.46,,-
25412464,2023-02-02,95.84,107.62,Outgoing
25412464,2023-02-03,183.44,87.6,Incoming
25412464,2023-02-04,-8.199999999999989,191.64,Outgoing
25412464,2023-02-04,-91.07,82.87,Outgoing
25412464,2023-02-05,-0.47999999999998977,90.59,Incoming
25412464,2023-02-07,-97.33999999999999,96.86,Outgoing
25412464,2023-02-09,-58.91999999999999,38.42,Incoming
25412464,2023-02-13,48.05000000000001,106.97,Incoming
25439304,2023-01-31,890.08,,-
25439304,2023-02-01,1016.48,126.4,Incoming
25439304,2023-02-05,1176.02,159.54,Incoming
25504032,2023-01-31,838.81,,-
25504032,2023-02-02,986.2299999999999,147.42,Incoming
25504032,2023-02-02,1076.11,89.88,Incoming
25504032,2023-02-06,1209.58,133.47,Incoming
25510430,2023-01-31,110.66,,-
25510430,2023-02-03,-48.56999999999999,159.23,Outgoing
25510430,2023-02-04,26.180000000000007,74.75,Incoming
25510430,2023-02-06,-1332.82,1359.0,Outgoing
25510430,2023-02-06,-1253.35,79.47,Incoming
25510430,2023-02-09,-1398.9299999999998,145.58,Outgoing
25510430,2023-02-09,-1311.7199999999998,87.21,Incoming
25510430,2023-02-09,-1168.4499999999998,143.27,Incoming
25510430,2023-02-10,-1261.3099999999997,92.86,Outgoing
25510430,2023-02-11,-1320.6099999999997,59.3,Outgoing
25522226,2023-01-31,428.21,,-
25522226,2023-02-02,335.59999999999997,92.61,Outgoing
25522226,2023-02-04,-1075.3000000000002,1410.9,Outgoing
25522226,2023-02-06,-913.9300000000002,161.37,Incoming
25522226,2023-02-07,-984.6900000000002,70.76,Outgoing
25522226,2023-02-10,-1095.8000000000002,111.11,Outgoing
25522226,2023-02-11,-1195.3700000000001,99.57,Outgoing
25522226,2023-02-11,-1354.0100000000002,158.64,Outgoing
25584693,2023-01-31,793.42,,-
25584693,2023-02-06,484.71999999999997,308.7,Outgoing
25584693,2023-02-06,388.53,96.19,Outgoing
25584693,2023-02-07,245.92999999999998,142.6,Outgoing
25584693,2023-02-08,-447.47,693.4,Outgoing
25584693,2023-02-09,-262.56000000000006,184.91,Incoming
25584693,2023-02-13,-407.75000000000006,145.19,Outgoing
25584693,2023-02-13,-309.30000000000007,98.45,Incoming
25584693,2023-02-13,-502.4000000000001,193.1,Outgoing
25584693,2023-02-14,-619.5200000000001,117.12,Outgoing
25596483,2023-01-31,595.87,,-
25596483,2023-02-02,756.49,160.62,Incoming
25596483,2023-02-05,676.26,80.23,Outgoing
25596483,2023-02-07,504.62,171.64,Outgoing
25596483,2023-02-10,399.27,105.35,Outgoing
25628234,2023-01-31,808.37,,-
25628234,2023-02-02,900.73,92.36,Incoming
25628234,2023-02-02,843.07,57.66,Outgoing
25628234,2023-02-07,799.76,43.31,Outgoing
25628234,2023-02-09,731.51,68.25,Outgoing
25628234,2023-02-09,891.05,159.54,Incoming
25628234,2023-02-12,750.8299999999999,140.22,Outgoing
25628234,2023-02-12,683.2299999999999,67.6,Outgoing
25636885,2023-01-31,755.58,,-
25636885,2023-02-02,735.47,20.11,Outgoing
25636885,2023-02-02,323.17,412.3,Outgoing
25636885,2023-02-08,230.31,92.86,Outgoing
25636885,2023-02-08,137.3,93.01,Outgoing
25636885,2023-02-10,-14.449999999999989,151.75,Outgoing
25636885,2023-02-10,1033.75,1048.2,Incoming
25636885,2023-02-12,1111.29,77.54,Incoming
25636885,2023-02-13,1251.59,140.3,Incoming
25677428,2023-01-31,307.44,,-
25677428,2023-02-03,363.79,56.35,Incoming
25677428,2023-02-07,249.51000000000002,114.28,Outgoing
25677428,2023-02-12,1850.81,1601.3,Incoming
25678043,2023-01-31,49.06,,-
25678043,2023-02-06,182.72,133.66,Incoming
25678043,2023-02-06,254.12,71.4,Incoming
25678043,2023-02-08,-2029.08,2283.2,Outgoing
25678043,2023-02-10,-1994.73,34.35,Incoming
25678043,2023-02-11,-1884.23,110.5,Incoming
25678043,2023-02-12,-1703.77,180.46,Incoming
25678043,2023-02-13,-1318.97,384.8,Incoming
25698177,2023-01-31,923.38,,-
25698177,2023-02-03,792.2,131.18,Outgoing
25698177,2023-02-04,916.26,124.06,Incoming
25698177,2023-02-04,860.68,55.58,Outgoing
25698177,2023-02-04,779.52,81.16,Outgoing
25698177,2023-02-06,-745.3800000000001,1524.9,Outgoing
25698177,2023-02-08,-896.0200000000001,150.64,Outgoing
25698177,2023-02-09,-1788.42,892.4,Outgoing
25698177,2023-02-11,-1606.31,182.11,Incoming
25698177,2023-02-12,-2398.1099999999997,791.8,Outgoing
25698177,2023-02-12,-2522.2799999999997,124.17,Outgoing
25710768,2023-01-31,968.16,,-
25737886,2023-01-31,410.76,,-
25737886,2023-02-04,288.78999999999996,121.97,Outgoing
25737886,2023-02-05,92.78999999999996,196.0,Outgoing
25737886,2023-02-10,-103.45000000000005,196.24,Outgoing
25737886,2023-02-11,19.50999999999995,122.96,Incoming
25737886,2023-02-11,-124.43000000000005,143.94,Outgoing
25737886,2023-02-11,-189.48000000000005,65.05,Outgoing
25737886,2023-02-12,-111.22000000000004,78.26,Incoming
25737886,2023-02-12,-218.31000000000006,107.09,Outgoing
25737886,2023-02-14,-337.4100000000001,119.1,Outgoing
25746852,2023-01-31,320.7,,-
25746852,2023-02-01,407.14,86.44,Incoming
25746852,2023-02-04,498.36,91.22,Incoming
25746852,2023-02-08,448.72,49.64,Outgoing
25746852,2023-02-10,1973.1200000000001,1524.4,Incoming
25746852,2023-02-12,1816.9900000000002,156.13,Outgoing
25746852,2023-02-13,1739.0800000000002,77.91,Outgoing
25746852,2023-02-14,3224.78,1485.7,Incoming
25768265,2023-01-31,702.22,,-
25768265,2023-02-02,2604.42,1902.2,Incoming
25768265,2023-02-06,4107.02,1502.6,Incoming
25768265,2023-02-06,3985.3000000000006,121.72,Outgoing
25768265,2023-02-08,3913.1300000000006,72.17,Outgoing
25768265,2023-02-09,3799.3100000000004,113.82,Outgoing
25768265,2023-02-10,3881.3100000000004,82.0,Incoming
25768265,2023-02-14,4026.3700000000003,145.06,Incoming
25779398,2023-01-31,967.13,,-
25779398,2023-02-02,1101.37,134.24,Incoming
25779398,2023-02-04,1035.05,66.32,Outgoing
25779398,2023-02-05,1135.1,100.05,Incoming
25779398,2023-02-11,1296.4299999999998,161.33,Incoming
25779398,2023-02-11,191.92999999999984,1104.5,Outgoing
25787771,2023-01-31,494.02,,-
25787771,2023-02-02,366.74,127.28,Outgoing
25787771,2023-02-06,212.27,154.47,Outgoing
25787771,2023-02-06,68.85000000000002,143.42,Outgoing
25787771,2023-02-07,811.65,742.8,Incoming
25787771,2023-02-07,747.24,64.41,Outgoing
25787771,2023-02-07,699.2,48.04,Outgoing
25787771,2023-02-08,816.5600000000001,117.36,Incoming
25787771,2023-02-09,741.58,74.98,Outgoing
25787771,2023-02-10,-921.0199999999999,1662.6,Outgoing
25787771,2023-02-10,-1071.32,150.3,Outgoing
25787771,2023-02-10,-942.3599999999999,128.96,Incoming
25787771,2023-02-11,-1068.5,126.14,Outgoing
25787771,2023-02-13,-1130.03,61.53,Outgoing
25787771,2023-02-13,-1284.84,154.81,Outgoing
25807378,2023-01-31,25.32,,-
25807378,2023-02-04,146.17,120.85,Incoming
25807378,2023-02-10,94.89999999999998,51.27,Outgoing
25893329,2023-01-31,211.58,,-
25893329,2023-02-08,430.48,218.9,Incoming
25893329,2023-02-12,606.51,176.03,Incoming
25931435,2023-01-31,127.08,,-
25931435,2023-02-01,196.6,69.52,Incoming
25931435,2023-02-07,-3.2600000000000193,199.86,Outgoing
25931435,2023-02-08,107.76999999999998,111.03,Incoming
25939481,2023-01-31,502.59,,-
25939481,2023-02-01,396.28999999999996,106.3,Outgoing
25939481,2023-02-05,497.74999999999994,101.46,Incoming
25939481,2023-02-10,445.72999999999996,52.02,Outgoing
25941557,2023-01-31,656.34,,-
25941557,2023-02-01,718.21,61.87,Incoming
25941557,2023-02-01,1536.6100000000001,818.4,Incoming
25941557,2023-02-02,1502.0500000000002,34.56,Outgoing
25941557,2023-02-03,1598.6800000000003,96.63,Incoming
25941557,2023-02-05,1636.6700000000003,37.99,Incoming
25941557,2023-02-06,1737.0100000000002,100.34,Incoming
25941557,2023-02-08,1867.4400000000003,130.43,Incoming
25941557,2023-02-10,1691.4900000000002,175.95,Outgoing
25941557,2023-02-10,1621.8100000000002,69.68,Outgoing
25941557,2023-02-12,20.51000000000022,1601.3,Outgoing
25941557,2023-02-13,-129.3899999999998,149.9,Outgoing
26008806,2023-01-31,553.23,,-
26008806,2023-02-02,347.74,205.49,Outgoing
26008806,2023-02-03,241.82,105.92,Outgoing
26008806,2023-02-05,410.03,168.21,Incoming
26008806,2023-02-05,289.0,121.03,Outgoing
26008806,2023-02-06,216.65,72.35,Outgoing
26023976,2023-01-31,681.17,,-
26023976,2023-02-03,590.51,90.66,Outgoing
26023976,2023-02-06,-295.39,885.9,Outgoing
26070761,2023-01-31,641.67,,-
26070761,2023-02-07,-435.13,1076.8,Outgoing
26070761,2023-02-11,-528.45,93.32,Outgoing
26070761,2023-02-13,-633.62,105.17,Outgoing
26070761,2023-02-14,-529.73,103.89,Incoming
26087369,2023-01-31,653.2,,-
26087369,2023-02-01,700.5300000000001,47.33,Incoming
26087369,2023-02-02,831.46,130.93,Incoming
26087369,2023-02-10,898.53,67.07,Incoming
26087369,2023-02-14,970.93,72.4,Incoming
26101648,2023-01-31,9.84,,-
26101648,2023-02-03,-67.03,76.87,Outgoing
26101648,2023-02-04,-164.97,97.94,Outgoing
26102798,2023-01-31,104.08,,-
26102798,2023-02-03,248.89999999999998,144.82,Incoming
26102798,2023-02-04,431.55999999999995,182.66,Incoming
26102798,2023-02-05,544.66,113.1,Incoming
26102798,2023-02-07,706.77,162.11,Incoming
26102798,2023-02-09,815.11,108.34,Incoming
26102798,2023-02-10,973.49,158.38,Incoming
26102798,2023-02-12,864.5,108.99,Outgoing
26102798,2023-02-14,1021.06,156.56,Incoming
26102798,2023-02-14,1079.69,58.63,Incoming
26102798,2023-02-14,1143.03,63.34,Incoming
26109213,2023-01-31,698.97,,-
26109213,2023-02-02,2285.5699999999997,1586.6,Incoming
26109213,2023-02-05,2312.4999999999995,26.93,Incoming
26109213,2023-02-05,997.3999999999996,1315.1,Outgoing
26109213,2023-02-06,941.5599999999996,55.84,Outgoing
26109213,2023-02-06,1014.9599999999996,73.4,Incoming
26109213,2023-02-08,910.7799999999995,104.18,Outgoing
26109213,2023-02-09,801.4599999999996,109.32,Outgoing
26109213,2023-02-09,907.2499999999995,105.79,Incoming
26109213,2023-02-12,825.8799999999995,81.37,Outgoing
26109213,2023-02-13,1018.9799999999996,193.1,Incoming
26115121,2023-01-31,466.67,,-
26115121,2023-02-03,551.46,84.79,Incoming
26115121,2023-02-03,406.85,144.61,Outgoing
26115121,2023-02-14,309.73,97.12,Outgoing
26118463,2023-01-31,981.0,,-
26118463,2023-02-01,853.54,127.46,Outgoing
26118463,2023-02-03,958.49,104.95,Incoming
26118463,2023-02-12,1054.89,96.4,Incoming
26248782,2023-01-31,70.58,,-
26248782,2023-02-02,200.81,130.23,Incoming
26248782,2023-02-06,129.29000000000002,71.52,Outgoing
26248782,2023-02-11,157.63000000000002,28.34,Incoming
26248782,2023-02-13,296.6,138.97,Incoming
26375186,2023-01-31,804.02,,-
26375186,2023-02-06,757.71,46.31,Outgoing
26375186,2023-02-06,660.1700000000001,97.54,Outgoing
26375186,2023-02-06,491.24000000000007,168.93,Outgoing
26375186,2023-02-06,645.99,154.75,Incoming
26375186,2023-02-07,520.03,125.96,Outgoing
26375186,2023-02-08,352.43999999999994,167.59,Outgoing
26375186,2023-02-10,426.42999999999995,73.99,Incoming
26375186,2023-02-11,561.81,135.38,Incoming
26375186,2023-02-14,-1089.0900000000001,1650.9,Outgoing
26432558,2023-01-31,465.32,,-
26432558,2023-02-01,437.96,27.36,Outgoing
26432558,2023-02-01,470.71,32.75,Incoming
26432558,2023-02-01,441.76,28.95,Outgoing
26432558,2023-02-01,252.69,189.07,Outgoing
26432558,2023-02-03,82.74000000000001,169.95,Outgoing
26432558,2023-02-04,222.25,139.51,Incoming
26432558,2023-02-06,196.39,25.86,Outgoing
26432558,2023-02-06,-1346.6100000000001,1543.0,Outgoing
26432558,2023-02-07,-224.71000000000004,1121.9,Incoming
26506201,2023-01-31,592.7,,-
26506201,2023-02-05,433.1600000000001,159.54,Outgoing
26506201,2023-02-05,476.44000000000005,43.28,Incoming
26506201,2023-02-07,340.75000000000006,135.69,Outgoing
26506201,2023-02-09,332.37000000000006,8.38,Outgoing
26506201,2023-02-11,1548.17,1215.8,Incoming
26522255,2023-01-31,283.67,,-
26522255,2023-02-02,340.51,56.84,Incoming
26522255,2023-02-08,1467.61,1127.1,Incoming
26522255,2023-02-13,2553.21,1085.6,Incoming
26522255,2023-02-14,2673.27,120.06,Incoming
26522255,2023-02-14,2802.52,129.25,Incoming
26528251,2023-01-31,539.97,,-
26528251,2023-02-11,648.5600000000001,108.59,Incoming
26528251,2023-02-13,803.9200000000001,155.36,Incoming
26528251,2023-02-14,701.3700000000001,102.55,Outgoing
26632358,2023-01-31,384.64,,-
26632358,2023-02-01,202.45,182.19,Outgoing
26632358,2023-02-01,21.619999999999976,180.83,Outgoing
26632358,2023-02-02,-40.08000000000003,61.7,Outgoing
26632358,2023-02-07,-1069.98,1029.9,Outgoing
26632358,2023-02-09,-1152.97,82.99,Outgoing
26632358,2023-02-11,-1128.07,24.9,Incoming
26632358,2023-02-13,-2615.77,1487.7,Outgoing
26643616,2023-01-31,260.1,,-
26643616,2023-02-01,169.31,90.79,Outgoing
26643616,2023-02-01,307.03,137.72,Incoming
26643616,2023-02-05,467.93999999999994,160.91,Incoming
26643616,2023-02-09,393.3399999999999,74.6,Outgoing
26643616,2023-02-11,222.44999999999993,170.89,Outgoing
26643616,2023-02-12,344.30999999999995,121.86,Incoming
26643616,2023-02-14,215.01999999999995,129.29,Outgoing
26669001,2023-01-31,70.04,,-
26669001,2023-02-03,49.010000000000005,21.03,Outgoing
26669001,2023-02-03,-7.299999999999997,56.31,Outgoing
26669001,2023-02-11,134.99,142.29,Incoming
26669001,2023-02-11,1453.09,1318.1,Incoming
26669001,2023-02-14,2087.09,634.0,Incoming
26669001,2023-02-14,2181.3,94.21,Incoming
26675311,2023-01-31,989.13,,-
26675311,2023-02-02,1104.01,114.88,Incoming
26675311,2023-02-07,1119.67,15.66,Incoming
26675311,2023-02-09,1274.96,155.29,Incoming
26675311,2023-02-09,1247.43,27.53,Outgoing
26675311,2023-02-11,1428.68,181.25,Incoming
26675311,2023-02-11,1470.54,41.86,Incoming
26675311,2023-02-11,1493.1599999999999,22.62,Incoming
26675311,2023-02-13,1617.4899999999998,124.33,Incoming
26675311,2023-02-14,1682.3599999999997,64.87,Incoming
26751921,2023-01-31,800.07,,-
26751921,2023-02-14,667.71,132.36,Outgoing
26751921,2023-02-14,540.37,127.34,Outgoing
26791907,2023-01-31,266.27,,-
26791907,2023-02-01,392.72999999999996,126.46,Incoming
26791907,2023-02-09,1016.9300000000001,624.2,Incoming
26791907,2023-02-12,937.1800000000001,79.75,Outgoing
26791907,2023-02-13,1118.72,181.54,Incoming
26793058,2023-01-31,384.98,,-
26793058,2023-02-03,340.39,44.59,Outgoing
26793058,2023-02-05,320.21999999999997,20.17,Outgoing
26793058,2023-02-06,-366.88000000000005,687.1,Outgoing
26793058,2023-02-08,-296.73,70.15,Incoming
26863880,2023-01-31,818.47,,-
26863880,2023-02-05,933.59,115.12,Incoming
26863880,2023-02-05,1022.2900000000001,88.7,Incoming
26863880,2023-02-07,1124.8300000000002,102.54,Incoming
26863880,2023-02-08,178.6300000000001,946.2,Outgoing
26863880,2023-02-09,286.10000000000014,107.47,Incoming
26863880,2023-02-14,184.57000000000014,101.53,Outgoing
26863880,2023-02-14,108.25000000000014,76.32,Outgoing
26874415,2023-01-31,19.62,,-
26874415,2023-02-02,2288.8199999999997,2269.2,Incoming
26874415,2023-02-03,2400.66,111.84,Incoming
26874415,2023-02-04,1877.06,523.6,Outgoing
26874415,2023-02-04,1790.32,86.74,Outgoing
26874415,2023-02-05,1694.97,95.35,Outgoing
26874415,2023-02-05,1573.56,121.41,Outgoing
26874415,2023-02-08,1626.55,52.99,Incoming
26874415,2023-02-11,1526.99,99.56,Outgoing
26884718,2023-01-31,573.65,,-
26884718,2023-02-01,459.17999999999995,114.47,Outgoing
26884718,2023-02-02,-23.52000000000004,482.7,Outgoing
26884718,2023-02-03,95.10999999999996,118.63,Incoming
26884718,2023-02-03,115.52999999999996,20.42,Incoming
26884718,2023-02-04,-34.85000000000004,150.38,Outgoing
26884718,2023-02-08,-184.68000000000006,149.83,Outgoing
26884718,2023-02-10,-137.67000000000007,47.01,Incoming
26884718,2023-02-11,-284.2300000000001,146.56,Outgoing
26888158,2023-01-31,473.02,,-
26888158,2023-02-02,488.78999999999996,15.77,Incoming
26888158,2023-02-02,417.90999999999997,70.88,Outgoing
26888158,2023-02-05,1440.21,1022.3,Incoming
26888158,2023-02-12,1260.28,179.93,Outgoing
26893181,2023-01-31,957.43,,-
26893181,2023-02-01,1023.3299999999999,65.9,Incoming
26893181,2023-02-01,906.67,116.66,Outgoing
26893181,2023-02-01,1075.85,169.18,Incoming
26893181,2023-02-03,1688.85,613.0,Incoming
26893181,2023-02-10,1599.74,89.11,Outgoing
26906533,2023-01-31,312.58,,-
26906533,2023-02-05,371.08,58.5,Incoming
26906533,2023-02-05,266.34,104.74,Outgoing
26906533,2023-02-07,300.98999999999995,34.65,Incoming
26906533,2023-02-08,287.66999999999996,13.32,Outgoing
26906533,2023-02-10,363.37999999999994,75.71,Incoming
26906533,2023-02-12,273.8999999999999,89.48,Outgoing
26906533,2023-02-14,223.07999999999993,50.82,Outgoing
26907311,2023-01-31,842.69,,-
26907311,2023-02-05,739.48,103.21,Outgoing
26907311,2023-02-05,1934.48,1195.0,Incoming
26907311,2023-02-07,2027.67,93.19,Incoming
26907311,2023-02-07,1901.94,125.73,Outgoing
26907311,2023-02-09,2062.48,160.54,Incoming
26907311,2023-02-10,2001.28,61.2,Outgoing
26907311,2023-02-13,1927.27,74.01,Outgoing
26953669,2023-01-31,813.21,,-
26953669,2023-02-01,731.99,81.22,Outgoing
26953669,2023-02-02,203.09000000000003,528.9,Outgoing
26953669,2023-02-03,303.51000000000005,100.42,Incoming
26953669,2023-02-09,227.72000000000003,75.79,Outgoing
26953669,2023-02-11,89.86000000000001,137.86,Outgoing
26958171,2023-01-31,837.04,,-
26958171,2023-02-02,953.14,116.1,Incoming
26958171,2023-02-05,944.09,9.05,Outgoing
26958171,2023-02-07,1058.83,114.74,Incoming
26958171,2023-02-11,1081.83,23.0,Incoming
26958171,2023-02-11,1062.59,19.24,Outgoing
26964507,2023-01-31,358.72,,-
26979446,2023-01-31,149.65,,-
26979446,2023-02-01,131.38,18.27,Outgoing
26979446,2023-02-03,-83.15,214.53,Outgoing
26979446,2023-02-07,-217.11,133.96,Outgoing
26979446,2023-02-11,-182.22000000000003,34.89,Incoming
26979446,2023-02-14,-111.82000000000002,70.4,Incoming
26985042,2023-01-31,248.7,,-
26985042,2023-02-02,364.95,116.25,Incoming
26985042,2023-02-03,469.77,104.82,Incoming
26985042,2023-02-03,241.17999999999998,228.59,Outgoing
26985042,2023-02-09,98.50999999999999,142.67,Outgoing
26985042,2023-02-12,152.60999999999999,54.1,Incoming
26985042,2023-02-14,28.419999999999987,124.19,Outgoing
27010847,2023-01-31,272.04,,-
27010847,2023-02-01,521.79,249.75,Incoming
27010847,2023-02-02,501.06999999999994,20.72,Outgoing
27010847,2023-02-02,632.5999999999999,131.53,Incoming
27010847,2023-02-02,505.6599999999999,126.94,Outgoing
27010847,2023-02-02,688.3699999999999,182.71,Incoming
27010847,2023-02-05,986.6699999999998,298.3,Incoming
27010847,2023-02-07,130.16999999999985,856.5,Outgoing
27010847,2023-02-07,29.76999999999984,100.4,Outgoing
27010847,2023-02-08,-106.14000000000016,135.91,Outgoing
27010847,2023-02-13,57.189999999999856,163.33,Incoming
27010847,2023-02-14,154.30999999999986,97.12,Incoming
27010847,2023-02-14,20.639999999999873,133.67,Outgoing
27108454,2023-01-31,423.96,,-
27108454,2023-02-02,317.36,106.6,Outgoing
27108454,2023-02-03,302.01,15.35,Outgoing
27108454,2023-02-08,204.01,98.0,Outgoing
27108454,2023-02-09,-1120.19,1324.2,Outgoing
27108454,2023-02-14,-1190.18,69.99,Outgoing
27117946,2023-01-31,342.03,,-
27117946,2023-02-05,321.71999999999997,20.31,Outgoing
27117946,2023-02-07,457.03999999999996,135.32,Incoming
27117946,2023-02-08,319.06999999999994,137.97,Outgoing
27117946,2023-02-13,410.49999999999994,91.43,Incoming
27170424,2023-01-31,211.66,,-
27170424,2023-02-04,362.45,150.79,Incoming
27170424,2023-02-09,474.0,111.55,Incoming
27170424,2023-02-10,333.43,140.57,Outgoing
27170424,2023-02-10,1169.33,835.9,Incoming
27193025,2023-01-31,187.57,,-
27193025,2023-02-01,132.87,54.7,Outgoing
27193025,2023-02-03,113.04,19.83,Outgoing
27193025,2023-02-04,217.28,104.24,Incoming
27193025,2023-02-05,98.89,118.39,Outgoing
27193025,2023-02-06,254.26,155.37,Incoming
27193025,2023-02-07,420.54999999999995,166.29,Incoming
27193025,2023-02-08,353.05999999999995,67.49,Outgoing
27193025,2023-02-10,305.30999999999995,47.75,Outgoing
27193025,2023-02-10,260.56999999999994,44.74,Outgoing
27193025,2023-02-11,203.87999999999994,56.69,Outgoing
27193025,2023-02-13,178.30999999999995,25.57,Outgoing
27193470,2023-01-31,479.57,,-
27193470,2023-02-02,547.98,68.41,Incoming
27193470,2023-02-03,630.39,82.41,Incoming
27193470,2023-02-04,524.5,105.89,Outgoing
27193470,2023-02-06,603.27,78.77,Incoming
27193470,2023-02-06,-883.6300000000001,1486.9,Outgoing
27193470,2023-02-07,-766.7700000000001,116.86,Incoming
27193470,2023-02-07,-1246.77,480.0,Outgoing
27193470,2023-02-08,-1129.24,117.53,Incoming
27193470,2023-02-08,-990.02,139.22,Incoming
27193470,2023-02-09,-871.56,118.46,Incoming
27193470,2023-02-12,-728.5799999999999,142.98,Incoming
27203821,2023-01-31,256.57,,-
27203821,2023-02-03,1122.67,866.1,Incoming
27203821,2023-02-07,970.44,152.23,Outgoing
27203821,2023-02-07,-709.3599999999999,1679.8,Outgoing
27203821,2023-02-09,-532.1599999999999,177.2,Incoming
27264533,2023-01-31,254.28,,-
27264533,2023-02-03,158.99,95.29,Outgoing
27264533,2023-02-07,94.91000000000001,64.08,Outgoing
27264533,2023-02-08,9.620000000000005,85.29,Outgoing
27305999,2023-01-31,17.22,,-
27305999,2023-02-03,134.39,117.17,Incoming
27305999,2023-02-03,319.40999999999997,185.02,Incoming
27334998,2023-01-31,817.28,,-
27334998,2023-02-05,716.71,100.57,Outgoing
27334998,2023-02-05,717.82,1.11,Incoming
27334998,2023-02-06,618.7900000000001,99.03,Outgoing
27334998,2023-02-07,789.44,170.65,Incoming
27334998,2023-02-08,919.82,130.38,Incoming
27356852,2023-01-31,414.82,,-
27356852,2023-02-01,254.06,160.76,Outgoing
27356852,2023-02-01,125.28,128.78,Outgoing
27356852,2023-02-03,224.7,99.42,Incoming
27356852,2023-02-04,-156.90000000000003,381.6,Outgoing
27356852,2023-02-04,-98.94000000000003,57.96,Incoming
27356852,2023-02-05,17.99999999999997,116.94,Incoming
27356852,2023-02-10,-1253.5,1271.5,Outgoing
27356852,2023-02-12,-1212.3,41.2,Incoming
27356852,2023-02-12,-1093.5,118.8,Incoming
27357010,2023-01-31,579.29,,-
27357010,2023-02-02,699.55,120.26,Incoming
27357010,2023-02-06,790.14,90.59,Incoming
27357010,2023-02-06,699.55,90.59,Outgoing
27357010,2023-02-09,598.31,101.24,Outgoing
27357010,2023-02-13,550.3,48.01,Outgoing
27357010,2023-02-14,672.77,122.47,Incoming
27382109,2023-01-31,174.95,,-
27382109,2023-02-01,111.47,63.48,Outgoing
27382109,2023-02-05,969.87,858.4,Incoming
27382109,2023-02-07,1105.96,136.09,Incoming
27382109,2023-02-07,1166.3600000000001,60.4,Incoming
27382109,2023-02-07,1212.19,45.83,Incoming
27382109,2023-02-13,23.789999999999964,1188.4,Outgoing
27382109,2023-02-14,212.50999999999996,188.72,Incoming
27388260,2023-01-31,39.64,,-
27388260,2023-02-04,-98.05999999999999,137.7,Outgoing
27388260,2023-02-07,-233.2,135.14,Outgoing
27388260,2023-02-07,-125.65999999999998,107.54,Incoming
27388260,2023-02-08,-18.23999999999998,107.42,Incoming
27388260,2023-02-09,-48.84999999999998,30.61,Outgoing
27388260,2023-02-11,-42.30999999999998,6.54,Incoming
27388260,2023-02-12,-152.2,109.89,Outgoing
27388260,2023-02-12,-201.57999999999998,49.38,Outgoing
27388260,2023-02-14,-324.94,123.36,Outgoing
27389680,2023-01-31,815.68,,-
27389680,2023-02-02,488.0799999999999,327.6,Outgoing
27389680,2023-02-05,469.94999999999993,18.13,Outgoing
27389680,2023-02-08,527.8799999999999,57.93,Incoming
27389680,2023-02-08,684.7399999999999,156.86,Incoming
27389680,2023-02-14,767.2199999999999,82.48,Incoming
27415805,2023-01-31,902.28,,-
27415805,2023-02-02,996.78,94.5,Incoming
27415805,2023-02-03,953.06,43.72,Outgoing
27415805,2023-02-06,2060.96,1107.9,Incoming
27415805,2023-02-07,2024.23,36.73,Outgoing
27415805,2023-02-09,2054.84,30.61,Incoming
27415805,2023-02-09,1929.7300000000002,125.11,Outgoing
27415805,2023-02-11,2102.05,172.32,Incoming
27430568,2023-01-31,450.45,,-
27430568,2023-02-01,550.5699999999999,100.12,Incoming
27430568,2023-02-01,737.02,186.45,Incoming
27430568,2023-02-02,1569.52,832.5,Incoming
27430568,2023-02-03,1677.32,107.8,Incoming
27430568,2023-02-03,1503.6499999999999,173.67,Outgoing
27430568,2023-02-06,1412.1499999999999,91.5,Outgoing
27430568,2023-02-09,1181.1799999999998,230.97,Outgoing
27430568,2023-02-10,1094.9099999999999,86.27,Outgoing
27430568,2023-02-11,1179.4999999999998,84.59,Incoming
27430568,2023-02-11,1270.1499999999999,90.65,Incoming
27430568,2023-02-12,2295.25,1025.1,Incoming
27580272,2023-01-31,352.81,,-
27580272,2023-02-03,237.06,115.75,Outgoing
27580272,2023-02-07,145.5,91.56,Outgoing
27580272,2023-02-09,209.95999999999998,64.46,Incoming
27582893,2023-01-31,639.21,,-
27582893,2023-02-02,737.3000000000001,98.09,Incoming
27582893,2023-02-03,883.6300000000001,146.33,Incoming
27582893,2023-02-03,1013.3600000000001,129.73,Incoming
27582893,2023-02-05,1118.69,105.33,Incoming
27582893,2023-02-14,1185.25,66.56,Incoming
27585212,2023-01-31,150.57,,-
27585212,2023-02-03,251.64,101.07,Incoming
27585212,2023-02-08,175.04999999999998,76.59,Outgoing
27589482,2023-01-31,494.03,,-
27589482,2023-02-01,364.49,129.54,Outgoing
27589482,2023-02-04,388.64,24.15,Incoming
27589482,2023-02-06,286.28999999999996,102.35,Outgoing
27589482,2023-02-09,415.85999999999996,129.57,Incoming
27589482,2023-02-13,401.29999999999995,14.56,Outgoing
27589482,2023-02-13,482.56999999999994,81.27,Incoming
27596004,2023-01-31,505.73,,-
27596004,2023-02-01,332.96000000000004,172.77,Outgoing
27596004,2023-02-01,-656.3399999999999,989.3,Outgoing
27596004,2023-02-01,-692.6399999999999,36.3,Outgoing
27596004,2023-02-06,-885.8799999999999,193.24,Outgoing
27596004,2023-02-09,-797.7199999999999,88.16,Incoming
27596004,2023-02-12,457.98000000000013,1255.7,Incoming
27596004,2023-02-14,717.2800000000002,259.3,Incoming
27596004,2023-02-14,716.8500000000003,0.43,Outgoing
27600956,2023-01-31,84.39,,-
27600956,2023-02-04,50.7,33.69,Outgoing
27600956,2023-02-05,154.97,104.27,Incoming
27600956,2023-02-08,49.620000000000005,105.35,Outgoing
27600956,2023-02-10,-59.47999999999999,109.1,Outgoing
27600956,2023-02-12,-256.77,197.29,Outgoing
27600956,2023-02-12,-273.33,16.56,Outgoing
27600956,2023-02-12,994.77,1268.1,Incoming
27600956,2023-02-14,859.41,135.36,Outgoing
27625709,2023-01-31,616.45,,-
27625709,2023-02-01,694.0600000000001,77.61,Incoming
27625709,2023-02-04,726.94,32.88,Incoming
27625709,2023-02-10,731.36,4.42,Incoming
27625709,2023-02-11,599.56,131.8,Outgoing
27625709,2023-02-14,752.79,153.23,Incoming
27625709,2023-02-14,624.4,128.39,Outgoing
27628187,2023-01-31,344.63,,-
27628187,2023-02-02,492.66999999999996,148.04,Incoming
27628187,2023-02-02,602.24,109.57,Incoming
27628187,2023-02-03,729.72,127.48,Incoming
27628187,2023-02-07,642.2,87.52,Outgoing
27713909,2023-01-31,199.77,,-
27713909,2023-02-02,120.52000000000001,79.25,Outgoing
27713909,2023-02-06,113.45000000000002,7.07,Outgoing
27713909,2023-02-09,-1046.55,1160.0,Outgoing
27806002,2023-01-31,565.08,,-
27806002,2023-02-07,537.33,27.75,Outgoing
27806002,2023-02-08,303.97,233.36,Outgoing
27806002,2023-02-14,783.87,479.9,Incoming
27821800,2023-01-31,322.23,,-
27821800,2023-02-06,716.73,394.5,Incoming
27821800,2023-02-10,793.05,76.32,Incoming
27821800,2023-02-13,734.43,58.62,Outgoing
27821800,2023-02-14,583.41,151.02,Outgoing
27845045,2023-01-31,136.91,,-
27845045,2023-02-01,56.00999999999999,80.9,Outgoing
27845045,2023-02-08,-61.07000000000001,117.08,Outgoing
27845045,2023-02-14,69.02,130.09,Incoming
27870202,2023-01-31,286.17,,-
27870202,2023-02-03,175.13,111.04,Outgoing
27870202,2023-02-07,-1438.0700000000002,1613.2,Outgoing
27870202,2023-02-08,-1451.6200000000001,13.55,Outgoing
27870202,2023-02-11,-1433.73,17.89,Incoming
27870202,2023-02-14,-1532.96,99.23,Outgoing
27985160,2023-01-31,446.21,,-
27985160,2023-02-02,1190.41,744.2,Incoming
27985160,2023-02-08,1323.01,132.6,Incoming
27985160,2023-02-09,1215.79,107.22,Outgoing
28053942,2023-01-31,70.94,,-
28053942,2023-02-01,1892.14,1821.2,Incoming
28053942,2023-02-02,2024.98,132.84,Incoming
28053942,2023-02-05,2866.1800000000003,841.2,Incoming
28053942,2023-02-05,2985.4600000000005,119.28,Incoming
28053942,2023-02-06,3060.6200000000003,75.16,Incoming
28063272,2023-01-31,252.41,,-
28063272,2023-02-04,96.84,155.57,Outgoing
28063272,2023-02-06,-105.21000000000001,202.05,Outgoing
28063272,2023-02-07,-299.22,194.01,Outgoing
28063272,2023-02-08,-1266.52,967.3,Outgoing
28063272,2023-02-08,-1140.61,125.91,Incoming
28063272,2023-02-09,-1034.75,105.86,Incoming
28063272,2023-02-10,-951.78,82.97,Incoming
28063272,2023-02-10,-786.15,165.63,Incoming
28063272,2023-02-10,-935.96,149.81,Outgoing
28063272,2023-02-14,-877.08,58.88,Incoming
28142099,2023-01-31,420.86,,-
28142099,2023-02-10,1555.46,1134.6,Incoming
28222331,2023-01-31,137.74,,-
28222331,2023-02-01,-2.359999999999985,140.1,Outgoing
28222331,2023-02-01,-105.11999999999999,102.76,Outgoing
28222331,2023-02-04,-135.48,30.36,Outgoing
28222331,2023-02-04,-67.54999999999998,67.93,Incoming
28222331,2023-02-07,-117.35999999999999,49.81,Outgoing
28240243,2023-01-31,850.7,,-
28240243,2023-02-01,972.77,122.07,Incoming
28240243,2023-02-08,1065.78,93.01,Incoming
28240243,2023-02-13,1241.1,175.32,Incoming
28247818,2023-01-31,150.24,,-
28247818,2023-02-01,74.72000000000001,75.52,Outgoing
28247818,2023-02-05,8.800000000000011,65.92,Outgoing
28247818,2023-02-07,-94.1,102.9,Outgoing
28247818,2023-02-07,-220.55,126.45,Outgoing
28247818,2023-02-09,-298.13,77.58,Outgoing
28247818,2023-02-10,-191.05,107.08,Incoming
28247818,2023-02-11,-220.81,29.76,Outgoing
28247818,2023-02-11,-286.03,65.22,Outgoing
28247818,2023-02-12,-405.96,119.93,Outgoing
28247818,2023-02-12,-338.36,67.6,Incoming
28247818,2023-02-12,-211.36,127.0,Incoming
28251857,2023-01-31,431.6,,-
28251857,2023-02-01,345.61,85.99,Outgoing
28251857,2023-02-02,435.99,90.38,Incoming
28251857,2023-02-02,-1065.31,1501.3,Outgoing
28251857,2023-02-05,-947.53,117.78,Incoming
28251857,2023-02-05,-948.02,0.49,Outgoing
28251857,2023-02-06,-1128.9099999999999,180.89,Outgoing
28251857,2023-02-10,-1024.3799999999999,104.53,Incoming
28251857,2023-02-10,-1045.31,20.93,Outgoing
28254911,2023-01-31,697.78,,-
28254911,2023-02-03,713.98,16.2,Incoming
28254911,2023-02-04,-174.91999999999996,888.9,Outgoing
28254911,2023-02-06,-43.319999999999965,131.6,Incoming
28254911,2023-02-06,-208.98999999999995,165.67,Outgoing
28254911,2023-02-07,-69.35999999999996,139.63,Incoming
28254911,2023-02-08,-160.23999999999995,90.88,Outgoing
28254911,2023-02-09,-228.85999999999996,68.62,Outgoing
28254911,2023-02-11,-862.06,633.2,Outgoing
28254911,2023-02-11,-739.7099999999999,122.35,Incoming
28254911,2023-02-11,-650.4899999999999,89.22,Incoming
28254911,2023-02-12,-503.4799999999999,147.01,Incoming
28254911,2023-02-12,-596.0099999999999,92.53,Outgoing
28254911,2023-02-14,-477.6299999999999,118.38,Incoming
28362321,2023-01-31,849.34,,-
28362321,2023-02-03,926.4100000000001,77.07,Incoming
28362321,2023-02-05,850.3000000000001,76.11,Outgoing
28362321,2023-02-07,791.22,59.08,Outgoing
28362321,2023-02-08,746.88,44.34,Outgoing
28362321,2023-02-10,816.5699999999999,69.69,Incoming
28362321,2023-02-10,-33.13000000000011,849.7,Outgoing
28362321,2023-02-10,-50.31000000000011,17.18,Outgoing
28362321,2023-02-12,564.0899999999999,614.4,Incoming
28380949,2023-01-31,937.24,,-
28380949,2023-02-01,1068.82,131.58,Incoming
28380949,2023-02-04,1127.2,58.38,Incoming
28380949,2023-02-04,2539.7,1412.5,Incoming
28380949,2023-02-05,2681.06,141.36,Incoming
28380949,2023-02-07,2663.67,17.39,Outgoing
28380949,2023-02-11,2090.4700000000003,573.2,Outgoing
28429440,2023-01-31,538.15,,-
28429440,2023-02-01,596.1,57.95,Incoming
28429440,2023-02-03,681.1600000000001,85.06,Incoming
28429440,2023-02-05,1152.56,471.4,Incoming
28429440,2023-02-07,1238.78,86.22,Incoming
28429440,2023-02-10,1179.47,59.31,Outgoing
28429440,2023-02-11,2275.5699999999997,1096.1,Incoming
28429440,2023-02-12,2095.3999999999996,180.17,Outgoing
28548067,2023-01-31,499.29,,-
28548067,2023-02-03,467.21000000000004,32.08,Outgoing
28548067,2023-02-05,366.34000000000003,100.87,Outgoing
28548067,2023-02-12,330.32000000000005,36.02,Outgoing
28553155,2023-01-31,147.09,,-
28553155,2023-02-01,278.45000000000005,131.36,Incoming
28553155,2023-02-03,385.12000000000006,106.67,Incoming
28553155,2023-02-05,250.17000000000007,134.95,Outgoing
28553155,2023-02-08,125.19000000000007,124.98,Outgoing
28553155,2023-02-09,22.780000000000072,102.41,Outgoing
28553155,2023-02-10,98.93000000000008,76.15,Incoming
28553155,2023-02-13,113.49000000000008,14.56,Incoming
28553155,2023-02-14,0.7700000000000813,112.72,Outgoing
28572979,2023-01-31,156.38,,-
28572979,2023-02-02,347.29999999999995,190.92,Incoming
28572979,2023-02-02,217.06999999999996,130.23,Outgoing
28572979,2023-02-04,-809.6300000000001,1026.7,Outgoing
28572979,2023-02-06,-599.2700000000001,210.36,Incoming
28572979,2023-02-09,-551.2200000000001,48.05,Incoming
28572979,2023-02-11,-382.3000000000002,168.92,Incoming
28572979,2023-02-12,-448.70000000000016,66.4,Outgoing
28595197,2023-01-31,897.68,,-
28595197,2023-02-02,829.5,68.18,Outgoing
28595197,2023-02-03,721.1800000000001,108.32,Outgoing
28595197,2023-02-04,1530.58,809.4,Incoming
28595197,2023-02-06,1564.6699999999998,34.09,Incoming
28595197,2023-02-07,2558.5699999999997,993.9,Incoming
28595197,2023-02-09,4165.17,1606.6,Incoming
28606808,2023-01-31,1.71,,-
28606808,2023-02-02,43.59,41.88,Incoming
28606808,2023-02-07,102.67,59.08,Incoming
28606808,2023-02-07,173.68,71.01,Incoming
28606808,2023-02-08,-784.1199999999999,957.8,Outgoing
28606808,2023-02-09,-644.4199999999998,139.7,Incoming
28629966,2023-01-31,60.86,,-
28629966,2023-02-02,8.75,52.11,Outgoing
28629966,2023-02-03,63.77,55.02,Incoming
28629966,2023-02-04,-8.719999999999992,72.49,Outgoing
28629966,2023-02-04,-17.349999999999994,8.63,Outgoing
28629966,2023-02-05,-125.66,108.31,Outgoing
28629966,2023-02-07,60.56999999999999,186.23,Incoming
28629966,2023-02-09,-43.31,103.88,Outgoing
28629966,2023-02-11,15.989999999999995,59.3,Incoming
28629966,2023-02-12,-82.21000000000001,98.2,Outgoing
28629966,2023-02-13,66.67999999999998,148.89,Incoming
28629966,2023-02-13,-59.780000000000015,126.46,Outgoing
28640713,2023-01-31,204.33,,-
28640713,2023-02-01,257.76,53.43,Incoming
28640713,2023-02-03,369.21999999999997,111.46,Incoming
28640713,2023-02-05,497.87,128.65,Incoming
28640713,2023-02-06,595.23,97.36,Incoming
28640713,2023-02-06,438.05,157.18,Outgoing
28640713,2023-02-06,344.3,93.75,Outgoing
28640713,2023-02-06,316.36,27.94,Outgoing
28640713,2023-02-07,306.84000000000003,9.52,Outgoing
28640713,2023-02-09,392.84000000000003,86.0,Incoming
28640713,2023-02-13,510.19000000000005,117.35,Incoming
28652960,2023-01-31,140.6,,-
28652960,2023-02-04,6.259999999999991,134.34,Outgoing
28652960,2023-02-04,-123.66,129.92,Outgoing
28652960,2023-02-06,-31.799999999999997,91.86,Incoming
28652960,2023-02-09,84.54,116.34,Incoming
28652960,2023-02-09,-130.21999999999997,214.76,Outgoing
28652960,2023-02-10,-327.93999999999994,197.72,Outgoing
28652960,2023-02-10,-297.91999999999996,30.02,Incoming
28652960,2023-02-11,-428.80999999999995,130.89,Outgoing
28652960,2023-02-12,-495.47999999999996,66.67,Outgoing
28652960,2023-02-13,-591.89,96.41,Outgoing
28652960,2023-02-13,-502.65999999999997,89.23,Incoming
28659160,2023-01-31,115.6,,-
28659160,2023-02-01,288.37,172.77,Incoming
28659160,2023-02-02,615.97,327.6,Incoming
28659160,2023-02-06,750.6500000000001,134.68,Incoming
28659160,2023-02-07,651.72,98.93,Outgoing
28680375,2023-01-31,337.2,,-
28680375,2023-02-02,252.54999999999998,84.65,Outgoing
28680375,2023-02-13,278.4,25.85,Incoming
28680375,2023-02-13,431.31999999999994,152.92,Incoming
28680375,2023-02-14,537.53,106.21,Incoming
28696496,2023-01-31,150.57,,-
28696496,2023-02-02,92.34,58.23,Outgoing
28696496,2023-02-08,212.89,120.55,Incoming
28696496,2023-02-09,130.34999999999997,82.54,Outgoing
28696496,2023-02-13,254.20999999999998,123.86,Incoming
28696496,2023-02-13,347.74,93.53,Incoming
28696496,2023-02-14,199.69,148.05,Outgoing
28738041,2023-01-31,907.31,,-
28738041,2023-02-02,955.66,48.35,Incoming
28738041,2023-02-07,-851.2400000000001,1806.9,Outgoing
28738041,2023-02-09,-948.1800000000001,96.94,Outgoing
28738041,2023-02-11,-1138.3600000000001,190.18,Outgoing
28738041,2023-02-12,-1072.3100000000002,66.05,Incoming
28738041,2023-02-13,-1015.6300000000002,56.68,Incoming
28738041,2023-02-14,-945.8400000000003,69.79,Incoming
28743137,2023-01-31,781.13,,-
28743137,2023-02-02,899.68,118.55,Incoming
28743137,2023-02-13,964.53,64.85,Incoming
28743137,2023-02-13,853.17,111.36,Outgoing
28745450,2023-01-31,157.38,,-
28745450,2023-02-01,-6.439999999999998,163.82,Outgoing
28745450,2023-02-06,71.37,77.81,Incoming
28745450,2023-02-09,23.410000000000004,47.96,Outgoing
28745450,2023-02-09,-90.09,113.5,Outgoing
28745450,2023-02-12,90.35,180.44,Incoming
28754062,2023-01-31,16.41,,-
28781155,2023-01-31,555.55,,-
28781155,2023-02-02,456.2099999999999,99.34,Outgoing
28781155,2023-02-06,350.9599999999999,105.25,Outgoing
28781155,2023-02-10,418.3699999999999,67.41,Incoming
28781155,2023-02-11,528.31,109.94,Incoming
28781155,2023-02-11,493.49999999999994,34.81,Outgoing
28811285,2023-01-31,813.63,,-
28811285,2023-02-03,1040.68,227.05,Incoming
28811285,2023-02-04,1126.8300000000002,86.15,Incoming
28811285,2023-02-08,1237.6100000000001,110.78,Incoming
28811285,2023-02-12,-296.9899999999998,1534.6,Outgoing
28819175,2023-01-31,414.48,,-
28819175,2023-02-01,458.77000000000004,44.29,Incoming
28819175,2023-02-02,438.20000000000005,20.57,Outgoing
28819175,2023-02-03,374.91,63.29,Outgoing
28819175,2023-02-06,553.86,178.95,Incoming
28819175,2023-02-09,917.6600000000001,363.8,Incoming
28819175,2023-02-09,1009.48,91.82,Incoming
28819175,2023-02-11,1164.97,155.49,Incoming
28822117,2023-01-31,204.79,,-
28822117,2023-02-01,303.53,98.74,Incoming
28822117,2023-02-05,-718.77,1022.3,Outgoing
28822117,2023-02-07,-674.91,43.86,Incoming
28909144,2023-01-31,263.97,,-
28909144,2023-02-04,231.09000000000003,32.88,Outgoing
28909144,2023-02-04,198.58000000000004,32.51,Outgoing
28909144,2023-02-05,265.38000000000005,66.8,Incoming
28909144,2023-02-08,99.59000000000006,165.79,Outgoing
28909144,2023-02-14,129.59000000000006,30.0,Incoming
28911002,2023-01-31,858.06,,-
28911002,2023-02-01,-281.6400000000001,1139.7,Outgoing
28911002,2023-02-02,-144.6100000000001,137.03,Incoming
28911002,2023-02-06,-21.9200000000001,122.69,Incoming
28911002,2023-02-11,53.1099999999999,75.03,Incoming
28911002,2023-02-11,2.9799999999998974,50.13,Outgoing
28969443,2023-01-31,12.77,,-
28969443,2023-02-07,498.66999999999996,485.9,Incoming
28969443,2023-02-08,577.73,79.06,Incoming
28969443,2023-02-09,548.02,29.71,Outgoing
28969443,2023-02-14,659.22,111.2,Incoming
28976546,2023-01-31,454.25,,-
28976546,2023-02-01,583.08,128.83,Incoming
28976546,2023-02-05,523.88,59.2,Outgoing
28976546,2023-02-06,595.42,71.54,Incoming
28976546,2023-02-09,644.02,48.6,Incoming
29000698,2023-01-31,954.02,,-
29000698,2023-02-06,1051.56,97.54,Incoming
29000698,2023-02-07,1006.5799999999999,44.98,Outgoing
29000698,2023-02-11,989.9899999999999,16.59,Outgoing
29000698,2023-02-12,798.3799999999999,191.61,Outgoing
29017229,2023-01-31,950.07,,-
29017229,2023-02-02,854.87,95.2,Outgoing
29017229,2023-02-03,1038.31,183.44,Incoming
29017229,2023-02-03,858.77,179.54,Outgoing
29017229,2023-02-04,-388.1300000000001,1246.9,Outgoing
29017229,2023-02-06,-198.2900000000001,189.84,Incoming
29017229,2023-02-14,-270.1700000000001,71.88,Outgoing
29039134,2023-01-31,218.26,,-
29039134,2023-02-05,103.16,115.1,Outgoing
29039134,2023-02-08,-142.64000000000001,245.8,Outgoing
29039134,2023-02-11,-225.40000000000003,82.76,Outgoing
29039134,2023-02-12,-1636.5,1411.1,Outgoing
29039134,2023-02-12,-1734.32,97.82,Outgoing
29039134,2023-02-14,-1838.96,104.64,Outgoing
29039134,2023-02-14,-2397.76,558.8,Outgoing
29043142,2023-01-31,210.89,,-
29043142,2023-02-09,321.4,110.51,Incoming
29043142,2023-02-11,436.01,114.61,Incoming
29043142,2023-02-12,368.76,67.25,Outgoing
29043142,2023-02-12,509.77,141.01,Incoming
29052260,2023-01-31,639.05,,-
29052260,2023-02-03,506.09999999999997,132.95,Outgoing
29052260,2023-02-05,416.58,89.52,Outgoing
29052260,2023-02-10,299.33,117.25,Outgoing
29061354,2023-01-31,180.47,,-
29061354,2023-02-05,178.22,2.25,Outgoing
29061354,2023-02-07,85.41,92.81,Outgoing
29061354,2023-02-11,139.69,54.28,Incoming
29061354,2023-02-11,-527.4100000000001,667.1,Outgoing
29074095,2023-01-31,512.38,,-
29074095,2023-02-01,425.47,86.91,Outgoing
29074095,2023-02-02,1349.47,924.0,Incoming
29074095,2023-02-07,1514.32,164.85,Incoming
29074095,2023-02-11,1601.46,87.14,Incoming
29074095,2023-02-12,1711.6000000000001,110.14,Incoming
29074095,2023-02-13,1777.14,65.54,Incoming
29074095,2023-02-13,1592.22,184.92,Outgoing
29222005,2023-01-31,0.34,,-
29222005,2023-02-03,-98.19,98.53,Outgoing
29222005,2023-02-05,11.439999999999998,109.63,Incoming
29222005,2023-02-05,130.86,119.42,Incoming
29222005,2023-02-07,50.500000000000014,80.36,Outgoing
29222005,2023-02-12,-43.499999999999986,94.0,Outgoing
29238925,2023-01-31,574.82,,-
29238925,2023-02-04,572.38,2.44,Outgoing
29238925,2023-02-09,525.31,47.07,Outgoing
29238925,2023-02-11,1413.11,887.8,Incoming
29238925,2023-02-14,2369.31,956.2,Incoming
29288598,2023-01-31,386.76,,-
29288598,2023-02-03,185.62,201.14,Outgoing
29288598,2023-02-04,269.77,84.15,Incoming
29288598,2023-02-06,195.14999999999998,74.62,Outgoing
29288598,2023-02-07,86.01999999999998,109.13,Outgoing
29288598,2023-02-08,-179.02000000000004,265.04,Outgoing
29288598,2023-02-11,-36.55000000000004,142.47,Incoming
29288598,2023-02-13,100.79999999999995,137.35,Incoming
29288598,2023-02-14,-1194.8,1295.6,Outgoing
29288598,2023-02-14,-1338.3999999999999,143.6,Outgoing
29303323,2023-01-31,525.6,,-
29303323,2023-02-02,669.4200000000001,143.82,Incoming
29303323,2023-02-02,773.1700000000001,103.75,Incoming
29303323,2023-02-03,636.5600000000001,136.61,Outgoing
29303323,2023-02-04,500.05000000000007,136.51,Outgoing
29303323,2023-02-09,-801.4499999999999,1301.5,Outgoing
29303323,2023-02-09,-658.9499999999999,142.5,Incoming
29303323,2023-02-13,-844.8199999999999,185.87,Outgoing
29303323,2023-02-13,-971.68,126.86,Outgoing
29358670,2023-01-31,874.94,,-
29358670,2023-02-01,782.08,92.86,Outgoing
29358670,2023-02-06,608.1600000000001,173.92,Outgoing
29358670,2023-02-08,658.5400000000001,50.38,Incoming
29358670,2023-02-08,779.1100000000001,120.57,Incoming
29358670,2023-02-09,673.5400000000002,105.57,Outgoing
29358670,2023-02-09,756.9200000000002,83.38,Incoming
29358670,2023-02-11,670.2300000000002,86.69,Outgoing
29358670,2023-02-11,548.7200000000003,121.51,Outgoing
29358670,2023-02-12,1732.5200000000002,1183.8,Incoming
29358670,2023-02-13,1789.3700000000001,56.85,Incoming
29422349,2023-01-31,623.61,,-
29422349,2023-02-08,532.5,91.11,Outgoing
29422349,2023-02-10,388.23,144.27,Outgoing
29422349,2023-02-13,534.0600000000001,145.83,Incoming
29464742,2023-01-31,557.11,,-
29464742,2023-02-02,470.8,86.31,Outgoing
29464742,2023-02-07,259.03,211.77,Outgoing
29464742,2023-02-08,351.85999999999996,92.83,Incoming
29464742,2023-02-14,499.09999999999997,147.24,Incoming
29473763,2023-01-31,724.82,,-
29473763,2023-02-05,805.48,80.66,Incoming
29473763,2023-02-08,661.4200000000001,144.06,Outgoing
29473763,2023-02-14,802.6300000000001,141.21,Incoming
29489865,2023-01-31,854.53,,-
29489865,2023-02-03,964.1899999999999,109.66,Incoming
29489865,2023-02-06,849.89,114.3,Outgoing
29489865,2023-02-10,1019.36,169.47,Incoming
29489865,2023-02-11,990.11,29.25,Outgoing
29489865,2023-02-11,1072.49,82.38,Incoming
29489865,2023-02-14,949.52,122.97,Outgoing
29523226,2023-01-31,807.56,,-
29523226,2023-02-01,704.9599999999999,102.6,Outgoing
29523226,2023-02-03,636.1099999999999,68.85,Outgoing
29523226,2023-02-03,684.8999999999999,48.79,Incoming
29523226,2023-02-05,493.42999999999984,191.47,Outgoing
29523226,2023-02-05,583.4899999999998,90.06,Incoming
29523226,2023-02-05,657.4799999999998,73.99,Incoming
29523226,2023-02-06,792.4399999999998,134.96,Incoming
29523226,2023-02-06,733.7299999999998,58.71,Outgoing
29523226,2023-02-08,817.0599999999998,83.33,Incoming
29523226,2023-02-09,562.1399999999999,254.92,Outgoing
29523226,2023-02-10,646.0799999999999,83.94,Incoming
29523226,2023-02-13,582.9999999999999,63.08,Outgoing
29523226,2023-02-13,557.1499999999999,25.85,Outgoing
29527534,2023-01-31,355.57,,-
29527534,2023-02-03,478.53999999999996,122.97,Incoming
29527534,2023-02-04,379.15,99.39,Outgoing
29527534,2023-02-10,527.78,148.63,Incoming
29527534,2023-02-11,441.5,86.28,Outgoing
29608056,2023-01-31,248.43,,-
29608056,2023-02-03,186.52,61.91,Outgoing
29608056,2023-02-03,292.44,105.92,Incoming
29608056,2023-02-06,407.63,115.19,Incoming
29608056,2023-02-06,320.73,86.9,Outgoing
29608056,2023-02-07,1931.13,1610.4,Incoming
29608056,2023-02-11,2062.9300000000003,131.8,Incoming
29608056,2023-02-12,1935.9600000000003,126.97,Outgoing
29608056,2023-02-12,1884.3000000000002,51.66,Outgoing
29608056,2023-02-12,1749.94,134.36,Outgoing
29608056,2023-02-12,1653.0700000000002,96.87,Outgoing
29631870,2023-01-31,694.99,,-
29631870,2023-02-02,616.38,78.61,Outgoing
29631870,2023-02-02,-521.62,1138.0,Outgoing
29631870,2023-02-04,-590.16,68.54,Outgoing
29631870,2023-02-04,-515.9499999999999,74.21,Incoming
29631870,2023-02-12,-629.4,113.45,Outgoing
29631870,2023-02-14,-539.3299999999999,90.07,Incoming
29638033,2023-01-31,537.95,,-
29638033,2023-02-01,2313.55,1775.6,Incoming
29638033,2023-02-01,2443.07,129.52,Incoming
29638033,2023-02-02,4333.07,1890.0,Incoming
29638033,2023-02-03,4436.86,103.79,Incoming
29638033,2023-02-08,4476.94,40.08,Incoming
29638033,2023-02-11,4566.44,89.5,Incoming
29638033,2023-02-12,4444.12,122.32,Outgoing
29638033,2023-02-14,4578.54,134.42,Incoming
29639626,2023-01-31,985.7,,-
29639626,2023-02-04,1098.3500000000001,112.65,Incoming
29639626,2023-02-05,962.4700000000001,135.88,Outgoing
29639626,2023-02-06,1021.2600000000001,58.79,Incoming
29639626,2023-02-10,917.5900000000001,103.67,Outgoing
29639626,2023-02-10,932.8400000000001,15.25,Incoming
29639626,2023-02-13,890.9900000000001,41.85,Outgoing
29639626,2023-02-13,1054.7,163.71,Incoming
29705419,2023-01-31,799.07,,-
29705419,2023-02-02,709.19,89.88,Outgoing
29705419,2023-02-03,1458.89,749.7,Incoming
29705419,2023-02-03,1396.0,62.89,Outgoing
29705419,2023-02-06,1246.92,149.08,Outgoing
29705419,2023-02-08,1113.38,133.54,Outgoing
29705419,2023-02-09,1212.97,99.59,Incoming
29705419,2023-02-13,1318.93,105.96,Incoming
29878790,2023-01-31,360.74,,-
29878790,2023-02-13,454.93,94.19,Incoming
29887258,2023-01-31,392.91,,-
29887258,2023-02-05,289.11,103.8,Outgoing
29887258,2023-02-08,306.74,17.63,Incoming
29887258,2023-02-13,463.83000000000004,157.09,Incoming
29887258,2023-02-14,341.36,122.47,Outgoing
29887258,2023-02-14,166.29000000000002,175.07,Outgoing
29920698,2023-01-31,922.07,,-
29920698,2023-02-02,1030.16,108.09,Incoming
29920698,2023-02-04,982.83,47.33,Outgoing
29920698,2023-02-04,937.3000000000001,45.53,Outgoing
29920698,2023-02-05,2412.7000000000003,1475.4,Incoming
29920698,2023-02-08,2334.86,77.84,Outgoing
29920698,2023-02-13,2248.6600000000003,86.2,Outgoing
29958061,2023-01-31,17.43,,-
29958061,2023-02-01,-75.85,93.28,Outgoing
29958061,2023-02-02,-179.24,103.39,Outgoing
29958061,2023-02-02,-150.94,28.3,Incoming
29958061,2023-02-03,-318.55,167.61,Outgoing
29958061,2023-02-04,-434.11,115.56,Outgoing
29958061,2023-02-07,-617.22,183.11,Outgoing
29958061,2023-02-08,-512.9000000000001,104.32,Incoming
29958061,2023-02-12,-1127.3000000000002,614.4,Outgoing
30030650,2023-01-31,414.27,,-
30030650,2023-02-06,318.12,96.15,Outgoing
30030650,2023-02-07,417.86,99.74,Incoming
30030650,2023-02-08,338.29,79.57,Outgoing
30030650,2023-02-08,197.84000000000003,140.45,Outgoing
30030650,2023-02-13,221.64000000000004,23.8,Incoming
30058030,2023-01-31,39.21,,-
30058030,2023-02-02,107.39000000000001,68.18,Incoming
30058030,2023-02-03,0.8500000000000085,106.54,Outgoing
30058030,2023-02-12,-36.849999999999994,37.7,Outgoing
30058030,2023-02-12,-126.49,89.64,Outgoing
30058030,2023-02-14,696.51,823.0,Incoming
30058030,2023-02-14,627.24,69.27,Outgoing
30093672,2023-01-31,939.77,,-
30093672,2023-02-04,817.9399999999999,121.83,Outgoing
30093672,2023-02-05,755.1999999999999,62.74,Outgoing
30093672,2023-02-06,721.1099999999999,34.09,Outgoing
30093672,2023-02-06,800.4299999999998,79.32,Incoming
30093672,2023-02-08,1802.4299999999998,1002.0,Incoming
30093672,2023-02-09,1795.31,7.12,Outgoing
30093672,2023-02-10,1937.3799999999999,142.07,Incoming
30093672,2023-02-11,1828.9699999999998,108.41,Outgoing
30093672,2023-02-12,1957.9699999999998,129.0,Incoming
30110747,2023-01-31,949.76,,-
30110747,2023-02-01,851.37,98.39,Outgoing
30110747,2023-02-03,1009.95,158.58,Incoming
30110747,2023-02-03,1235.8400000000001,225.89,Incoming
30110747,2023-02-06,1165.7400000000002,70.1,Outgoing
30110747,2023-02-07,1096.4000000000003,69.34,Outgoing
30110747,2023-02-10,1134.2300000000002,37.83,Incoming
30110747,2023-02-13,991.0900000000003,143.14,Outgoing
30112323,2023-01-31,519.73,,-
30112323,2023-02-01,532.04,12.31,Incoming
30112323,2023-02-01,493.13,38.91,Outgoing
30112323,2023-02-01,393.45,99.68,Outgoing
30112323,2023-02-04,529.91,136.46,Incoming
30112323,2023-02-07,557.38,27.47,Incoming
30112323,2023-02-08,1937.1799999999998,1379.8,Incoming
30112323,2023-02-09,432.4799999999998,1504.7,Outgoing
30112323,2023-02-14,549.7799999999997,117.3,Incoming
30196319,2023-01-31,721.4,,-
30196319,2023-02-01,753.79,32.39,Incoming
30196319,2023-02-06,628.5899999999999,125.2,Outgoing
30196319,2023-02-09,746.8,118.21,Incoming
30196319,2023-02-10,842.78,95.98,Incoming
30227774,2023-01-31,546.85,,-
30227774,2023-02-01,646.15,99.3,Incoming
30227774,2023-02-05,599.29,46.86,Outgoing
30227774,2023-02-09,509.53999999999996,89.75,Outgoing
30227774,2023-02-11,655.5699999999999,146.03,Incoming
30235398,2023-01-31,973.95,,-
30235398,2023-02-02,919.01,54.94,Outgoing
30235398,2023-02-02,1041.3899999999999,122.38,Incoming
30235398,2023-02-13,1104.4699999999998,63.08,Incoming
30237685,2023-01-31,751.93,,-
30237685,2023-02-06,941.1099999999999,189.18,Incoming
30237685,2023-02-10,109.70999999999992,831.4,Outgoing
30237685,2023-02-12,14.459999999999923,95.25,Outgoing
30279114,2023-01-31,951.13,,-
30279114,2023-02-01,806.8199999999999,144.31,Outgoing
30279114,2023-02-02,1038.72,231.9,Incoming
30279114,2023-02-08,1105.69,66.97,Incoming
30279114,2023-02-09,1316.49,210.8,Incoming
30312615,2023-01-31,659.36,,-
30312615,2023-02-05,2512.06,1852.7,Incoming
30312615,2023-02-06,2434.83,77.23,Outgoing
30312615,2023-02-07,2550.87,116.04,Incoming
30312615,2023-02-12,2709.44,158.57,Incoming
30312615,2023-02-12,2266.34,443.1,Outgoing
30312615,2023-02-13,2403.2400000000002,136.9,Incoming
30324819,2023-01-31,823.45,,-
30324819,2023-02-02,354.15000000000003,469.3,Outgoing
30324819,2023-02-03,197.00000000000003,157.15,Outgoing
30324819,2023-02-05,327.70000000000005,130.7,Incoming
30324819,2023-02-05,469.21000000000004,141.51,Incoming
30340808,2023-01-31,895.41,,-
30340808,2023-02-03,1018.8,123.39,Incoming
30340808,2023-02-06,1083.6299999999999,64.83,Incoming
30340808,2023-02-07,1205.53,121.9,Incoming
30340808,2023-02-14,2865.73,1660.2,Incoming
30372316,2023-01-31,189.39,,-
30372316,2023-02-02,368.78999999999996,179.4,Incoming
30372316,2023-02-08,216.79999999999995,151.99,Outgoing
30372316,2023-02-08,295.78,78.98,Incoming
30372316,2023-02-09,-920.8199999999999,1216.6,Outgoing
30372316,2023-02-09,33.08000000000004,953.9,Incoming
30372316,2023-02-11,-7.729999999999961,40.81,Outgoing
30372316,2023-02-13,94.50000000000004,102.23,Incoming
30372316,2023-02-14,94.93000000000005,0.43,Incoming
30374840,2023-01-31,564.42,,-
30374840,2023-02-03,660.8399999999999,96.42,Incoming
30374840,2023-02-03,1939.04,1278.2,Incoming
30374840,2023-02-07,1795.42,143.62,Outgoing
30374840,2023-02-07,1590.6100000000001,204.81,Outgoing
30374840,2023-02-08,1628.7400000000002,38.13,Incoming
30374840,2023-02-08,1521.0400000000002,107.7,Outgoing
30374840,2023-02-10,3106.04,1585.0,Incoming
30396291,2023-01-31,803.37,,-
30396291,2023-02-03,604.28,199.09,Outgoing
30396291,2023-02-03,1215.08,610.8,Incoming
30396291,2023-02-06,1314.5,99.42,Incoming
30396291,2023-02-06,1414.55,100.05,Incoming
30409599,2023-01-31,117.47,,-
30409599,2023-02-03,-57.150000000000006,174.62,Outgoing
30409599,2023-02-05,-108.41,51.26,Outgoing
30409599,2023-02-07,-289.03999999999996,180.63,Outgoing
30409599,2023-02-08,-398.76,109.72,Outgoing
30409599,2023-02-10,-370.51,28.25,Incoming
30409599,2023-02-14,-1238.01,867.5,Outgoing
30428666,2023-01-31,393.33,,-
30428666,2023-02-04,543.35,150.02,Incoming
30428666,2023-02-05,572.4,29.05,Incoming
30428666,2023-02-07,639.0699999999999,66.67,Incoming
30428666,2023-02-11,598.3599999999999,40.71,Outgoing
30484027,2023-01-31,272.71,,-
30484027,2023-02-01,145.05999999999997,127.65,Outgoing
30484027,2023-02-03,261.75,116.69,Incoming
30484027,2023-02-05,183.07999999999998,78.67,Outgoing
30484027,2023-02-09,193.52999999999997,10.45,Incoming
30484027,2023-02-12,321.35999999999996,127.83,Incoming
30484027,2023-02-12,397.9599999999999,76.6,Incoming
30511779,2023-01-31,772.02,,-
30511779,2023-02-02,592.0799999999999,179.94,Outgoing
30511779,2023-02-07,520.8999999999999,71.18,Outgoing
30511779,2023-02-08,414.02999999999986,106.87,Outgoing
30511779,2023-02-10,346.6199999999999,67.41,Outgoing
30511779,2023-02-11,231.8499999999999,114.77,Outgoing
30511779,2023-02-11,173.83999999999992,58.01,Outgoing
30518350,2023-01-31,490.85,,-
30518350,2023-02-06,-1007.4499999999999,1498.3,Outgoing
30518350,2023-02-11,-988.2099999999999,19.24,Incoming
30557885,2023-01-31,615.82,,-
30557885,2023-02-05,1294.52,678.7,Incoming
30565855,2023-01-31,982.05,,-
30565855,2023-02-05,-310.75,1292.8,Outgoing
30565855,2023-02-09,-259.07,51.68,Incoming
30565855,2023-02-11,-137.74,121.33,Incoming
30565855,2023-02-13,-208.28000000000003,70.54,Outgoing
30565855,2023-02-14,-691.48,483.2,Outgoing
30623117,2023-01-31,266.92,,-
30623117,2023-02-04,392.65000000000003,125.73,Incoming
30623117,2023-02-09,1562.0500000000002,1169.4,Incoming
30623117,2023-02-11,1673.16,111.11,Incoming
30623117,2023-02-11,1711.9,38.74,Incoming
30623117,2023-02-14,1557.3200000000002,154.58,Outgoing
30623117,2023-02-14,1479.9900000000002,77.33,Outgoing
30623117,2023-02-14,1639.0200000000002,159.03,Incoming
30647433,2023-01-31,632.2,,-
30647433,2023-02-02,857.11,224.91,Incoming
30647433,2023-02-03,1331.81,474.7,Incoming
30647433,2023-02-04,1347.1299999999999,15.32,Incoming
30647433,2023-02-05,1447.9399999999998,100.81,Incoming
30647433,2023-02-07,1487.0299999999997,39.09,Incoming
30647433,2023-02-07,1406.8399999999997,80.19,Outgoing
30647433,2023-02-10,1302.4499999999996,104.39,Outgoing
30657838,2023-01-31,468.82,,-
30657838,2023-02-01,-1770.4800000000002,2239.3,Outgoing
30657838,2023-02-01,-1678.5300000000002,91.95,Incoming
30657838,2023-02-03,-1539.3700000000001,139.16,Incoming
30657838,2023-02-04,-1663.43,124.06,Outgoing
30657838,2023-02-05,-1501.63,161.8,Incoming
30657838,2023-02-05,-2041.43,539.8,Outgoing
30657838,2023-02-06,-1988.49,52.94,Incoming
30657838,2023-02-06,-2079.47,90.98,Outgoing
30657838,2023-02-08,-2163.58,84.11,Outgoing
30657838,2023-02-09,-2232.91,69.33,Outgoing
30657838,2023-02-11,-2385.67,152.76,Outgoing
30671754,2023-01-31,621.9,,-
30671754,2023-02-04,755.2,133.3,Incoming
30671754,2023-02-07,750.13,5.07,Outgoing
30672740,2023-01-31,355.33,,-
30672740,2023-02-02,167.92999999999998,187.4,Outgoing
30672740,2023-02-06,41.43999999999998,126.49,Outgoing
30672740,2023-02-07,-5.0700000000000145,46.51,Outgoing
30672740,2023-02-11,-1954.6699999999998,1949.6,Outgoing
30672740,2023-02-13,-1848.07,106.6,Incoming
30688447,2023-01-31,555.31,,-
30688447,2023-02-03,693.29,137.98,Incoming
30688447,2023-02-05,853.9599999999999,160.67,Incoming
30688447,2023-02-06,771.9699999999999,81.99,Outgoing
30688447,2023-02-10,934.29,162.32,Incoming
30688447,2023-02-14,1036.05,101.76,Incoming
30718836,2023-01-31,360.78,,-
30718836,2023-02-01,437.67999999999995,76.9,Incoming
30718836,2023-02-01,250.78999999999996,186.89,Outgoing
30718836,2023-02-03,383.89,133.1,Incoming
30718836,2023-02-04,325.79999999999995,58.09,Outgoing
30718836,2023-02-06,436.05999999999995,110.26,Incoming
30718836,2023-02-07,452.3299999999999,16.27,Incoming
30718836,2023-02-08,1579.73,1127.4,Incoming
30718836,2023-02-09,1528.05,51.68,Outgoing
30718836,2023-02-11,1463.5,64.55,Outgoing
30718836,2023-02-13,1538.66,75.16,Incoming
30723991,2023-01-31,310.02,,-
30723991,2023-02-02,223.32999999999998,86.69,Outgoing
30723991,2023-02-03,84.64999999999998,138.68,Outgoing
30723991,2023-02-07,180.42999999999998,95.78,Incoming
30758515,2023-01-31,35.74,,-
30758515,2023-02-01,-66.65,102.39,Outgoing
30758515,2023-02-02,-127.74000000000001,61.09,Outgoing
30758515,2023-02-13,-311.17,183.43,Outgoing
30760024,2023-01-31,766.43,,-
30760024,2023-02-02,843.5699999999999,77.14,Incoming
30760024,2023-02-03,882.18,38.61,Incoming
30760024,2023-02-09,798.92,83.26,Outgoing
30791105,2023-01-31,272.5,,-
30791105,2023-02-02,79.72999999999999,192.77,Outgoing
30791105,2023-02-04,193.35,113.62,Incoming
30791105,2023-02-06,91.33999999999999,102.01,Outgoing
30791105,2023-02-06,203.67,112.33,Incoming
30791105,2023-02-10,23.72,179.95,Outgoing
30791105,2023-02-11,-83.29,107.01,Outgoing
30929422,2023-01-31,161.53,,-
30929422,2023-02-01,282.46000000000004,120.93,Incoming
30929422,2023-02-01,442.1,159.64,Incoming
30929422,2023-02-07,359.19000000000005,82.91,Outgoing
30929422,2023-02-08,472.61000000000007,113.42,Incoming
30929422,2023-02-08,496.20000000000005,23.59,Incoming
30929422,2023-02-11,534.57,38.37,Incoming
30929422,2023-02-12,611.0500000000001,76.48,Incoming
30929422,2023-02-13,724.96,113.91,Incoming
30970897,2023-01-31,57.17,,-
30970897,2023-02-01,198.76999999999998,141.6,Incoming
30970897,2023-02-03,314.39,115.62,Incoming
30970897,2023-02-03,424.93,110.54,Incoming
30970897,2023-02-04,541.59,116.66,Incoming
30970897,2023-02-05,339.84000000000003,201.75,Outgoing
30970897,2023-02-07,481.11,141.27,Incoming
30970897,2023-02-09,638.4100000000001,157.3,Incoming
30970897,2023-02-09,751.7700000000001,113.36,Incoming
30970897,2023-02-12,723.8700000000001,27.9,Outgoing
30970897,2023-02-13,623.3700000000001,100.5,Outgoing
30977834,2023-01-31,203.99,,-
30977834,2023-02-02,28.26000000000002,175.73,Outgoing
30977834,2023-02-04,204.25000000000003,175.99,Incoming
30977834,2023-02-04,-482.25,686.5,Outgoing
30977834,2023-02-05,-446.95,35.3,Incoming
30977834,2023-02-07,-360.49,86.46,Incoming
30977834,2023-02-07,-272.67,87.82,Incoming
30977834,2023-02-10,-339.96000000000004,67.29,Outgoing
30977834,2023-02-12,-385.19000000000005,45.23,Outgoing
30979429,2023-01-31,414.1,,-
30979429,2023-02-01,484.44000000000005,70.34,Incoming
30979429,2023-02-02,1349.8400000000001,865.4,Incoming
30979429,2023-02-03,483.7400000000001,866.1,Outgoing
30979429,2023-02-05,379.47000000000014,104.27,Outgoing
30979429,2023-02-09,539.5300000000002,160.06,Incoming
30979429,2023-02-11,504.4600000000002,35.07,Outgoing
30979429,2023-02-12,583.1100000000002,78.65,Incoming
30990911,2023-01-31,997.59,,-
30990911,2023-02-02,1141.64,144.05,Incoming
30990911,2023-02-04,1315.5400000000002,173.9,Incoming
30990911,2023-02-04,1144.9800000000002,170.56,Outgoing
30990911,2023-02-07,1269.8400000000001,124.86,Incoming
30990911,2023-02-08,1137.64,132.2,Outgoing
30990911,2023-02-11,1244.0400000000002,106.4,Incoming
31026801,2023-01-31,85.36,,-
31026801,2023-02-01,32.37,52.99,Outgoing
31026801,2023-02-06,131.51,99.14,Incoming
31026801,2023-02-07,233.76999999999998,102.26,Incoming
31026801,2023-02-08,281.34999999999997,47.58,Incoming
31026801,2023-02-11,343.67999999999995,62.33,Incoming
31131351,2023-01-31,278.94,,-
31131351,2023-02-04,16.939999999999998,262.0,Outgoing
31131351,2023-02-04,-769.1600000000001,786.1,Outgoing
31131351,2023-02-04,-867.58,98.42,Outgoing
31131351,2023-02-06,-897.5300000000001,29.95,Outgoing
31131351,2023-02-06,226.56999999999982,1124.1,Incoming
31131351,2023-02-08,122.55999999999982,104.01,Outgoing
31131351,2023-02-09,281.0799999999998,158.52,Incoming
31131351,2023-02-12,505.2199999999998,224.14,Incoming
31150830,2023-01-31,36.16,,-
31150830,2023-02-01,198.01,161.85,Incoming
31150830,2023-02-02,71.88999999999999,126.12,Outgoing
31150830,2023-02-02,-56.82000000000002,128.71,Outgoing
31150830,2023-02-05,4.859999999999978,61.68,Incoming
31150830,2023-02-06,-47.450000000000024,52.31,Outgoing
31150830,2023-02-07,388.34999999999997,435.8,Incoming
31150830,2023-02-09,458.64,70.29,Incoming
31150830,2023-02-09,514.52,55.88,Incoming
31150830,2023-02-11,598.97,84.45,Incoming
31158381,2023-01-31,514.96,,-
31158381,2023-02-01,291.02000000000004,223.94,Outgoing
31158381,2023-02-01,151.84000000000003,139.18,Outgoing
31158381,2023-02-07,70.90000000000003,80.94,Outgoing
31158381,2023-02-08,203.35000000000002,132.45,Incoming
31158381,2023-02-13,334.71000000000004,131.36,Incoming
31183587,2023-01-31,725.0,,-
31183587,2023-02-02,761.32,36.32,Incoming
31183587,2023-02-03,780.63,19.31,Incoming
31183587,2023-02-05,-371.87,1152.5,Outgoing
31183587,2023-02-08,580.13,952.0,Incoming
31183587,2023-02-12,358.40999999999997,221.72,Outgoing
31183587,2023-02-12,245.77999999999997,112.63,Outgoing
31183587,2023-02-13,322.27,76.49,Incoming
31183587,2023-02-13,440.03999999999996,117.77,Incoming
31187024,2023-01-31,950.41,,-
31187024,2023-02-02,1055.93,105.52,Incoming
31187024,2023-02-03,1105.3200000000002,49.39,Incoming
31187024,2023-02-04,1230.5700000000002,125.25,Incoming
31187024,2023-02-06,1076.15,154.42,Outgoing
31187024,2023-02-08,1004.3400000000001,71.81,Outgoing
31187024,2023-02-08,1542.2400000000002,537.9,Incoming
31187024,2023-02-10,760.0400000000002,782.2,Outgoing
31187024,2023-02-10,923.2200000000003,163.18,Incoming
31263913,2023-01-31,267.5,,-
31263913,2023-02-01,316.28,48.78,Incoming
31263913,2023-02-02,449.65999999999997,133.38,Incoming
31263913,2023-02-06,365.2,84.46,Outgoing
31319183,2023-01-31,407.92,,-
31319183,2023-02-06,503.03000000000003,95.11,Incoming
31319183,2023-02-08,444.21000000000004,58.82,Outgoing
31319183,2023-02-09,595.4300000000001,151.22,Incoming
31319183,2023-02-10,535.0200000000001,60.41,Outgoing
31319183,2023-02-12,598.3500000000001,63.33,Incoming
31319183,2023-02-12,493.45000000000016,104.9,Outgoing
31319183,2023-02-13,366.7900000000002,126.66,Outgoing
31335654,2023-01-31,217.33,,-
31335654,2023-02-02,91.34000000000002,125.99,Outgoing
31335654,2023-02-07,-55.479999999999976,146.82,Outgoing
31335654,2023-02-10,-143.10999999999996,87.63,Outgoing
31335654,2023-02-10,-231.72999999999996,88.62,Outgoing
31335654,2023-02-12,-1424.43,1192.7,Outgoing
31367758,2023-01-31,536.16,,-
31367758,2023-02-01,447.15,89.01,Outgoing
31367758,2023-02-08,350.57,96.58,Outgoing
31367758,2023-02-10,-485.33,835.9,Outgoing
31367758,2023-02-13,-592.88,107.55,Outgoing
31392168,2023-01-31,615.42,,-
31392168,2023-02-05,793.0899999999999,177.67,Incoming
31392168,2023-02-08,622.1099999999999,170.98,Outgoing
31392168,2023-02-10,478.26999999999987,143.84,Outgoing
31392168,2023-02-13,434.0699999999999,44.2,Outgoing
31525756,2023-01-31,363.68,,-
31525756,2023-02-01,282.66,81.02,Outgoing
31525756,2023-02-07,135.90000000000003,146.76,Outgoing
31525756,2023-02-12,264.22,128.32,Incoming
31525756,2023-02-13,306.07000000000005,41.85,Incoming
31525756,2023-02-13,381.63000000000005,75.56,Incoming
31537778,2023-01-31,335.19,,-
31537778,2023-02-01,371.62,36.43,Incoming
31537778,2023-02-14,252.87,118.75,Outgoing
31541158,2023-01-31,215.94,,-
31541158,2023-02-07,323.73,107.79,Incoming
31541158,2023-02-09,250.13000000000002,73.6,Outgoing
31541158,2023-02-09,129.66000000000003,120.47,Outgoing
31541158,2023-02-13,239.83000000000004,110.17,Incoming
31557275,2023-01-31,362.05,,-
31557275,2023-02-02,524.4,162.35,Incoming
31557275,2023-02-05,587.72,63.32,Incoming
31557275,2023-02-09,500.86,86.86,Outgoing
31557275,2023-02-11,667.1600000000001,166.3,Incoming
31557275,2023-02-14,607.3500000000001,59.81,Outgoing
31589468,2023-01-31,713.44,,-
31589468,2023-02-01,1520.64,807.2,Incoming
31589468,2023-02-01,1598.71,78.07,Incoming
31589468,2023-02-03,1481.25,117.46,Outgoing
31589468,2023-02-10,1339.12,142.13,Outgoing
31589468,2023-02-14,1416.81,77.69,Incoming
31594938,2023-01-31,486.88,,-
31594938,2023-02-02,559.78,72.9,Incoming
31594938,2023-02-02,766.6899999999999,206.91,Incoming
31594938,2023-02-03,717.15,49.54,Outgoing
31594938,2023-02-05,486.65,230.5,Outgoing
31594938,2023-02-06,563.87,77.22,Incoming
31594938,2023-02-06,695.83,131.96,Incoming
31594938,2023-02-10,743.7,47.87,Incoming
31594938,2023-02-14,834.5600000000001,90.86,Incoming
31595213,2023-01-31,418.35,,-
31595213,2023-02-02,233.91000000000003,184.44,Outgoing
31595213,2023-02-03,344.34000000000003,110.43,Incoming
31595213,2023-02-04,216.13000000000002,128.21,Outgoing
31595213,2023-02-10,135.36,80.77,Outgoing
31595213,2023-02-12,257.97,122.61,Incoming
31595213,2023-02-14,85.59000000000003,172.38,Outgoing
31661113,2023-01-31,309.32,,-
31661113,2023-02-02,241.14999999999998,68.17,Outgoing
31661113,2023-02-10,229.83999999999997,11.31,Outgoing
31661113,2023-02-10,126.91999999999997,102.92,Outgoing
31661113,2023-02-13,110.32999999999997,16.59,Outgoing
31670977,2023-01-31,385.42,,-
31670977,2023-02-02,1906.22,1520.8,Incoming
31670977,2023-02-04,1772.92,133.3,Outgoing
31670977,2023-02-08,1762.8700000000001,10.05,Outgoing
31670977,2023-02-14,1850.48,87.61,Incoming
31680976,2023-01-31,327.79,,-
31680976,2023-02-01,409.88,82.09,Incoming
31680976,2023-02-05,475.61,65.73,Incoming
31680976,2023-02-06,5.009999999999991,470.6,Outgoing
31680976,2023-02-08,-357.59000000000003,362.6,Outgoing
31680976,2023-02-10,-287.91,69.68,Incoming
31680976,2023-02-10,-171.93,115.98,Incoming
31680976,2023-02-11,953.0699999999999,1125.0,Incoming
31680976,2023-02-14,803.17,149.9,Outgoing
31689747,2023-01-31,907.21,,-
31689747,2023-02-01,802.6400000000001,104.57,Outgoing
31689747,2023-02-02,980.1400000000001,177.5,Incoming
31689747,2023-02-04,1021.9100000000001,41.77,Incoming
31689747,2023-02-04,1002.7800000000001,19.13,Outgoing
31689747,2023-02-04,913.5900000000001,89.19,Outgoing
31689747,2023-02-06,1015.4300000000002,101.84,Incoming
31689747,2023-02-07,1122.6900000000003,107.26,Incoming
31689747,2023-02-09,950.9800000000002,171.71,Outgoing
31693244,2023-01-31,311.41,,-
31693244,2023-02-02,457.26,145.85,Incoming
31693244,2023-02-03,408.1,49.16,Outgoing
31693244,2023-02-08,1118.4,710.3,Incoming
31693244,2023-02-08,1215.3500000000001,96.95,Incoming
31693244,2023-02-10,1133.92,81.43,Outgoing
31693244,2023-02-13,1289.3600000000001,155.44,Incoming
31693244,2023-02-13,1415.8200000000002,126.46,Incoming
31693244,2023-02-14,1489.18,73.36,Incoming
31759645,2023-01-31,43.92,,-
31759645,2023-02-01,-118.10000000000001,162.02,Outgoing
31759645,2023-02-02,364.59999999999997,482.7,Incoming
31759645,2023-02-04,468.75,104.15,Incoming
31759645,2023-02-06,345.65999999999997,123.09,Outgoing
31759645,2023-02-06,287.78,57.88,Outgoing
31759645,2023-02-07,456.99,169.21,Incoming
31759645,2023-02-08,377.93,79.06,Outgoing
31759645,2023-02-08,541.9,163.97,Incoming
31759645,2023-02-09,652.73,110.83,Incoming
31759645,2023-02-09,686.45,33.72,Incoming
31759645,2023-02-10,837.22,150.77,Incoming
31770323,2023-01-31,666.66,,-
31770323,2023-02-07,1669.1599999999999,1002.5,Incoming
31770323,2023-02-07,1743.5099999999998,74.35,Incoming
31770323,2023-02-11,1683.4599999999998,60.05,Outgoing
31770323,2023-02-12,1609.5199999999998,73.94,Outgoing
31770323,2023-02-12,1462.0699999999997,147.45,Outgoing
31770323,2023-02-13,1353.0099999999998,109.06,Outgoing
31770323,2023-02-13,1534.5199999999998,181.51,Incoming
31774984,2023-01-31,964.57,,-
31774984,2023-02-01,837.0,127.57,Outgoing
31774984,2023-02-04,715.51,121.49,Outgoing
31774984,2023-02-08,550.81,164.7,Outgoing
31774984,2023-02-09,690.67,139.86,Incoming
31774984,2023-02-09,563.29,127.38,Outgoing
31774984,2023-02-11,424.09,139.2,Outgoing
31826534,2023-01-31,541.64,,-
31826534,2023-02-02,637.0799999999999,95.44,Incoming
31826534,2023-02-07,481.9599999999999,155.12,Outgoing
31826534,2023-02-10,586.8199999999999,104.86,Incoming
31826534,2023-02-11,671.8199999999999,85.0,Incoming
31826534,2023-02-14,56.219999999999914,615.6,Outgoing
31830289,2023-01-31,816.55,,-
31830289,2023-02-01,772.26,44.29,Outgoing
31830289,2023-02-06,926.73,154.47,Incoming
31830289,2023-02-14,724.96,201.77,Outgoing
31873155,2023-01-31,351.03,,-
31873155,2023-02-02,323.59,27.44,Outgoing
31873155,2023-02-02,446.78999999999996,123.2,Incoming
31873155,2023-02-04,232.00999999999996,214.78,Outgoing
31873155,2023-02-06,339.54999999999995,107.54,Incoming
31873155,2023-02-08,516.49,176.94,Incoming
31873155,2023-02-11,404.61,111.88,Outgoing
31873155,2023-02-12,414.51,9.9,Incoming
31957459,2023-01-31,758.69,,-
31957459,2023-02-01,660.1700000000001,98.52,Outgoing
31957459,2023-02-03,593.1400000000001,67.03,Outgoing
31957459,2023-02-03,706.6000000000001,113.46,Incoming
31957459,2023-02-03,617.3700000000001,89.23,Outgoing
31957459,2023-02-06,722.0300000000001,104.66,Incoming
31957459,2023-02-08,814.57,92.54,Incoming
31957459,2023-02-08,803.99,10.58,Outgoing
31957459,2023-02-10,901.28,97.29,Incoming
31978646,2023-01-31,393.51,,-
31978646,2023-02-05,566.13,172.62,Incoming
31978646,2023-02-06,376.95,189.18,Outgoing
31978646,2023-02-09,426.96999999999997,50.02,Incoming
31978646,2023-02-10,336.97999999999996,89.99,Outgoing
31978646,2023-02-11,224.41999999999996,112.56,Outgoing
32019304,2023-01-31,961.49,,-
32019304,2023-02-01,804.7,156.79,Outgoing
32019304,2023-02-01,1005.1,200.4,Incoming
32019304,2023-02-02,895.53,109.57,Outgoing
32019304,2023-02-08,811.5699999999999,83.96,Outgoing
32019304,2023-02-10,778.5799999999999,32.99,Outgoing
32019304,2023-02-11,888.2399999999999,109.66,Incoming
32019304,2023-02-13,789.3399999999999,98.9,Outgoing
32084810,2023-01-31,610.7,,-
32084810,2023-02-02,777.9200000000001,167.22,Incoming
32084810,2023-02-03,902.72,124.8,Incoming
32084810,2023-02-05,925.74,23.02,Incoming
32084810,2023-02-06,942.41,16.67,Incoming
32084810,2023-02-08,1010.01,67.6,Incoming
32084810,2023-02-12,1077.03,67.02,Incoming
32092491,2023-01-31,51.82,,-
32092491,2023-02-01,-74.19,126.01,Outgoing
32092491,2023-02-02,-175.34,101.15,Outgoing
32092491,2023-02-03,-223.82,48.48,Outgoing
32092491,2023-02-07,-410.04999999999995,186.23,Outgoing
32092491,2023-02-09,-475.19999999999993,65.15,Outgoing
32092491,2023-02-10,-875.3,400.1,Outgoing
32092491,2023-02-14,526.5,1401.8,Incoming
32092491,2023-02-14,875.6,349.1,Incoming
32092491,2023-02-14,1013.52,137.92,Incoming
32109414,2023-01-31,967.31,,-
32109414,2023-02-01,851.04,116.27,Outgoing
32109414,2023-02-05,970.52,119.48,Incoming
32109414,2023-02-12,907.84,62.68,Outgoing
32109414,2023-02-13,1016.9000000000001,109.06,Incoming
32131123,2023-01-31,758.69,,-
32131123,2023-02-04,742.1800000000001,16.51,Outgoing
32131123,2023-02-10,838.35,96.17,Incoming
32131123,2023-02-11,971.29,132.94,Incoming
32192958,2023-01-31,209.37,,-
32192958,2023-02-02,51.96000000000001,157.41,Outgoing
32192958,2023-02-05,191.71,139.75,Incoming
32192958,2023-02-05,-1433.8899999999999,1625.6,Outgoing
32192958,2023-02-07,-1477.7499999999998,43.86,Outgoing
32192958,2023-02-11,-1625.7899999999997,148.04,Outgoing
32192958,2023-02-13,-1573.5999999999997,52.19,Incoming
32192958,2023-02-13,-441.0999999999997,1132.5,Incoming
32221529,2023-01-31,887.75,,-
32221529,2023-02-06,773.64,114.11,Outgoing
32221529,2023-02-06,653.04,120.6,Outgoing
32221529,2023-02-07,532.4,120.64,Outgoing
32221529,2023-02-08,580.5899999999999,48.19,Incoming
32221529,2023-02-10,472.0199999999999,108.57,Outgoing
32221529,2023-02-11,426.3499999999999,45.67,Outgoing
32221529,2023-02-13,496.6499999999999,70.3,Incoming
32221529,2023-02-13,394.4199999999999,102.23,Outgoing
32221652,2023-01-31,36.96,,-
32221652,2023-02-01,1857.26,1820.3,Incoming
32221652,2023-02-01,2946.8599999999997,1089.6,Incoming
32221652,2023-02-06,2914.49,32.37,Outgoing
32221652,2023-02-06,3006.7799999999997,92.29,Incoming
32221652,2023-02-07,2415.58,591.2,Outgoing
32221652,2023-02-08,2594.0699999999997,178.49,Incoming
32261620,2023-01-31,55.43,,-
32261620,2023-02-01,-731.7700000000001,787.2,Outgoing
32261620,2023-02-02,-911.1700000000001,179.4,Outgoing
32261620,2023-02-02,-1003.1400000000001,91.97,Outgoing
32261620,2023-02-03,-1129.7800000000002,126.64,Outgoing
32261620,2023-02-11,-1273.5600000000002,143.78,Outgoing
32261620,2023-02-13,-1115.66,157.9,Incoming
32261620,2023-02-13,-963.82,151.84,Incoming
32275676,2023-01-31,889.61,,-
32275676,2023-02-03,819.32,70.29,Outgoing
32275676,2023-02-07,992.6700000000001,173.35,Incoming
32275676,2023-02-09,873.5000000000001,119.17,Outgoing
32275676,2023-02-14,803.4700000000001,70.03,Outgoing
32308270,2023-01-31,976.53,,-
32308270,2023-02-03,837.37,139.16,Outgoing
32308270,2023-02-05,899.9300000000001,62.56,Incoming
32308270,2023-02-09,1959.93,1060.0,Incoming
32308270,2023-02-09,1948.26,11.67,Outgoing
32312381,2023-01-31,742.85,,-
32312381,2023-02-01,839.62,96.77,Incoming
32312381,2023-02-11,705.53,134.09,Outgoing
32312410,2023-01-31,817.47,,-
32312410,2023-02-04,907.0500000000001,89.58,Incoming
32370392,2023-01-31,369.09,,-
32370392,2023-02-04,301.15999999999997,67.93,Outgoing
32370392,2023-02-05,133.97999999999996,167.18,Outgoing
32370392,2023-02-06,69.14999999999996,64.83,Outgoing
32370392,2023-02-10,202.60999999999996,133.46,Incoming
32370392,2023-02-12,274.53999999999996,71.93,Incoming
32386770,2023-01-31,639.45,,-
32386770,2023-02-01,696.0,56.55,Incoming
32386770,2023-02-02,594.54,101.46,Outgoing
32386770,2023-02-03,598.1899999999999,3.65,Incoming
32386770,2023-02-03,-118.41000000000008,716.6,Outgoing
32386770,2023-02-05,-1250.21,1131.8,Outgoing
32386770,2023-02-06,-1322.46,72.25,Outgoing
32386770,2023-02-07,-1271.3500000000001,51.11,Incoming
32386770,2023-02-07,-1389.69,118.34,Outgoing
32386770,2023-02-11,-1567.7,178.01,Outgoing
32386770,2023-02-14,-1702.22,134.52,Outgoing
32390015,2023-01-31,529.35,,-
32390015,2023-02-02,676.79,147.44,Incoming
32390015,2023-02-04,794.5799999999999,117.79,Incoming
32390015,2023-02-07,877.92,83.34,Incoming
32390015,2023-02-08,974.3499999999999,96.43,Incoming
32390015,2023-02-09,817.2199999999999,157.13,Outgoing
32390015,2023-02-12,728.81,88.41,Outgoing
32390015,2023-02-13,808.9,80.09,Incoming
32390015,2023-02-13,982.26,173.36,Incoming
32390015,2023-02-14,844.89,137.37,Outgoing
32400822,2023-01-31,987.34,,-
32400822,2023-02-08,2795.7400000000002,1808.4,Incoming
32400822,2023-02-12,2612.3300000000004,183.41,Outgoing
32400822,2023-02-14,2748.8200000000006,136.49,Incoming
32408166,2023-01-31,261.63,,-
32408166,2023-02-01,931.73,670.1,Incoming
32408166,2023-02-01,996.85,65.12,Incoming
32408166,2023-02-02,934.07,62.78,Outgoing
32408166,2023-02-05,853.0200000000001,81.05,Outgoing
32408166,2023-02-05,966.8400000000001,113.82,Incoming
32408166,2023-02-06,1089.8000000000002,122.96,Incoming
32408166,2023-02-11,915.8300000000002,173.97,Outgoing
32408166,2023-02-13,832.9400000000002,82.89,Outgoing
32424424,2023-01-31,848.04,,-
32424424,2023-02-06,-903.56,1751.6,Outgoing
32424424,2023-02-07,-1059.25,155.69,Outgoing
32424424,2023-02-08,-952.63,106.62,Incoming
32424424,2023-02-08,-899.5,53.13,Incoming
32424424,2023-02-12,-739.17,160.33,Incoming
32424424,2023-02-13,-830.9499999999999,91.78,Outgoing
32474004,2023-01-31,509.41,,-
32474004,2023-02-05,588.37,78.96,Incoming
32474004,2023-02-06,705.28,116.91,Incoming
32474004,2023-02-08,700.4399999999999,4.84,Outgoing
32474004,2023-02-09,594.06,106.38,Outgoing
32476086,2023-01-31,67.66,,-
32476086,2023-02-06,12.36,55.3,Outgoing
32476086,2023-02-09,-103.39,115.75,Outgoing
32476086,2023-02-10,-240.95,137.56,Outgoing
32476086,2023-02-12,-368.54999999999995,127.6,Outgoing
32476086,2023-02-14,-1276.9499999999998,908.4,Outgoing
32597705,2023-01-31,869.89,,-
32597705,2023-02-03,994.93,125.04,Incoming
32597705,2023-02-03,1167.17,172.24,Incoming
32597705,2023-02-06,1243.77,76.6,Incoming
32597705,2023-02-08,1068.35,175.42,Outgoing
32597705,2023-02-12,1158.6899999999998,90.34,Incoming
32597705,2023-02-13,1270.12,111.43,Incoming
32641357,2023-01-31,12.39,,-
32641357,2023-02-03,29.32,16.93,Incoming
32641357,2023-02-04,123.94,94.62,Incoming
32641357,2023-02-04,4.689999999999998,119.25,Outgoing
32641357,2023-02-08,697.69,693.0,Incoming
32641357,2023-02-09,744.0600000000001,46.37,Incoming
32679915,2023-01-31,841.31,,-
32679915,2023-02-02,1003.2199999999999,161.91,Incoming
32679915,2023-02-03,1113.08,109.86,Incoming
32679915,2023-02-06,958.78,154.3,Outgoing
32737909,2023-01-31,744.1,,-
32737909,2023-02-01,644.58,99.52,Outgoing
32737909,2023-02-02,504.31000000000006,140.27,Outgoing
32737909,2023-02-03,467.2900000000001,37.02,Outgoing
32737909,2023-02-04,413.7800000000001,53.51,Outgoing
32737909,2023-02-07,471.0300000000001,57.25,Incoming
32737909,2023-02-09,358.1000000000001,112.93,Outgoing
32737909,2023-02-10,300.4700000000001,57.63,Outgoing
32737909,2023-02-13,675.5700000000002,375.1,Incoming
32803222,2023-01-31,827.92,,-
32803222,2023-02-01,908.8399999999999,80.92,Incoming
32803222,2023-02-10,844.9699999999999,63.87,Outgoing
32803222,2023-02-11,702.56,142.41,Outgoing
32803222,2023-02-12,692.66,9.9,Outgoing
32803222,2023-02-13,596.5999999999999,96.06,Outgoing
32803222,2023-02-14,539.9399999999999,56.66,Outgoing
32824719,2023-01-31,502.37,,-
32824719,2023-02-01,512.17,9.8,Incoming
32824719,2023-02-10,333.06999999999994,179.1,Outgoing
32824719,2023-02-11,443.4799999999999,110.41,Incoming
32888555,2023-01-31,781.33,,-
32888555,2023-02-03,705.22,76.11,Outgoing
32888555,2023-02-05,779.38,74.16,Incoming
32888555,2023-02-06,875.53,96.15,Incoming
32888555,2023-02-06,-285.8700000000001,1161.4,Outgoing
32888555,2023-02-09,-106.61000000000013,179.26,Incoming
32888555,2023-02-11,-63.71000000000013,42.9,Incoming
32888555,2023-02-12,-233.07000000000014,169.36,Outgoing
32888555,2023-02-14,-440.4300000000002,207.36,Outgoing
32930305,2023-01-31,49.71,,-
32930305,2023-02-05,-101.57999999999998,151.29,Outgoing
32930305,2023-02-08,108.15,209.73,Incoming
32930305,2023-02-11,34.540000000000006,73.61,Outgoing
32930305,2023-02-12,218.26999999999998,183.73,Incoming
32934183,2023-01-31,917.81,,-
32934183,2023-02-03,1804.11,886.3,Incoming
32934183,2023-02-07,1870.08,65.97,Incoming
32934183,2023-02-11,1814.6999999999998,55.38,Outgoing
32973728,2023-01-31,321.03,,-
32973728,2023-02-06,266.32,54.71,Outgoing
32973728,2023-02-08,370.5,104.18,Incoming
32973728,2023-02-13,239.14,131.36,Outgoing
32991596,2023-01-31,755.92,,-
32991596,2023-02-01,589.4399999999999,166.48,Outgoing
32991596,2023-02-05,523.9,65.54,Outgoing
32991596,2023-02-07,361.78999999999996,162.11,Outgoing
32991596,2023-02-09,242.96999999999997,118.82,Outgoing
32991596,2023-02-11,390.51,147.54,Incoming
32991596,2023-02-11,-1460.89,1851.4,Outgoing
32991596,2023-02-11,-1302.25,158.64,Incoming
33014501,2023-01-31,454.35,,-
33014501,2023-02-03,538.47,84.12,Incoming
33014501,2023-02-03,607.32,68.85,Incoming
33014501,2023-02-04,477.68000000000006,129.64,Outgoing
33014501,2023-02-04,392.4100000000001,85.27,Outgoing
33014501,2023-02-05,472.6700000000001,80.26,Incoming
33014501,2023-02-09,395.0100000000001,77.66,Outgoing
33014501,2023-02-13,530.7900000000001,135.78,Incoming
33014501,2023-02-13,377.96000000000004,152.83,Outgoing
33112628,2023-01-31,879.2,,-
33112628,2023-02-02,682.6,196.6,Outgoing
33112628,2023-02-04,437.37,245.23,Outgoing
33112628,2023-02-05,304.27,133.1,Outgoing
33112628,2023-02-06,380.08,75.81,Incoming
33112628,2023-02-10,280.54999999999995,99.53,Outgoing
33112628,2023-02-11,403.78999999999996,123.24,Incoming
33112628,2023-02-12,319.71999999999997,84.07,Outgoing
33112628,2023-02-13,202.36999999999998,117.35,Outgoing
33116647,2023-01-31,391.76,,-
33116647,2023-02-04,323.32,68.44,Outgoing
33116647,2023-02-05,384.21999999999997,60.9,Incoming
33116647,2023-02-06,520.71,136.49,Incoming
33116647,2023-02-06,1616.1100000000001,1095.4,Incoming
33116647,2023-02-09,1674.2,58.09,Incoming
33116647,2023-02-09,1596.1000000000001,78.1,Outgoing
33116647,2023-02-13,1565.0300000000002,31.07,Outgoing
33116647,2023-02-14,1625.9500000000003,60.92,Incoming
33159039,2023-01-31,100.51,,-
33159039,2023-02-01,340.71,240.2,Incoming
33159039,2023-02-05,484.01,143.3,Incoming
33159039,2023-02-05,610.52,126.51,Incoming
33159039,2023-02-12,704.88,94.36,Incoming
33168725,2023-01-31,211.44,,-
33168725,2023-02-01,122.78999999999999,88.65,Outgoing
33168725,2023-02-03,232.83999999999997,110.05,Incoming
33168725,2023-02-04,494.84,262.0,Incoming
33168725,2023-02-10,594.37,99.53,Incoming
33168725,2023-02-14,717.79,123.42,Incoming
33173974,2023-01-31,94.47,,-
33173974,2023-02-02,5.900000000000006,88.57,Outgoing
33173974,2023-02-04,-45.94,51.84,Outgoing
33173974,2023-02-05,60.379999999999995,106.32,Incoming
33173974,2023-02-06,159.3,98.92,Incoming
33173974,2023-02-07,24.710000000000008,134.59,Outgoing
33173974,2023-02-08,184.81,160.1,Incoming
33173974,2023-02-10,22.44999999999999,162.36,Outgoing
33173974,2023-02-13,-47.10000000000001,69.55,Outgoing
33173974,2023-02-13,154.84999999999997,201.95,Incoming
33202593,2023-01-31,329.25,,-
33202593,2023-02-09,520.54,191.29,Incoming
33240853,2023-01-31,985.46,,-
33240853,2023-02-01,1106.15,120.69,Incoming
33240853,2023-02-07,-322.9499999999998,1429.1,Outgoing
33240853,2023-02-09,615.3500000000001,938.3,Incoming
33240853,2023-02-11,-702.7499999999998,1318.1,Outgoing
33240853,2023-02-13,-788.9999999999998,86.25,Outgoing
33240853,2023-02-14,-711.7899999999997,77.21,Incoming
33259781,2023-01-31,923.18,,-
33259781,2023-02-01,1016.6099999999999,93.43,Incoming
33259781,2023-02-05,951.04,65.57,Outgoing
33259781,2023-02-07,884.16,66.88,Outgoing
33259781,2023-02-08,1033.8,149.64,Incoming
33259781,2023-02-09,121.0,912.8,Outgoing
33259781,2023-02-10,271.39,150.39,Incoming
33259781,2023-02-12,-570.3100000000001,841.7,Outgoing
33259781,2023-02-12,-663.8800000000001,93.57,Outgoing
33259781,2023-02-14,-730.1700000000001,66.29,Outgoing
33259781,2023-02-14,-642.94,87.23,Incoming
33270307,2023-01-31,38.51,,-
33270307,2023-02-02,159.12,120.61,Incoming
33270307,2023-02-04,126.5,32.62,Outgoing
33270307,2023-02-06,243.49,116.99,Incoming
33270307,2023-02-12,132.68,110.81,Outgoing
33270307,2023-02-14,-1243.32,1376.0,Outgoing
33348876,2023-01-31,267.33,,-
33348876,2023-02-02,308.27,40.94,Incoming
33348876,2023-02-05,247.92,60.35,Outgoing
33348876,2023-02-07,148.70999999999998,99.21,Outgoing
33348876,2023-02-07,37.449999999999974,111.26,Outgoing
33348876,2023-02-08,255.02999999999997,217.58,Incoming
33348876,2023-02-09,408.47999999999996,153.45,Incoming
33351056,2023-01-31,597.06,,-
33351056,2023-02-02,739.3399999999999,142.28,Incoming
33351056,2023-02-03,560.2099999999999,179.13,Outgoing
33351056,2023-02-03,-209.09000000000003,769.3,Outgoing
33351056,2023-02-03,-417.37,208.28,Outgoing
33351056,2023-02-07,-507.63,90.26,Outgoing
33351056,2023-02-10,-417.65,89.98,Incoming
33351056,2023-02-13,-501.84999999999997,84.2,Outgoing
33381880,2023-01-31,682.27,,-
33381880,2023-02-04,623.96,58.31,Outgoing
33381880,2023-02-04,721.02,97.06,Incoming
33381880,2023-02-07,645.56,75.46,Outgoing
33381880,2023-02-08,813.8499999999999,168.29,Incoming
33381880,2023-02-11,986.4199999999998,172.57,Incoming
33381880,2023-02-12,855.0799999999998,131.34,Outgoing
33381880,2023-02-14,781.6799999999998,73.4,Outgoing
33403100,2023-01-31,270.23,,-
33403100,2023-02-11,380.51,110.28,Incoming
33414190,2023-01-31,204.38,,-
33414190,2023-02-04,140.84,63.54,Outgoing
33414190,2023-02-07,170.63,29.79,Incoming
33414190,2023-02-11,110.25999999999999,60.37,Outgoing
33414190,2023-02-13,260.64,150.38,Incoming
33424425,2023-01-31,23.18,,-
33424425,2023-02-01,77.88,54.7,Incoming
33424425,2023-02-02,-30.58,108.46,Outgoing
33424425,2023-02-04,-76.03,45.45,Outgoing
33424425,2023-02-04,-654.63,578.6,Outgoing
33424425,2023-02-07,-615.04,39.59,Incoming
33424425,2023-02-13,-691.0799999999999,76.04,Outgoing
33470885,2023-01-31,531.96,,-
33470885,2023-02-02,350.40000000000003,181.56,Outgoing
33470885,2023-02-03,426.06000000000006,75.66,Incoming
33470885,2023-02-03,533.96,107.9,Incoming
33470885,2023-02-05,604.4000000000001,70.44,Incoming
33470885,2023-02-07,-1072.0,1676.4,Outgoing
33470885,2023-02-12,-0.599999999999909,1071.4,Incoming
33470885,2023-02-13,-62.54999999999991,61.95,Outgoing
33470885,2023-02-14,-207.6099999999999,145.06,Outgoing
33505838,2023-01-31,76.39,,-
33505838,2023-02-05,21.86,54.53,Outgoing
33505838,2023-02-06,-113.95,135.81,Outgoing
33505838,2023-02-07,-40.69,73.26,Incoming
33505838,2023-02-07,37.269999999999996,77.96,Incoming
33505838,2023-02-08,-50.07000000000001,87.34,Outgoing
33505838,2023-02-14,43.05,93.12,Incoming
33527603,2023-01-31,413.42,,-
33527603,2023-02-10,918.22,504.8,Incoming
33527603,2023-02-10,1041.88,123.66,Incoming
33527603,2023-02-11,1137.15,95.27,Incoming
33527603,2023-02-12,1043.1000000000001,94.05,Outgoing
33527603,2023-02-13,-111.59999999999991,1154.7,Outgoing
33527759,2023-01-31,245.55,,-
33527759,2023-02-06,346.45000000000005,100.9,Incoming
33527759,2023-02-11,1138.85,792.4,Incoming
33561341,2023-01-31,749.16,,-
33561341,2023-02-01,646.8499999999999,102.31,Outgoing
33561341,2023-02-05,629.5999999999999,17.25,Outgoing
33561341,2023-02-09,515.1499999999999,114.45,Outgoing
33632099,2023-01-31,943.81,,-
33632099,2023-02-04,2342.51,1398.7,Incoming
33632099,2023-02-05,2377.2700000000004,34.76,Incoming
33632099,2023-02-10,2288.5500000000006,88.72,Outgoing
33632099,2023-02-10,2372.060000000001,83.51,Incoming
33632099,2023-02-11,380.7600000000009,1991.3,Outgoing
33632099,2023-02-12,-1574.839999999999,1955.6,Outgoing
33632099,2023-02-13,-1629.429999999999,54.59,Outgoing
33632099,2023-02-13,-259.329999999999,1370.1,Incoming
33632099,2023-02-14,-201.49999999999903,57.83,Incoming
33634912,2023-01-31,888.99,,-
33634912,2023-02-02,938.75,49.76,Incoming
33634912,2023-02-04,1047.83,109.08,Incoming
33634912,2023-02-04,1021.3499999999999,26.48,Outgoing
33634912,2023-02-06,1009.7399999999999,11.61,Outgoing
33634912,2023-02-10,1150.8,141.06,Incoming
33634912,2023-02-13,1269.6299999999999,118.83,Incoming
33634912,2023-02-13,1208.29,61.34,Outgoing
33634912,2023-02-13,1360.05,151.76,Incoming
33634912,2023-02-14,1523.3899999999999,163.34,Incoming
33749113,2023-01-31,590.37,,-
33749113,2023-02-03,735.35,144.98,Incoming
33749113,2023-02-05,837.52,102.17,Incoming
33749113,2023-02-07,959.54,122.02,Incoming
33749113,2023-02-12,1082.35,122.81,Incoming
33749113,2023-02-12,955.4199999999998,126.93,Outgoing
33749812,2023-01-31,121.02,,-
33749812,2023-02-02,70.19,50.83,Outgoing
33749812,2023-02-03,149.11,78.92,Incoming
33749812,2023-02-04,1106.6100000000001,957.5,Incoming
33749812,2023-02-04,1146.3700000000001,39.76,Incoming
33749812,2023-02-05,1036.3000000000002,110.07,Outgoing
33749812,2023-02-06,935.5000000000002,100.8,Outgoing
33750944,2023-01-31,100.44,,-
33750944,2023-02-05,239.1,138.66,Incoming
33750944,2023-02-14,118.27,120.83,Outgoing
33771855,2023-01-31,886.78,,-
33771855,2023-02-01,1413.88,527.1,Incoming
33771855,2023-02-01,1260.23,153.65,Outgoing
33771855,2023-02-05,1490.73,230.5,Incoming
33771855,2023-02-09,1464.41,26.32,Outgoing
33771855,2023-02-11,1668.0800000000002,203.67,Incoming
33771855,2023-02-13,1622.5200000000002,45.56,Outgoing
33806253,2023-01-31,847.44,,-
33806253,2023-02-01,696.26,151.18,Outgoing
33806253,2023-02-05,840.89,144.63,Incoming
33806253,2023-02-06,951.36,110.47,Incoming
33806253,2023-02-09,1038.38,87.02,Incoming
33806253,2023-02-10,898.6200000000001,139.76,Outgoing
33832864,2023-01-31,46.85,,-
33832864,2023-02-02,156.13,109.28,Incoming
33832864,2023-02-03,284.75,128.62,Incoming
33832864,2023-02-06,2028.25,1743.5,Incoming
33832864,2023-02-13,1905.2,123.05,Outgoing
33906740,2023-01-31,820.46,,-
33906740,2023-02-01,887.98,67.52,Incoming
33906740,2023-02-02,1589.08,701.1,Incoming
33906740,2023-02-04,1635.57,46.49,Incoming
33906740,2023-02-04,1698.26,62.69,Incoming
33906740,2023-02-10,2445.56,747.3,Incoming
33906740,2023-02-11,2340.1,105.46,Outgoing
33906740,2023-02-12,2364.8399999999997,24.74,Incoming
33906740,2023-02-14,2217.4599999999996,147.38,Outgoing
33914941,2023-01-31,665.9,,-
33914941,2023-02-01,826.38,160.48,Incoming
33914941,2023-02-03,931.45,105.07,Incoming
33914941,2023-02-05,1074.42,142.97,Incoming
33914941,2023-02-06,1128.47,54.05,Incoming
33915504,2023-01-31,742.98,,-
33915504,2023-02-07,608.36,134.62,Outgoing
33915504,2023-02-10,1320.56,712.2,Incoming
33915504,2023-02-11,1398.8799999999999,78.32,Incoming
33915504,2023-02-11,262.5799999999999,1136.3,Outgoing
33915504,2023-02-12,370.7399999999999,108.16,Incoming
33915504,2023-02-13,246.2999999999999,124.44,Outgoing
33915504,2023-02-14,297.1199999999999,50.82,Incoming
33915504,2023-02-14,2534.12,2237.0,Incoming
33967237,2023-01-31,324.8,,-
33967237,2023-02-01,182.65,142.15,Outgoing
33967237,2023-02-03,29.789999999999992,152.86,Outgoing
33967237,2023-02-04,116.86999999999999,87.08,Incoming
33967237,2023-02-04,8.659999999999997,108.21,Outgoing
33967237,2023-02-07,-44.940000000000005,53.6,Outgoing
33967237,2023-02-13,20.96,65.9,Incoming
33967237,2023-02-14,87.64000000000001,66.68,Incoming
34017695,2023-01-31,672.46,,-
34017695,2023-02-01,593.26,79.2,Outgoing
34017695,2023-02-04,667.19,73.93,Incoming
34017695,2023-02-05,703.75,36.56,Incoming
34017695,2023-02-07,922.25,218.5,Incoming
34017695,2023-02-08,989.74,67.49,Incoming
34017695,2023-02-13,841.31,148.43,Outgoing
34017695,2023-02-13,985.77,144.46,Incoming
34017695,2023-02-13,2741.77,1756.0,Incoming
34017695,2023-02-14,2591.5299999999997,150.24,Outgoing
34017695,2023-02-14,4594.23,2002.7,Incoming
34027487,2023-01-31,54.87,,-
34027487,2023-02-02,110.89,56.02,Incoming
34027487,2023-02-07,303.19,192.3,Incoming
34027487,2023-02-10,179.25,123.94,Outgoing
34027487,2023-02-11,222.42000000000002,43.17,Incoming
34027487,2023-02-12,165.26000000000002,57.16,Outgoing
34027487,2023-02-13,21.01000000000002,144.25,Outgoing
34027487,2023-02-14,-80.08999999999997,101.1,Outgoing
34112514,2023-01-31,974.1,,-
34112514,2023-02-12,1097.34,123.24,Incoming
34128127,2023-01-31,275.83,,-
34128127,2023-02-01,187.73,88.1,Outgoing
34128127,2023-02-05,-653.47,841.2,Outgoing
34128127,2023-02-05,-790.07,136.6,Outgoing
34128127,2023-02-10,-805.32,15.25,Outgoing
34128127,2023-02-11,-760.3000000000001,45.02,Incoming
34158235,2023-01-31,50.76,,-
34158235,2023-02-02,-44.76,95.52,Outgoing
34158235,2023-02-03,40.720000000000006,85.48,Incoming
34158235,2023-02-05,-25.099999999999987,65.82,Outgoing
34158235,2023-02-06,-158.03,132.93,Outgoing
34158235,2023-02-07,-114.78999999999999,43.24,Incoming
34158235,2023-02-08,-34.629999999999995,80.16,Incoming
34158235,2023-02-10,46.63000000000001,81.26,Incoming
34158235,2023-02-13,203.12,156.49,Incoming
34158235,2023-02-14,362.20000000000005,159.08,Incoming
34158235,2023-02-14,802.0,439.8,Incoming
34190086,2023-01-31,890.87,,-
34190086,2023-02-01,824.97,65.9,Outgoing
34190086,2023-02-08,969.03,144.06,Incoming
34190086,2023-02-13,1042.99,73.96,Incoming
34190086,2023-02-13,973.36,69.63,Outgoing
34190086,2023-02-14,947.91,25.45,Outgoing
34252525,2023-01-31,107.18,,-
34252525,2023-02-02,202.45,95.27,Incoming
34252525,2023-02-04,446.58,244.13,Incoming
34252525,2023-02-04,333.09,113.49,Outgoing
34252525,2023-02-07,250.29999999999995,82.79,Outgoing
34252525,2023-02-08,335.36999999999995,85.07,Incoming
34252525,2023-02-13,-1168.0300000000002,1503.4,Outgoing
34264499,2023-01-31,864.86,,-
34264499,2023-02-08,758.89,105.97,Outgoing
34264499,2023-02-09,-139.21000000000004,898.1,Outgoing
34264499,2023-02-09,-165.16000000000003,25.95,Outgoing
34264499,2023-02-09,-300.84000000000003,135.68,Outgoing
34264499,2023-02-12,-222.94000000000003,77.9,Incoming
34264499,2023-02-13,-299.01,76.07,Outgoing
34264499,2023-02-14,-371.40999999999997,72.4,Outgoing
34275044,2023-01-31,532.29,,-
34275044,2023-02-07,452.44999999999993,79.84,Outgoing
34275044,2023-02-08,308.18999999999994,144.26,Outgoing
34275044,2023-02-10,216.52999999999994,91.66,Outgoing
34275044,2023-02-11,106.58999999999995,109.94,Outgoing
34275044,2023-02-13,263.4799999999999,156.89,Incoming
34284479,2023-01-31,74.46,,-
34284479,2023-02-04,100.19999999999999,25.74,Incoming
34284479,2023-02-05,-55.44,155.64,Outgoing
34284479,2023-02-08,10.61,66.05,Incoming
34284479,2023-02-08,213.70999999999998,203.1,Incoming
34284479,2023-02-10,149.95,63.76,Outgoing
34284479,2023-02-12,27.469999999999985,122.48,Outgoing
34336001,2023-01-31,396.75,,-
34336001,2023-02-01,445.14,48.39,Incoming
34336001,2023-02-06,311.48,133.66,Outgoing
34336001,2023-02-08,125.14000000000001,186.34,Outgoing
34336001,2023-02-12,196.53000000000003,71.39,Incoming
34336001,2023-02-14,123.60000000000002,72.93,Outgoing
34336001,2023-02-14,212.76000000000002,89.16,Incoming
34351752,2023-01-31,30.31,,-
34351752,2023-02-02,42.96,12.65,Incoming
34351752,2023-02-02,70.48,27.52,Incoming
34351752,2023-02-05,298.14,227.66,Incoming
34374766,2023-01-31,916.09,,-
34374766,2023-02-01,784.5600000000001,131.53,Outgoing
34374766,2023-02-03,34.860000000000014,749.7,Outgoing
34374766,2023-02-06,173.10000000000002,138.24,Incoming
34374766,2023-02-08,406.46000000000004,233.36,Incoming
34374766,2023-02-08,-562.3399999999999,968.8,Outgoing
34374766,2023-02-10,-493.42999999999995,68.91,Incoming
34374766,2023-02-14,-506.85999999999996,13.43,Outgoing
34400277,2023-01-31,207.59,,-
34400277,2023-02-01,1601.29,1393.7,Incoming
34400277,2023-02-03,1533.1599999999999,68.13,Outgoing
34400277,2023-02-04,1382.7099999999998,150.45,Outgoing
34400277,2023-02-04,1306.0499999999997,76.66,Outgoing
34400277,2023-02-05,1299.3299999999997,6.72,Outgoing
34400277,2023-02-06,610.8299999999997,688.5,Outgoing
34400277,2023-02-10,665.6099999999997,54.78,Incoming
34400277,2023-02-14,552.0899999999997,113.52,Outgoing
34400277,2023-02-14,638.2599999999996,86.17,Incoming
34403979,2023-01-31,101.14,,-
34403979,2023-02-01,-79.92,181.06,Outgoing
34403979,2023-02-02,18.450000000000003,98.37,Incoming
34403979,2023-02-04,-58.92,77.37,Outgoing
34403979,2023-02-07,151.36,210.28,Incoming
34403979,2023-02-11,108.89000000000001,42.47,Outgoing
34403979,2023-02-12,1309.99,1201.1,Incoming
34403979,2023-02-14,1224.58,85.41,Outgoing
34461285,2023-01-31,149.82,,-
34461285,2023-02-04,66.08999999999999,83.73,Outgoing
34461285,2023-02-06,-55.510000000000005,121.6,Outgoing
34461285,2023-02-10,53.58999999999999,109.1,Incoming
34461285,2023-02-11,181.69,128.1,Incoming
34461285,2023-02-11,38.53999999999999,143.15,Outgoing
34461285,2023-02-13,-44.45,82.99,Outgoing
34482885,2023-01-31,359.84,,-
34482885,2023-02-05,521.3,161.46,Incoming
34482885,2023-02-08,696.7199999999999,175.42,Incoming
34482885,2023-02-08,337.81999999999994,358.9,Outgoing
34482885,2023-02-11,-823.28,1161.1,Outgoing
34482885,2023-02-14,-732.8,90.48,Incoming
34650969,2023-01-31,177.82,,-
34650969,2023-02-05,294.76,116.94,Incoming
34650969,2023-02-06,1289.96,995.2,Incoming
34650969,2023-02-08,1220.94,69.02,Outgoing
34650969,2023-02-10,1284.7,63.76,Incoming
34681193,2023-01-31,183.13,,-
34681193,2023-02-01,399.62,216.49,Incoming
34681193,2023-02-04,332.61,67.01,Outgoing
34681193,2023-02-06,199.49,133.12,Outgoing
34681193,2023-02-07,324.05,124.56,Incoming
34681193,2023-02-09,250.07,73.98,Outgoing
34681193,2023-02-13,365.57,115.5,Incoming
34866268,2023-01-31,516.92,,-
34866268,2023-02-03,695.39,178.47,Incoming
34866268,2023-02-12,-566.3100000000001,1261.7,Outgoing
34867145,2023-01-31,212.16,,-
34867145,2023-02-02,423.43,211.27,Incoming
34867145,2023-02-05,559.02,135.59,Incoming
34867145,2023-02-10,600.67,41.65,Incoming
34902863,2023-01-31,31.36,,-
34902863,2023-02-01,120.58,89.22,Incoming
34902863,2023-02-04,189.12,68.54,Incoming
34902863,2023-02-06,103.68,85.44,Outgoing
34902863,2023-02-07,-36.41999999999999,140.1,Outgoing
34902863,2023-02-11,-228.35,191.93,Outgoing
34908905,2023-01-31,887.49,,-
34908905,2023-02-04,989.8,102.31,Incoming
34908905,2023-02-05,972.1099999999999,17.69,Outgoing
34908905,2023-02-07,1018.9199999999998,46.81,Incoming
34908905,2023-02-08,1174.54,155.62,Incoming
34908905,2023-02-09,1309.4099999999999,134.87,Incoming
34908905,2023-02-09,1175.1999999999998,134.21,Outgoing
34908905,2023-02-13,1299.5699999999997,124.37,Incoming
34921262,2023-01-31,971.82,,-
34921262,2023-02-05,2888.92,1917.1,Incoming
34921262,2023-02-07,2817.4,71.52,Outgoing
34921262,2023-02-08,2919.27,101.87,Incoming
34921262,2023-02-10,3004.11,84.84,Incoming
34921262,2023-02-13,2955.06,49.05,Outgoing
34921262,2023-02-14,3003.45,48.39,Incoming
34960760,2023-01-31,981.79,,-
34960760,2023-02-02,1172.69,190.9,Incoming
34960760,2023-02-09,1268.45,95.76,Incoming
34960760,2023-02-10,1179.33,89.12,Outgoing
34960760,2023-02-12,1019.1899999999999,160.14,Outgoing
35038984,2023-01-31,566.36,,-
35038984,2023-02-07,459.16,107.2,Outgoing
35038984,2023-02-07,635.1700000000001,176.01,Incoming
35038984,2023-02-09,540.8800000000001,94.29,Outgoing
35038984,2023-02-11,640.45,99.57,Incoming
35051369,2023-01-31,637.18,,-
35051369,2023-02-01,680.8299999999999,43.65,Incoming
35051369,2023-02-02,568.4799999999999,112.35,Outgoing
35051369,2023-02-04,766.8499999999999,198.37,Incoming
35051369,2023-02-11,816.79,49.94,Incoming
35082945,2023-01-31,713.95,,-
35082945,2023-02-07,729.72,15.77,Incoming
35082945,2023-02-08,862.5,132.78,Incoming
35082945,2023-02-12,748.9,113.6,Outgoing
35082945,2023-02-14,560.18,188.72,Outgoing
35083564,2023-01-31,599.99,,-
35083564,2023-02-05,455.22,144.77,Outgoing
35083564,2023-02-06,487.42,32.2,Incoming
35083564,2023-02-06,668.6600000000001,181.24,Incoming
35083564,2023-02-08,529.44,139.22,Outgoing
35083564,2023-02-09,469.90000000000003,59.54,Outgoing
35126236,2023-01-31,739.8,,-
35126236,2023-02-02,1119.3,379.5,Incoming
35126236,2023-02-04,1054.82,64.48,Outgoing
35126236,2023-02-04,1164.03,109.21,Incoming
35126236,2023-02-06,168.82999999999993,995.2,Outgoing
35126236,2023-02-08,38.269999999999925,130.56,Outgoing
35126236,2023-02-08,-65.62000000000008,103.89,Outgoing
35126236,2023-02-10,-30.910000000000075,34.71,Incoming
35126236,2023-02-13,-168.26000000000008,137.35,Outgoing
35126236,2023-02-13,-282.6500000000001,114.39,Outgoing
35126236,2023-02-14,-2420.65,2138.0,Outgoing
35160368,2023-01-31,53.59,,-
35160368,2023-02-01,12.040000000000006,41.55,Outgoing
35160368,2023-02-05,-73.03999999999999,85.08,Outgoing
35160368,2023-02-05,-236.35999999999999,163.32,Outgoing
35160368,2023-02-10,-391.75,155.39,Outgoing
35160368,2023-02-12,-531.3199999999999,139.57,Outgoing
35160368,2023-02-13,-492.16999999999996,39.15,Incoming
35160368,2023-02-14,-399.5799999999999,92.59,Incoming
35160368,2023-02-14,-486.9099999999999,87.33,Outgoing
35177782,2023-01-31,79.03,,-
35177782,2023-02-03,-70.50999999999999,149.54,Outgoing
35177782,2023-02-08,-180.76,110.25,Outgoing
35177782,2023-02-09,-74.94,105.82,Incoming
35177782,2023-02-10,48.83,123.77,Incoming
35177782,2023-02-10,-23.35000000000001,72.18,Outgoing
35177782,2023-02-11,-122.77000000000001,99.42,Outgoing
35194218,2023-01-31,842.34,,-
35194218,2023-02-01,700.1400000000001,142.2,Outgoing
35194218,2023-02-04,694.2800000000001,5.86,Outgoing
35194218,2023-02-05,1506.88,812.6,Incoming
35194218,2023-02-10,1436.45,70.43,Outgoing
35194218,2023-02-11,1570.6100000000001,134.16,Incoming
35194218,2023-02-12,1646.71,76.1,Incoming
35197451,2023-01-31,411.69,,-
35197451,2023-02-01,507.75,96.06,Incoming
35197451,2023-02-02,506.84,0.91,Outgoing
35197451,2023-02-03,408.53,98.31,Outgoing
35197451,2023-02-05,322.39,86.14,Outgoing
35197451,2023-02-05,180.88,141.51,Outgoing
35197451,2023-02-07,49.03999999999999,131.84,Outgoing
35197451,2023-02-11,197.44,148.4,Incoming
35197451,2023-02-11,257.65999999999997,60.22,Incoming
35197451,2023-02-14,-465.74,723.4,Outgoing
35210460,2023-01-31,185.3,,-
35210460,2023-02-01,284.93,99.63,Incoming
35210460,2023-02-01,-1536.27,1821.2,Outgoing
35210460,2023-02-03,-1653.74,117.47,Outgoing
35210460,2023-02-08,-1853.2,199.46,Outgoing
35210460,2023-02-09,-1895.7,42.5,Outgoing
35210460,2023-02-10,-1964.48,68.78,Outgoing
35293864,2023-01-31,592.55,,-
35293864,2023-02-01,661.02,68.47,Incoming
35321469,2023-01-31,194.57,,-
35321469,2023-02-01,118.30999999999999,76.26,Outgoing
35321469,2023-02-02,237.67,119.36,Incoming
35321469,2023-02-07,350.7,113.03,Incoming
35321469,2023-02-09,275.74,74.96,Outgoing
35321469,2023-02-14,327.52,51.78,Incoming
35330225,2023-01-31,717.9,,-
35330225,2023-02-02,679.48,38.42,Outgoing
35330225,2023-02-04,561.52,117.96,Outgoing
35330225,2023-02-05,489.41999999999996,72.1,Outgoing
35330225,2023-02-06,580.1999999999999,90.78,Incoming
35330225,2023-02-08,675.28,95.08,Incoming
35330225,2023-02-09,-494.1200000000001,1169.4,Outgoing
35330225,2023-02-14,11.479999999999905,505.6,Incoming
35345678,2023-01-31,381.43,,-
35345678,2023-02-02,282.92,98.51,Outgoing
35345678,2023-02-03,112.22000000000003,170.7,Outgoing
35345678,2023-02-06,-41.309999999999974,153.53,Outgoing
35345678,2023-02-06,55.75000000000003,97.06,Incoming
35345678,2023-02-07,183.31000000000003,127.56,Incoming
35379604,2023-01-31,171.68,,-
35379604,2023-02-06,143.32,28.36,Outgoing
35379604,2023-02-06,228.11,84.79,Incoming
35379604,2023-02-08,213.46,14.65,Outgoing
35379604,2023-02-08,-479.53999999999996,693.0,Outgoing
35379604,2023-02-10,-365.71999999999997,113.82,Incoming
35379604,2023-02-13,-307.09999999999997,58.62,Incoming
35391237,2023-01-31,412.06,,-
35391237,2023-02-01,518.0,105.94,Incoming
35391237,2023-02-01,644.5,126.5,Incoming
35391237,2023-02-01,540.56,103.94,Outgoing
35391237,2023-02-02,638.4599999999999,97.9,Incoming
35391237,2023-02-03,786.06,147.6,Incoming
35391237,2023-02-04,949.0899999999999,163.03,Incoming
35391237,2023-02-07,1103.05,153.96,Incoming
35391237,2023-02-11,1044.69,58.36,Outgoing
35391237,2023-02-13,1179.41,134.72,Incoming
35391237,2023-02-14,1043.71,135.7,Outgoing
35391340,2023-01-31,886.56,,-
35391340,2023-02-01,1005.76,119.2,Incoming
35391340,2023-02-04,1106.3899999999999,100.63,Incoming
35391340,2023-02-04,980.9799999999999,125.41,Outgoing
35391340,2023-02-08,1058.24,77.26,Incoming
35391340,2023-02-09,901.57,156.67,Outgoing
35391340,2023-02-09,837.1300000000001,64.44,Outgoing
35391340,2023-02-11,727.3700000000001,109.76,Outgoing
35391340,2023-02-11,815.0000000000001,87.63,Incoming
35391340,2023-02-12,930.0400000000001,115.04,Incoming
35405748,2023-01-31,19.49,,-
35405748,2023-02-02,-1646.51,1666.0,Outgoing
35405748,2023-02-03,-1474.52,171.99,Incoming
35405748,2023-02-06,-1414.1299999999999,60.39,Incoming
35405748,2023-02-09,-1350.1399999999999,63.99,Incoming
35445202,2023-01-31,972.48,,-
35445202,2023-02-04,1067.49,95.01,Incoming
35445202,2023-02-04,929.15,138.34,Outgoing
35445202,2023-02-05,886.9,42.25,Outgoing
35445202,2023-02-07,815.78,71.12,Outgoing
35445202,2023-02-13,896.5,80.72,Incoming
35445202,2023-02-13,845.83,50.67,Outgoing
35445202,2023-02-14,717.27,128.56,Outgoing
35506101,2023-01-31,713.65,,-
35506101,2023-02-04,857.48,143.83,Incoming
35506101,2023-02-06,1226.38,368.9,Incoming
35506101,2023-02-07,1200.2900000000002,26.09,Outgoing
35506101,2023-02-07,1184.5200000000002,15.77,Outgoing
35506101,2023-02-08,1113.6000000000001,70.92,Outgoing
35506101,2023-02-09,2500.4,1386.8,Incoming
35506101,2023-02-09,2413.38,87.02,Outgoing
35506101,2023-02-11,2521.33,107.95,Incoming
35510004,2023-01-31,723.62,,-
35510004,2023-02-07,776.76,53.14,Incoming
35510004,2023-02-09,916.79,140.03,Incoming
35510004,2023-02-14,793.8499999999999,122.94,Outgoing
35539408,2023-01-31,469.13,,-
35539408,2023-02-08,402.55,66.58,Outgoing
35539408,2023-02-12,381.59000000000003,20.96,Outgoing
35539408,2023-02-12,441.89000000000004,60.3,Incoming
35540836,2023-01-31,17.91,,-
35540836,2023-02-01,-102.78,120.69,Outgoing
35540836,2023-02-04,-264.88,162.1,Outgoing
35540836,2023-02-11,-200.32999999999998,64.55,Incoming
35540836,2023-02-12,-1050.43,850.1,Outgoing
35549277,2023-01-31,505.72,,-
35549277,2023-02-03,341.58000000000004,164.14,Outgoing
35549277,2023-02-04,197.63000000000005,143.95,Outgoing
35549277,2023-02-06,143.42000000000004,54.21,Outgoing
35549277,2023-02-08,209.24000000000004,65.82,Incoming
35549277,2023-02-09,129.91000000000003,79.33,Outgoing
35549277,2023-02-14,-5.809999999999974,135.72,Outgoing
35555120,2023-01-31,598.72,,-
35555120,2023-02-05,710.75,112.03,Incoming
35555120,2023-02-06,865.79,155.04,Incoming
35555120,2023-02-09,941.18,75.39,Incoming
35564578,2023-01-31,621.37,,-
35564578,2023-02-01,519.69,101.68,Outgoing
35564578,2023-02-01,362.81000000000006,156.88,Outgoing
35564578,2023-02-05,396.13000000000005,33.32,Incoming
35564578,2023-02-06,319.5300000000001,76.6,Outgoing
35564578,2023-02-06,178.70000000000007,140.83,Outgoing
35564578,2023-02-07,272.5900000000001,93.89,Incoming
35564578,2023-02-09,179.4500000000001,93.14,Outgoing
35564578,2023-02-11,1088.5500000000002,909.1,Incoming
35564578,2023-02-12,1184.2600000000002,95.71,Incoming
35564578,2023-02-14,1030.7800000000002,153.48,Outgoing
35574156,2023-01-31,471.05,,-
35574156,2023-02-02,389.85,81.2,Outgoing
35574156,2023-02-02,502.88,113.03,Incoming
35574156,2023-02-04,601.15,98.27,Incoming
35574156,2023-02-10,483.35999999999996,117.79,Outgoing
35574156,2023-02-12,555.01,71.65,Incoming
35614465,2023-01-31,276.17,,-
35614465,2023-02-01,387.65000000000003,111.48,Incoming
35614465,2023-02-01,280.76000000000005,106.89,Outgoing
35614465,2023-02-01,205.14000000000004,75.62,Outgoing
35614465,2023-02-02,136.56000000000006,68.58,Outgoing
35614465,2023-02-04,-102.39999999999995,238.96,Outgoing
35614465,2023-02-04,-184.64999999999995,82.25,Outgoing
35614465,2023-02-07,-360.65999999999997,176.01,Outgoing
35614465,2023-02-09,-279.15999999999997,81.5,Incoming
35614465,2023-02-12,-237.54999999999995,41.61,Incoming
35614465,2023-02-14,-289.65,52.1,Outgoing
35614465,2023-02-14,-220.14,69.51,Incoming
35616763,2023-01-31,279.43,,-
35616763,2023-02-03,134.45000000000002,144.98,Outgoing
35616763,2023-02-04,43.54000000000002,90.91,Outgoing
35616763,2023-02-04,-48.339999999999975,91.88,Outgoing
35616763,2023-02-05,-147.23999999999998,98.9,Outgoing
35616763,2023-02-09,-52.45999999999998,94.78,Incoming
35616763,2023-02-10,81.43,133.89,Incoming
35633136,2023-01-31,603.11,,-
35633136,2023-02-07,743.83,140.72,Incoming
35633136,2023-02-08,2332.83,1589.0,Incoming
35633136,2023-02-09,477.3299999999999,1855.5,Outgoing
35633136,2023-02-10,562.4899999999999,85.16,Incoming
35633136,2023-02-12,691.1099999999999,128.62,Incoming
35633136,2023-02-14,467.1199999999999,223.99,Outgoing
35642953,2023-01-31,137.26,,-
35642953,2023-02-07,183.08999999999997,45.83,Incoming
35642953,2023-02-10,41.25999999999996,141.83,Outgoing
35642953,2023-02-11,143.68999999999997,102.43,Incoming
35642953,2023-02-13,16.96999999999997,126.72,Outgoing
35652360,2023-01-31,41.81,,-
35652360,2023-02-02,-45.489999999999995,87.3,Outgoing
35652360,2023-02-07,90.13000000000001,135.62,Incoming
35652360,2023-02-10,191.87,101.74,Incoming
35652360,2023-02-12,199.33,7.46,Incoming
35698347,2023-01-31,258.22,,-
35698347,2023-02-09,403.24,145.02,Incoming
35698347,2023-02-12,326.88,76.36,Outgoing
35698347,2023-02-12,244.68,82.2,Outgoing
35698347,2023-02-12,387.78,143.1,Incoming
35698347,2023-02-12,359.35999999999996,28.42,Outgoing
35698347,2023-02-13,335.55999999999995,23.8,Outgoing
35698347,2023-02-14,440.5899999999999,105.03,Incoming
35712712,2023-01-31,828.88,,-
35712712,2023-02-02,733.96,94.92,Outgoing
35712712,2023-02-04,642.74,91.22,Outgoing
35712712,2023-02-13,736.32,93.58,Incoming
35712712,2023-02-14,867.9000000000001,131.58,Incoming
35721788,2023-01-31,837.07,,-
35721788,2023-02-02,789.35,47.72,Outgoing
35721788,2023-02-04,-758.85,1548.2,Outgoing
35721788,2023-02-05,-569.5,189.35,Incoming
35721788,2023-02-07,-735.77,166.27,Outgoing
35721788,2023-02-11,-668.74,67.03,Incoming
35726421,2023-01-31,379.1,,-
35726421,2023-02-01,415.40000000000003,36.3,Incoming
35726421,2023-02-09,448.08000000000004,32.68,Incoming
35726421,2023-02-09,190.98000000000002,257.1,Outgoing
35726421,2023-02-11,308.39,117.41,Incoming
35726421,2023-02-12,189.62,118.77,Outgoing
35726421,2023-02-12,336.43,146.81,Incoming
35726421,2023-02-13,304.42,32.01,Outgoing
35726421,2023-02-14,389.38,84.96,Incoming
35726421,2023-02-14,246.31,143.07,Outgoing
35746207,2023-01-31,785.36,,-
35746207,2023-02-02,643.1,142.26,Outgoing
35746207,2023-02-04,806.6800000000001,163.58,Incoming
35746207,2023-02-08,942.74,136.06,Incoming
35746207,2023-02-09,1122.78,180.04,Incoming
35746207,2023-02-11,1229.65,106.87,Incoming
35746207,2023-02-14,1147.17,82.48,Outgoing
35746207,2023-02-14,1220.94,73.77,Incoming
35762783,2023-01-31,346.14,,-
35762783,2023-02-04,311.5,34.64,Outgoing
35762783,2023-02-06,213.98000000000002,97.52,Outgoing
35762783,2023-02-06,312.19,98.21,Incoming
35772673,2023-01-31,517.9,,-
35772673,2023-02-01,594.29,76.39,Incoming
35772673,2023-02-11,576.8399999999999,17.45,Outgoing
35772673,2023-02-12,463.05999999999995,113.78,Outgoing
35799522,2023-01-31,750.79,,-
35799522,2023-02-04,628.5999999999999,122.19,Outgoing
35799522,2023-02-04,713.0799999999999,84.48,Incoming
35799522,2023-02-08,-98.12000000000012,811.2,Outgoing
35799522,2023-02-09,-175.21000000000012,77.09,Outgoing
35799522,2023-02-12,-656.4100000000001,481.2,Outgoing
35799522,2023-02-12,-534.2800000000001,122.13,Incoming
35799522,2023-02-13,-587.97,53.69,Outgoing
35805852,2023-01-31,886.37,,-
35805852,2023-02-03,860.09,26.28,Outgoing
35805852,2023-02-08,701.04,159.05,Outgoing
35805852,2023-02-13,781.14,80.1,Incoming
35805852,2023-02-13,909.92,128.78,Incoming
35827625,2023-01-31,445.63,,-
35827625,2023-02-01,450.08,4.45,Incoming
35827625,2023-02-03,581.0,130.92,Incoming
35827625,2023-02-06,530.14,50.86,Outgoing
35827625,2023-02-07,364.08,166.06,Outgoing
35827625,2023-02-08,467.57,103.49,Incoming
35827625,2023-02-13,329.5,138.07,Outgoing
35869347,2023-01-31,768.74,,-
35869347,2023-02-01,867.8,99.06,Incoming
35869347,2023-02-06,739.0999999999999,128.7,Outgoing
35869347,2023-02-08,802.5199999999999,63.42,Incoming
35869347,2023-02-09,679.6099999999999,122.91,Outgoing
35869347,2023-02-10,174.8099999999999,504.8,Outgoing
35869347,2023-02-13,825.31,650.5,Incoming
35948735,2023-01-31,117.14,,-
35948735,2023-02-06,-56.13000000000001,173.27,Outgoing
35948735,2023-02-08,201.26999999999998,257.4,Incoming
35948735,2023-02-10,261.08,59.81,Incoming
35948735,2023-02-12,364.88,103.8,Incoming
35948735,2023-02-13,219.04999999999998,145.83,Outgoing
35996817,2023-01-31,187.89,,-
35996817,2023-02-02,125.75999999999999,62.13,Outgoing
35996817,2023-02-02,933.66,807.9,Incoming
35996817,2023-02-03,1889.06,955.4,Incoming
35996817,2023-02-04,1726.3,162.76,Outgoing
35996817,2023-02-04,1629.11,97.19,Outgoing
35996817,2023-02-05,1590.03,39.08,Outgoing
35996817,2023-02-06,445.53,1144.5,Outgoing
35996817,2023-02-13,557.28,111.75,Incoming
36007496,2023-01-31,239.44,,-
36007496,2023-02-03,345.98,106.54,Incoming
36007496,2023-02-04,215.61,130.37,Outgoing
36007496,2023-02-10,358.39,142.78,Incoming
36007496,2023-02-11,414.06,55.67,Incoming
36007496,2023-02-12,504.39,90.33,Incoming
36106467,2023-01-31,720.17,,-
36106467,2023-02-02,666.06,54.11,Outgoing
36106467,2023-02-13,715.03,48.97,Incoming
36106467,2023-02-14,824.16,109.13,Incoming
36110938,2023-01-31,532.77,,-
36110938,2023-02-05,683.92,151.15,Incoming
36110938,2023-02-14,573.5,110.42,Outgoing
36110938,2023-02-14,624.86,51.36,Incoming
36112473,2023-01-31,530.67,,-
36112473,2023-02-02,426.39,104.28,Outgoing
36112473,2023-02-07,443.11,16.72,Incoming
36112473,2023-02-08,314.69000000000005,128.42,Outgoing
36112473,2023-02-08,277.62000000000006,37.07,Outgoing
36112473,2023-02-11,165.75000000000006,111.87,Outgoing
36114551,2023-01-31,876.22,,-
36114551,2023-02-03,888.75,12.53,Incoming
36114551,2023-02-03,2376.75,1488.0,Incoming
36114551,2023-02-07,2386.27,9.52,Incoming
36114551,2023-02-11,2251.77,134.5,Outgoing
36114551,2023-02-11,2138.57,113.2,Outgoing
36114551,2023-02-13,2292.7200000000003,154.15,Incoming
36114551,2023-02-14,2158.21,134.51,Outgoing
36126802,2023-01-31,617.04,,-
36126802,2023-02-04,499.06999999999994,117.97,Outgoing
36126802,2023-02-10,621.7299999999999,122.66,Incoming
36126802,2023-02-12,702.3599999999999,80.63,Incoming
36131723,2023-01-31,602.96,,-
36131723,2023-02-02,-120.03999999999996,723.0,Outgoing
36131723,2023-02-06,-194.81999999999996,74.78,Outgoing
36131723,2023-02-07,-348.05999999999995,153.24,Outgoing
36131723,2023-02-08,-287.35999999999996,60.7,Incoming
36131723,2023-02-13,-405.71999999999997,118.36,Outgoing
36141472,2023-01-31,656.7,,-
36141472,2023-02-09,636.6,20.1,Outgoing
36143004,2023-01-31,256.22,,-
36143004,2023-02-03,389.17,132.95,Incoming
36143004,2023-02-04,447.91,58.74,Incoming
36143004,2023-02-08,336.88,111.03,Outgoing
36143004,2023-02-13,209.69,127.19,Outgoing
36171568,2023-01-31,343.44,,-
36171568,2023-02-06,512.91,169.47,Incoming
36171568,2023-02-14,361.43999999999994,151.47,Outgoing
36192947,2023-01-31,744.33,,-
36192947,2023-02-02,671.1800000000001,73.15,Outgoing
36192947,2023-02-04,624.0200000000001,47.16,Outgoing
36192947,2023-02-05,782.5600000000001,158.54,Incoming
36192947,2023-02-05,886.36,103.8,Incoming
36192947,2023-02-05,1021.22,134.86,Incoming
36192947,2023-02-07,585.4200000000001,435.8,Outgoing
36192947,2023-02-11,549.0400000000001,36.38,Outgoing
36192947,2023-02-11,618.7400000000001,69.7,Incoming
36192947,2023-02-13,663.3100000000002,44.57,Incoming
36192947,2023-02-14,588.7800000000002,74.53,Outgoing
36197772,2023-01-31,962.03,,-
36197772,2023-02-01,983.85,21.82,Incoming
36197772,2023-02-04,1173.15,189.3,Incoming
36197772,2023-02-06,993.57,179.58,Outgoing
36197772,2023-02-12,1070.9,77.33,Incoming
36197772,2023-02-13,1235.66,164.76,Incoming
36197772,2023-02-14,1345.8000000000002,110.14,Incoming
36258926,2023-01-31,549.71,,-
36258926,2023-02-06,650.4200000000001,100.71,Incoming
36258926,2023-02-06,547.0500000000001,103.37,Outgoing
36258926,2023-02-09,680.21,133.16,Incoming
36258926,2023-02-10,559.82,120.39,Outgoing
36259936,2023-01-31,628.23,,-
36259936,2023-02-01,609.46,18.77,Outgoing
36259936,2023-02-05,205.86,403.6,Outgoing
36259936,2023-02-06,189.36,16.5,Outgoing
36259936,2023-02-08,250.06,60.7,Incoming
36259936,2023-02-11,381.67,131.61,Incoming
36259936,2023-02-12,495.12,113.45,Incoming
36296704,2023-01-31,491.31,,-
36296704,2023-02-04,323.58000000000004,167.73,Outgoing
36296704,2023-02-04,515.22,191.64,Incoming
36296704,2023-02-05,498.98,16.24,Outgoing
36296704,2023-02-08,382.40000000000003,116.58,Outgoing
36327122,2023-01-31,808.81,,-
36327122,2023-02-02,936.41,127.6,Incoming
36327122,2023-02-07,832.25,104.16,Outgoing
36327122,2023-02-08,884.0,51.75,Incoming
36389309,2023-01-31,469.45,,-
36389309,2023-02-06,602.38,132.93,Incoming
36389309,2023-02-08,639.09,36.71,Incoming
36389309,2023-02-09,555.62,83.47,Outgoing
36389309,2023-02-11,1827.12,1271.5,Incoming
36389309,2023-02-11,1681.31,145.81,Outgoing
36393557,2023-01-31,407.12,,-
36393557,2023-02-03,506.19,99.07,Incoming
36393557,2023-02-05,607.35,101.16,Incoming
36393557,2023-02-06,749.9000000000001,142.55,Incoming
36393557,2023-02-09,744.3100000000001,5.59,Outgoing
36393557,2023-02-13,582.8700000000001,161.44,Outgoing
36419197,2023-01-31,627.78,,-
36419197,2023-02-02,498.33,129.45,Outgoing
36419197,2023-02-07,328.96999999999997,169.36,Outgoing
36419197,2023-02-08,-1364.23,1693.2,Outgoing
36419197,2023-02-14,-1454.97,90.74,Outgoing
36425954,2023-01-31,93.85,,-
36425954,2023-02-03,240.44,146.59,Incoming
36425954,2023-02-04,89.6,150.84,Outgoing
36425954,2023-02-04,-42.09,131.69,Outgoing
36425954,2023-02-10,99.37,141.46,Incoming
36425954,2023-02-11,139.59,40.22,Incoming
36425954,2023-02-14,35.41,104.18,Outgoing
36519974,2023-01-31,922.41,,-
36519974,2023-02-05,1051.8799999999999,129.47,Incoming
36519974,2023-02-07,1090.76,38.88,Incoming
36519974,2023-02-09,2613.46,1522.7,Incoming
36519974,2023-02-12,2751.82,138.36,Incoming
36549889,2023-01-31,760.2,,-
36549889,2023-02-09,857.59,97.39,Incoming
36549889,2023-02-10,870.07,12.48,Incoming
36549889,2023-02-10,1001.69,131.62,Incoming
36549889,2023-02-14,857.86,143.83,Outgoing
36551112,2023-01-31,976.02,,-
36551112,2023-02-01,988.85,12.83,Incoming
36551112,2023-02-05,804.94,183.91,Outgoing
36551112,2023-02-05,844.97,40.03,Incoming
36551112,2023-02-06,877.3100000000001,32.34,Incoming
36551112,2023-02-06,779.6700000000001,97.64,Outgoing
36551112,2023-02-14,2293.77,1514.1,Incoming
36551112,2023-02-14,4490.969999999999,2197.2,Incoming
36596942,2023-01-31,550.9,,-
36596942,2023-02-03,419.98,130.92,Outgoing
36596942,2023-02-06,309.89,110.09,Outgoing
36596942,2023-02-08,500.77,190.88,Incoming
36596942,2023-02-08,574.9,74.13,Incoming
36596942,2023-02-09,419.61,155.29,Outgoing
36596942,2023-02-13,371.23,48.38,Outgoing
36596942,2023-02-13,320.55,50.68,Outgoing
36596942,2023-02-13,339.40000000000003,18.85,Incoming
36611100,2023-01-31,485.06,,-
36611100,2023-02-02,341.0,144.06,Outgoing
36611100,2023-02-03,906.2,565.2,Incoming
36611100,2023-02-05,997.76,91.56,Incoming
36611100,2023-02-08,926.15,71.61,Outgoing
36611100,2023-02-10,1100.92,174.77,Incoming
36636385,2023-01-31,985.55,,-
36636385,2023-02-01,1119.61,134.06,Incoming
36636385,2023-02-04,1045.59,74.02,Outgoing
36636385,2023-02-07,-347.1100000000001,1392.7,Outgoing
36636385,2023-02-10,-212.57000000000014,134.54,Incoming
36636385,2023-02-10,-136.51000000000013,76.06,Incoming
36668239,2023-01-31,566.32,,-
36668239,2023-02-02,-1073.88,1640.2,Outgoing
36668239,2023-02-03,-1002.6100000000001,71.27,Incoming
36668239,2023-02-11,-878.8000000000002,123.81,Incoming
36668239,2023-02-13,-867.6900000000002,11.11,Incoming
36692647,2023-01-31,710.29,,-
36692647,2023-02-02,543.9399999999999,166.35,Outgoing
36692647,2023-02-09,414.17999999999995,129.76,Outgoing
36696277,2023-01-31,395.42,,-
36696277,2023-02-01,241.99,153.43,Outgoing
36696277,2023-02-08,350.95,108.96,Incoming
36696277,2023-02-08,276.57,74.38,Outgoing
36696277,2023-02-08,398.55,121.98,Incoming
36696277,2023-02-09,347.77,50.78,Outgoing
36696277,2023-02-10,-203.02999999999997,550.8,Outgoing
36696277,2023-02-11,-241.76999999999998,38.74,Outgoing
36696277,2023-02-12,-1733.47,1491.7,Outgoing
36725272,2023-01-31,52.82,,-
36725272,2023-02-02,0.03999999999999915,52.78,Outgoing
36725272,2023-02-05,-129.23000000000002,129.27,Outgoing
36725272,2023-02-06,-290.6,161.37,Outgoing
36725272,2023-02-07,-181.40000000000003,109.2,Incoming
36725272,2023-02-14,-55.040000000000035,126.36,Incoming
36837451,2023-01-31,429.52,,-
36837451,2023-02-01,283.5,146.02,Outgoing
36837451,2023-02-02,187.18,96.32,Outgoing
36837451,2023-02-02,-25.419999999999987,212.6,Outgoing
36837451,2023-02-02,-57.37999999999999,31.96,Outgoing
36837451,2023-02-07,20.080000000000005,77.46,Incoming
36837451,2023-02-12,139.17000000000002,119.09,Incoming
36837451,2023-02-12,61.84000000000002,77.33,Outgoing
36841261,2023-01-31,172.37,,-
36841261,2023-02-01,300.02,127.65,Incoming
36841261,2023-02-04,189.71999999999997,110.3,Outgoing
36841261,2023-02-06,349.18999999999994,159.47,Incoming
36841261,2023-02-10,209.19999999999993,139.99,Outgoing
36841261,2023-02-12,80.57999999999993,128.62,Outgoing
36841261,2023-02-14,229.20999999999992,148.63,Incoming
36849841,2023-01-31,593.56,,-
36849841,2023-02-02,656.0799999999999,62.52,Incoming
36849841,2023-02-03,830.6999999999999,174.62,Incoming
36849841,2023-02-04,914.43,83.73,Incoming
36849841,2023-02-05,800.41,114.02,Outgoing
36849841,2023-02-10,899.87,99.46,Incoming
36871984,2023-01-31,949.89,,-
36871984,2023-02-05,1053.18,103.29,Incoming
36871984,2023-02-07,996.69,56.49,Outgoing
36871984,2023-02-08,1151.3200000000002,154.63,Incoming
36871984,2023-02-12,-511.67999999999984,1663.0,Outgoing
36871984,2023-02-13,-453.3799999999998,58.3,Incoming
36949196,2023-01-31,614.22,,-
36949196,2023-02-02,495.90000000000003,118.32,Outgoing
36949196,2023-02-03,371.02000000000004,124.88,Outgoing
36949196,2023-02-04,496.43000000000006,125.41,Incoming
36949196,2023-02-04,583.1700000000001,86.74,Incoming
36949196,2023-02-07,668.94,85.77,Incoming
36982820,2023-01-31,833.46,,-
36982820,2023-02-01,233.66000000000008,599.8,Outgoing
36982820,2023-02-05,308.2100000000001,74.55,Incoming
36982820,2023-02-08,305.49000000000007,2.72,Outgoing
36982820,2023-02-12,431.11000000000007,125.62,Incoming
36982820,2023-02-12,313.6600000000001,117.45,Outgoing
36982820,2023-02-14,233.2000000000001,80.46,Outgoing
37004975,2023-01-31,635.77,,-
37004975,2023-02-04,691.31,55.54,Incoming
37004975,2023-02-05,569.06,122.25,Outgoing
37004975,2023-02-06,477.47999999999996,91.58,Outgoing
37004975,2023-02-06,417.9,59.58,Outgoing
37004975,2023-02-07,2097.7,1679.8,Incoming
37004975,2023-02-08,3387.8999999999996,1290.2,Incoming
37004975,2023-02-09,3500.2099999999996,112.31,Incoming
37004975,2023-02-09,3462.5599999999995,37.65,Outgoing
37004975,2023-02-13,3352.3899999999994,110.17,Outgoing
37017424,2023-01-31,71.34,,-
37017424,2023-02-01,169.86,98.52,Incoming
37017424,2023-02-01,255.69,85.83,Incoming
37017424,2023-02-02,144.53,111.16,Outgoing
37017424,2023-02-10,1675.53,1531.0,Incoming
37017424,2023-02-10,1686.6,11.07,Incoming
37017424,2023-02-12,1614.86,71.74,Outgoing
37017424,2023-02-13,1543.35,71.51,Outgoing
37062632,2023-01-31,366.72,,-
37062632,2023-02-01,247.27000000000004,119.45,Outgoing
37062632,2023-02-04,157.76000000000005,89.51,Outgoing
37062632,2023-02-06,329.06000000000006,171.3,Incoming
37062632,2023-02-09,278.6500000000001,50.41,Outgoing
37062632,2023-02-10,351.2600000000001,72.61,Incoming
37062632,2023-02-10,246.7300000000001,104.53,Outgoing
37062632,2023-02-13,159.7000000000001,87.03,Outgoing
37146521,2023-01-31,471.64,,-
37146521,2023-02-01,489.90999999999997,18.27,Incoming
37146521,2023-02-04,584.1999999999999,94.29,Incoming
37146521,2023-02-08,779.55,195.35,Incoming
37146521,2023-02-08,2345.25,1565.7,Incoming
37146521,2023-02-08,2438.98,93.73,Incoming
37146521,2023-02-10,2485.05,46.07,Incoming
37146521,2023-02-13,2447.5800000000004,37.47,Outgoing
37164421,2023-01-31,302.68,,-
37164421,2023-02-03,157.26000000000002,145.42,Outgoing
37164421,2023-02-06,23.79000000000002,133.47,Outgoing
37164421,2023-02-10,221.51000000000002,197.72,Incoming
37164421,2023-02-11,39.400000000000006,182.11,Outgoing
37247834,2023-01-31,319.19,,-
37247834,2023-02-01,468.15,148.96,Incoming
37247834,2023-02-01,1405.25,937.1,Incoming
37247834,2023-02-07,1236.04,169.21,Outgoing
37247834,2023-02-08,1072.07,163.97,Outgoing
37247834,2023-02-08,1128.2,56.13,Incoming
37247834,2023-02-09,1266.68,138.48,Incoming
37247834,2023-02-09,1346.81,80.13,Incoming
37247834,2023-02-11,1464.48,117.67,Incoming
37247834,2023-02-12,1649.99,185.51,Incoming
37247834,2023-02-14,1607.86,42.13,Outgoing
37256412,2023-01-31,24.43,,-
37256412,2023-02-03,1553.8300000000002,1529.4,Incoming
37256412,2023-02-05,1418.44,135.39,Outgoing
37256412,2023-02-08,1338.31,80.13,Outgoing
37256412,2023-02-11,1215.07,123.24,Outgoing
37267391,2023-01-31,819.11,,-
37267391,2023-02-01,924.87,105.76,Incoming
37267391,2023-02-02,1590.87,666.0,Incoming
37267391,2023-02-04,1488.1599999999999,102.71,Outgoing
37267391,2023-02-06,1588.9599999999998,100.8,Incoming
37267391,2023-02-06,959.6599999999999,629.3,Outgoing
37267391,2023-02-09,824.7899999999998,134.87,Outgoing
37267391,2023-02-10,887.6099999999999,62.82,Incoming
37267391,2023-02-11,840.2299999999999,47.38,Outgoing
37273974,2023-01-31,533.14,,-
37273974,2023-02-02,453.01,80.13,Outgoing
37273974,2023-02-02,-246.89,699.9,Outgoing
37273974,2023-02-03,-427.76,180.87,Outgoing
37273974,2023-02-05,-490.3,62.54,Outgoing
37273974,2023-02-13,-365.05,125.25,Incoming
37274865,2023-01-31,95.23,,-
37297429,2023-01-31,693.82,,-
37297429,2023-02-01,773.22,79.4,Incoming
37297429,2023-02-02,-210.07999999999993,983.3,Outgoing
37297429,2023-02-02,-318.16999999999996,108.09,Outgoing
37297429,2023-02-03,-189.91999999999996,128.25,Incoming
37297429,2023-02-05,-235.81999999999996,45.9,Outgoing
37297429,2023-02-06,-308.69999999999993,72.88,Outgoing
37297429,2023-02-08,-114.80999999999995,193.89,Incoming
37297429,2023-02-14,38.34000000000006,153.15,Incoming
37297429,2023-02-14,63.79000000000006,25.45,Incoming
37319261,2023-01-31,574.42,,-
37319261,2023-02-04,673.81,99.39,Incoming
37319261,2023-02-06,2083.41,1409.6,Incoming
37319261,2023-02-09,2173.16,89.75,Incoming
37319261,2023-02-10,2117.87,55.29,Outgoing
37369245,2023-01-31,446.65,,-
37369245,2023-02-01,521.05,74.4,Incoming
37369245,2023-02-03,564.77,43.72,Incoming
37369245,2023-02-04,682.96,118.19,Incoming
37369245,2023-02-04,600.4000000000001,82.56,Outgoing
37369245,2023-02-05,640.8100000000001,40.41,Incoming
37369245,2023-02-10,1965.71,1324.9,Incoming
37369245,2023-02-14,2089.9700000000003,124.26,Incoming
37407392,2023-01-31,822.17,,-
37407392,2023-02-04,742.6999999999999,79.47,Outgoing
37407392,2023-02-05,749.5699999999999,6.87,Incoming
37407392,2023-02-10,860.1899999999999,110.62,Incoming
37407392,2023-02-13,947.39,87.2,Incoming
37407392,2023-02-14,897.99,49.4,Outgoing
37443706,2023-01-31,621.08,,-
37443706,2023-02-03,532.75,88.33,Outgoing
37443706,2023-02-07,622.06,89.31,Incoming
37443706,2023-02-08,463.39,158.67,Outgoing
37443706,2023-02-08,415.2,48.19,Outgoing
37443706,2023-02-12,319.4,95.8,Outgoing
37443706,2023-02-13,-768.6,1088.0,Outgoing
37443706,2023-02-13,-671.5500000000001,97.05,Incoming
37443706,2023-02-14,-718.8000000000001,47.25,Outgoing
37503622,2023-01-31,630.18,,-
37503622,2023-02-03,483.29999999999995,146.88,Outgoing
37503622,2023-02-03,604.5999999999999,121.3,Incoming
37503622,2023-02-04,1851.5,1246.9,Incoming
37503622,2023-02-04,3246.8,1395.3,Incoming
37503622,2023-02-09,3349.4900000000002,102.69,Incoming
37503622,2023-02-09,3246.3300000000004,103.16,Outgoing
37503622,2023-02-09,1945.6300000000003,1300.7,Outgoing
37510139,2023-01-31,546.33,,-
37510139,2023-02-03,1372.13,825.8,Incoming
37510139,2023-02-05,1255.19,116.94,Outgoing
37510139,2023-02-11,1213.0,42.19,Outgoing
37510139,2023-02-14,1049.6100000000001,163.39,Outgoing
37528735,2023-01-31,368.39,,-
37528735,2023-02-02,460.86,92.47,Incoming
37528735,2023-02-07,307.56,153.3,Outgoing
37528735,2023-02-08,350.15,42.59,Incoming
37528735,2023-02-11,338.84999999999997,11.3,Outgoing
37528735,2023-02-14,249.42999999999995,89.42,Outgoing
37561049,2023-01-31,903.95,,-
37561049,2023-02-01,984.5300000000001,80.58,Incoming
37561049,2023-02-02,1124.8700000000001,140.34,Incoming
37561049,2023-02-03,1203.5300000000002,78.66,Incoming
37561049,2023-02-04,1106.7500000000002,96.78,Outgoing
37561049,2023-02-04,1103.8900000000003,2.86,Outgoing
37561049,2023-02-05,-818.6099999999997,1922.5,Outgoing
37561049,2023-02-13,-662.2399999999997,156.37,Incoming
37561049,2023-02-13,-825.5699999999997,163.33,Outgoing
37561049,2023-02-14,-938.6399999999996,113.07,Outgoing
37599317,2023-01-31,177.32,,-
37599317,2023-02-02,60.889999999999986,116.43,Outgoing
37599317,2023-02-03,228.5,167.61,Incoming
37599317,2023-02-09,171.97,56.53,Outgoing
37599317,2023-02-11,275.38,103.41,Incoming
37599317,2023-02-11,201.76,73.62,Outgoing
37599317,2023-02-12,334.24,132.48,Incoming
37642787,2023-01-31,396.03,,-
37642787,2023-02-03,395.0,1.03,Outgoing
37642787,2023-02-03,316.72,78.28,Outgoing
37642787,2023-02-03,504.42,187.7,Incoming
37642787,2023-02-04,632.1800000000001,127.76,Incoming
37642787,2023-02-06,680.49,48.31,Incoming
37642787,2023-02-10,-609.1099999999999,1289.6,Outgoing
37642787,2023-02-10,-634.4199999999998,25.31,Outgoing
37642787,2023-02-14,-793.5099999999999,159.09,Outgoing
37658218,2023-01-31,561.27,,-
37658218,2023-02-01,-9.029999999999973,570.3,Outgoing
37658218,2023-02-02,30.840000000000025,39.87,Incoming
37658218,2023-02-07,-12.789999999999978,43.63,Outgoing
37658218,2023-02-09,70.63000000000002,83.42,Incoming
37658218,2023-02-14,156.13000000000002,85.5,Incoming
37658218,2023-02-14,257.66,101.53,Incoming
37678813,2023-01-31,767.56,,-
37678813,2023-02-03,834.91,67.35,Incoming
37678813,2023-02-08,940.3199999999999,105.41,Incoming
37678813,2023-02-13,862.18,78.14,Outgoing
37678813,2023-02-13,795.9499999999999,66.23,Outgoing
37767441,2023-01-31,726.46,,-
37767441,2023-02-01,814.6500000000001,88.19,Incoming
37767441,2023-02-02,830.45,15.8,Incoming
37767441,2023-02-03,735.62,94.83,Outgoing
37767441,2023-02-08,648.61,87.01,Outgoing
37767441,2023-02-09,583.65,64.96,Outgoing
37767441,2023-02-12,414.21,169.44,Outgoing
37789180,2023-01-31,854.05,,-
37789180,2023-02-02,930.04,75.99,Incoming
37789180,2023-02-03,910.15,19.89,Outgoing
37789180,2023-02-07,825.3199999999999,84.83,Outgoing
37789180,2023-02-08,-795.6800000000001,1621.0,Outgoing
37789180,2023-02-09,930.72,1726.4,Incoming
37789180,2023-02-11,-106.27999999999997,1037.0,Outgoing
37789180,2023-02-11,-133.14999999999998,26.87,Outgoing
37789180,2023-02-11,-197.98999999999998,64.84,Outgoing
37789180,2023-02-12,-131.67,66.32,Incoming
37789180,2023-02-13,15.830000000000013,147.5,Incoming
37796234,2023-01-31,992.46,,-
37796234,2023-02-02,937.5300000000001,54.93,Outgoing
37796234,2023-02-02,-760.4699999999999,1698.0,Outgoing
37796234,2023-02-04,-675.56,84.91,Incoming
37796234,2023-02-04,-864.9399999999999,189.38,Outgoing
37796234,2023-02-04,-780.8199999999999,84.12,Incoming
37796234,2023-02-06,-844.18,63.36,Outgoing
37796234,2023-02-08,-1940.38,1096.2,Outgoing
37796234,2023-02-09,-1767.18,173.2,Incoming
37796234,2023-02-09,-1805.89,38.71,Outgoing
37830423,2023-01-31,285.5,,-
37830423,2023-02-02,370.40999999999997,84.91,Incoming
37830423,2023-02-04,249.71999999999997,120.69,Outgoing
37830423,2023-02-05,194.33999999999997,55.38,Outgoing
37830423,2023-02-07,264.28,69.94,Incoming
37830423,2023-02-08,245.16999999999996,19.11,Outgoing
37830423,2023-02-08,227.53999999999996,17.63,Outgoing
37830423,2023-02-13,290.71,63.17,Incoming
37878074,2023-01-31,647.56,,-
37878074,2023-02-01,772.25,124.69,Incoming
37878074,2023-02-03,1990.25,1218.0,Incoming
37878074,2023-02-04,2026.49,36.24,Incoming
37878074,2023-02-11,2144.11,117.62,Incoming
37878074,2023-02-11,2246.2400000000002,102.13,Incoming
37878074,2023-02-11,2966.9400000000005,720.7,Incoming
37905098,2023-01-31,389.98,,-
37905098,2023-02-04,277.33000000000004,112.65,Outgoing
37905098,2023-02-07,369.46000000000004,92.13,Incoming
37905098,2023-02-07,567.08,197.62,Incoming
37905098,2023-02-07,604.98,37.9,Incoming
37905098,2023-02-08,499.57000000000005,105.41,Outgoing
37905098,2023-02-09,389.90000000000003,109.67,Outgoing
37905098,2023-02-11,309.05000000000007,80.85,Outgoing
37905098,2023-02-12,479.4800000000001,170.43,Incoming
37905098,2023-02-12,604.7500000000001,125.27,Incoming
37936898,2023-01-31,745.79,,-
37936898,2023-02-01,850.64,104.85,Incoming
37936898,2023-02-03,949.17,98.53,Incoming
37936898,2023-02-06,1948.27,999.1,Incoming
37936898,2023-02-06,1788.78,159.49,Outgoing
37936898,2023-02-10,1624.85,163.93,Outgoing
37936898,2023-02-10,1562.6999999999998,62.15,Outgoing
37936898,2023-02-11,1649.6799999999998,86.98,Incoming
37936898,2023-02-13,1575.82,73.86,Outgoing
37945317,2023-01-31,8.24,,-
37945317,2023-02-02,-114.57000000000001,122.81,Outgoing
37945317,2023-02-03,-644.1700000000001,529.6,Outgoing
37945317,2023-02-06,-524.0200000000001,120.15,Incoming
37945317,2023-02-07,-2213.7200000000003,1689.7,Outgoing
37945317,2023-02-09,-2105.19,108.53,Incoming
37945317,2023-02-09,-1887.92,217.27,Incoming
37945317,2023-02-10,-3412.32,1524.4,Outgoing
37945317,2023-02-12,-3501.76,89.44,Outgoing
37945317,2023-02-14,-3401.0600000000004,100.7,Incoming
37953007,2023-01-31,440.78,,-
37953007,2023-02-02,508.98999999999995,68.21,Incoming
37953007,2023-02-04,1295.09,786.1,Incoming
37953007,2023-02-04,1164.9699999999998,130.12,Outgoing
38032055,2023-01-31,416.47,,-
38032055,2023-02-04,448.98,32.51,Incoming
38032055,2023-02-07,604.1,155.12,Incoming
38032055,2023-02-07,591.44,12.66,Outgoing
38032055,2023-02-10,712.73,121.29,Incoming
38032055,2023-02-10,1099.53,386.8,Incoming
38032055,2023-02-12,952.52,147.01,Outgoing
38032055,2023-02-14,864.16,88.36,Outgoing
38038623,2023-01-31,526.98,,-
38038623,2023-02-05,-818.1199999999999,1345.1,Outgoing
38038623,2023-02-06,-762.8599999999999,55.26,Incoming
38038623,2023-02-10,-637.9299999999998,124.93,Incoming
38038623,2023-02-13,-489.35999999999984,148.57,Incoming
38038623,2023-02-14,-293.4399999999998,195.92,Incoming
38124225,2023-01-31,943.59,,-
38124225,2023-02-05,835.8000000000001,107.79,Outgoing
38124225,2023-02-08,744.5600000000001,91.24,Outgoing
38124225,2023-02-08,858.72,114.16,Incoming
38124225,2023-02-09,1004.3000000000001,145.58,Incoming
38124225,2023-02-09,1105.54,101.24,Incoming
38124225,2023-02-10,1042.19,63.35,Outgoing
38124225,2023-02-10,927.8700000000001,114.32,Outgoing
38124225,2023-02-13,861.9700000000001,65.9,Outgoing
38157078,2023-01-31,756.55,,-
38157078,2023-02-04,91.94999999999993,664.6,Outgoing
38157078,2023-02-07,178.4699999999999,86.52,Incoming
38157078,2023-02-13,348.43999999999994,169.97,Incoming
38224160,2023-01-31,701.82,,-
38224160,2023-02-02,794.72,92.9,Incoming
38224160,2023-02-03,913.82,119.1,Incoming
38224160,2023-02-07,989.7700000000001,75.95,Incoming
38224160,2023-02-13,1065.8100000000002,76.04,Incoming
38291062,2023-01-31,486.68,,-
38291062,2023-02-01,569.1,82.42,Incoming
38291062,2023-02-05,647.77,78.67,Incoming
38291062,2023-02-06,400.95,246.82,Outgoing
38291062,2023-02-11,399.24,1.71,Outgoing
38291062,2023-02-12,519.1700000000001,119.93,Incoming
38291062,2023-02-14,441.8400000000001,77.33,Outgoing
38291062,2023-02-14,547.0900000000001,105.25,Incoming
38316158,2023-01-31,138.4,,-
38316158,2023-02-02,63.91000000000001,74.49,Outgoing
38316158,2023-02-05,-28.36999999999999,92.28,Outgoing
38316158,2023-02-05,-256.03,227.66,Outgoing
38316158,2023-02-07,-292.01,35.98,Outgoing
38316158,2023-02-08,-316.77,24.76,Outgoing
38316158,2023-02-14,-263.5,53.27,Incoming
38346624,2023-01-31,740.09,,-
38346624,2023-02-10,554.88,185.21,Outgoing
38346624,2023-02-10,-182.32000000000005,737.2,Outgoing
38395807,2023-01-31,463.52,,-
38395807,2023-02-07,318.59,144.93,Outgoing
38395807,2023-02-08,274.53999999999996,44.05,Outgoing
38395807,2023-02-09,315.30999999999995,40.77,Incoming
38395807,2023-02-12,224.07999999999993,91.23,Outgoing
38428295,2023-01-31,690.12,,-
38428295,2023-02-08,889.58,199.46,Incoming
38428295,2023-02-11,1057.14,167.56,Incoming
38428295,2023-02-13,1185.25,128.11,Incoming
38428295,2023-02-14,1355.54,170.29,Incoming
38429514,2023-01-31,627.62,,-
38429514,2023-02-01,699.8,72.18,Incoming
38429514,2023-02-04,819.63,119.83,Incoming
38429514,2023-02-08,927.65,108.02,Incoming
38429514,2023-02-10,1067.4099999999999,139.76,Incoming
38429514,2023-02-11,1020.0899999999998,47.32,Outgoing
38429514,2023-02-12,917.1399999999998,102.95,Outgoing
38429514,2023-02-14,863.1799999999997,53.96,Outgoing
38442044,2023-01-31,106.95,,-
38442044,2023-02-02,42.05,64.9,Outgoing
38442044,2023-02-03,65.89,23.84,Incoming
38442044,2023-02-06,14.939999999999998,50.95,Outgoing
38442044,2023-02-07,159.1,144.16,Incoming
38442044,2023-02-07,311.35,152.25,Incoming
38442044,2023-02-07,198.22000000000003,113.13,Outgoing
38442044,2023-02-08,140.45000000000002,57.77,Outgoing
38442044,2023-02-08,106.33000000000001,34.12,Outgoing
38442044,2023-02-12,7.680000000000007,98.65,Outgoing
38442044,2023-02-14,-852.4200000000001,860.1,Outgoing
38487215,2023-01-31,780.01,,-
38487215,2023-02-01,-28.389999999999986,808.4,Outgoing
38487215,2023-02-03,-147.33999999999997,118.95,Outgoing
38487215,2023-02-03,-19.23999999999998,128.1,Incoming
38487215,2023-02-06,1523.76,1543.0,Incoming
38495059,2023-01-31,14.18,,-
38495059,2023-02-02,50.78,36.6,Incoming
38495059,2023-02-06,93.32,42.54,Incoming
38495059,2023-02-11,229.32,136.0,Incoming
38502892,2023-01-31,600.32,,-
38502892,2023-02-06,662.4000000000001,62.08,Incoming
38502892,2023-02-07,590.7900000000001,71.61,Outgoing
38502892,2023-02-08,638.1600000000001,47.37,Incoming
38528119,2023-01-31,165.9,,-
38528119,2023-02-06,87.61,78.29,Outgoing
38528119,2023-02-06,278.86,191.25,Incoming
38528119,2023-02-08,446.52,167.66,Incoming
38528119,2023-02-13,277.57,168.95,Outgoing
38528119,2023-02-14,161.05,116.52,Outgoing
38558525,2023-01-31,833.07,,-
38558525,2023-02-04,770.82,62.25,Outgoing
38558525,2023-02-07,-1048.1799999999998,1819.0,Outgoing
38558525,2023-02-08,-1242.4799999999998,194.3,Outgoing
38564653,2023-01-31,647.95,,-
38564653,2023-02-03,644.45,3.5,Outgoing
38564653,2023-02-05,539.87,104.58,Outgoing
38564653,2023-02-12,406.42,133.45,Outgoing
38564653,2023-02-13,312.45000000000005,93.97,Outgoing
38587383,2023-01-31,579.12,,-
38587383,2023-02-01,498.05,81.07,Outgoing
38587383,2023-02-01,644.15,146.1,Incoming
38587383,2023-02-03,683.52,39.37,Incoming
38587383,2023-02-03,572.86,110.66,Outgoing
38587383,2023-02-04,734.96,162.1,Incoming
38587383,2023-02-07,610.6500000000001,124.31,Outgoing
38587383,2023-02-07,776.9200000000001,166.27,Incoming
38587383,2023-02-09,895.33,118.41,Incoming
38587383,2023-02-12,932.47,37.14,Incoming
38587383,2023-02-12,1015.0600000000001,82.59,Incoming
38606148,2023-01-31,956.59,,-
38606148,2023-02-02,1067.75,111.16,Incoming
38606148,2023-02-04,999.84,67.91,Outgoing
38606148,2023-02-04,1072.3700000000001,72.53,Incoming
38606148,2023-02-06,1098.41,26.04,Incoming
38606148,2023-02-11,1230.97,132.56,Incoming
38606148,2023-02-12,2554.37,1323.4,Incoming
38606148,2023-02-12,2422.79,131.58,Outgoing
38627867,2023-01-31,132.74,,-
38627867,2023-02-05,232.65,99.91,Incoming
38627867,2023-02-06,161.71,70.94,Outgoing
38627867,2023-02-14,263.8,102.09,Incoming
38690875,2023-01-31,320.39,,-
38690875,2023-02-03,446.59999999999997,126.21,Incoming
38690875,2023-02-06,644.8,198.2,Incoming
38690875,2023-02-11,791.89,147.09,Incoming
38690875,2023-02-13,867.98,76.09,Incoming
38690875,2023-02-13,972.22,104.24,Incoming
38690875,2023-02-14,1095.1200000000001,122.9,Incoming
38740782,2023-01-31,702.64,,-
38740782,2023-02-04,836.19,133.55,Incoming
38740782,2023-02-05,897.2800000000001,61.09,Incoming
38740782,2023-02-12,981.3500000000001,84.07,Incoming
38740782,2023-02-12,905.2500000000001,76.1,Outgoing
38749064,2023-01-31,569.98,,-
38749064,2023-02-01,426.01,143.97,Outgoing
38749064,2023-02-02,1862.31,1436.3,Incoming
38749064,2023-02-03,1773.25,89.06,Outgoing
38749064,2023-02-14,1634.54,138.71,Outgoing
38764064,2023-01-31,648.12,,-
38764064,2023-02-01,595.95,52.17,Outgoing
38764064,2023-02-02,580.1500000000001,15.8,Outgoing
38764064,2023-02-07,473.5100000000001,106.64,Outgoing
38764064,2023-02-09,440.6400000000001,32.87,Outgoing
38764064,2023-02-11,431.3900000000001,9.25,Outgoing
38764064,2023-02-13,334.8800000000001,96.51,Outgoing
38764064,2023-02-14,276.0000000000001,58.88,Outgoing
38780970,2023-01-31,846.59,,-
38780970,2023-02-01,964.86,118.27,Incoming
38780970,2023-02-04,847.6,117.26,Outgoing
38780970,2023-02-07,793.32,54.28,Outgoing
38780970,2023-02-10,745.45,47.87,Outgoing
38780970,2023-02-13,1584.35,838.9,Incoming
38839019,2023-01-31,187.15,,-
38839019,2023-02-01,-749.95,937.1,Outgoing
38839019,2023-02-01,-696.96,52.99,Incoming
38839019,2023-02-02,-540.9200000000001,156.04,Incoming
38839019,2023-02-08,-654.9000000000001,113.98,Outgoing
38839019,2023-02-11,-490.5300000000001,164.37,Incoming
38839019,2023-02-11,-596.9300000000001,106.4,Outgoing
38839019,2023-02-14,-767.5,170.57,Outgoing
38903150,2023-01-31,263.28,,-
38903150,2023-02-03,360.04999999999995,96.77,Incoming
38903150,2023-02-04,488.23999999999995,128.19,Incoming
38903150,2023-02-07,676.5999999999999,188.36,Incoming
38903150,2023-02-10,592.43,84.17,Outgoing
38903150,2023-02-10,438.5899999999999,153.84,Outgoing
38903150,2023-02-11,572.18,133.59,Incoming
38903150,2023-02-14,1729.2799999999997,1157.1,Incoming
38921478,2023-01-31,641.48,,-
38921478,2023-02-02,529.32,112.16,Outgoing
38921478,2023-02-03,537.0200000000001,7.7,Incoming
38921478,2023-02-04,627.1500000000001,90.13,Incoming
38921478,2023-02-05,557.57,69.58,Outgoing
38921478,2023-02-05,1850.37,1292.8,Incoming
38921478,2023-02-07,1803.4499999999998,46.92,Outgoing
38921478,2023-02-10,1918.1899999999998,114.74,Incoming
38921478,2023-02-12,1812.9899999999998,105.2,Outgoing
38921478,2023-02-13,1856.5499999999997,43.56,Incoming
38921478,2023-02-14,1987.3899999999996,130.84,Incoming
38957380,2023-01-31,37.95,,-
38957380,2023-02-02,155.85000000000002,117.9,Incoming
38957380,2023-02-03,80.19000000000003,75.66,Outgoing
38957380,2023-02-04,-8.639999999999972,88.83,Outgoing
38957380,2023-02-07,103.87000000000003,112.51,Incoming
38957380,2023-02-07,227.57000000000005,123.7,Incoming
38957380,2023-02-07,361.5300000000001,133.96,Incoming
38957380,2023-02-10,240.2600000000001,121.27,Outgoing
38957380,2023-02-10,72.31000000000012,167.95,Outgoing
38957380,2023-02-13,200.40000000000012,128.09,Incoming
38969279,2023-01-31,195.74,,-
38969279,2023-02-02,47.650000000000006,148.09,Outgoing
38969279,2023-02-04,-1532.1499999999999,1579.8,Outgoing
38969279,2023-02-04,-1526.61,5.54,Incoming
38969279,2023-02-05,634.0899999999999,2160.7,Incoming
38969279,2023-02-05,456.63999999999993,177.45,Outgoing
38969279,2023-02-06,-580.6600000000001,1037.3,Outgoing
38969279,2023-02-10,-2079.76,1499.1,Outgoing
38969279,2023-02-12,-2183.5600000000004,103.8,Outgoing
38990596,2023-01-31,108.78,,-
38990596,2023-02-03,-1354.02,1462.8,Outgoing
38990596,2023-02-07,-2702.3199999999997,1348.3,Outgoing
38990596,2023-02-07,-2677.99,24.33,Incoming
38990596,2023-02-10,-2803.0299999999997,125.04,Outgoing
38990596,2023-02-12,-2709.6099999999997,93.42,Incoming
38990596,2023-02-13,-2587.45,122.16,Incoming
38991889,2023-01-31,292.35,,-
38991889,2023-02-05,397.3,104.95,Incoming
38991889,2023-02-08,559.9300000000001,162.63,Incoming
38991889,2023-02-10,635.6400000000001,75.71,Incoming
38991889,2023-02-10,611.6800000000001,23.96,Outgoing
38991889,2023-02-12,482.68000000000006,129.0,Outgoing
38991889,2023-02-14,521.6,38.92,Incoming
39001531,2023-01-31,882.34,,-
39001531,2023-02-03,950.47,68.13,Incoming
39001531,2023-02-06,998.9,48.43,Incoming
39001531,2023-02-10,1166.85,167.95,Incoming
39001531,2023-02-13,1277.59,110.74,Incoming
39013360,2023-01-31,987.76,,-
39013360,2023-02-02,876.55,111.21,Outgoing
39013360,2023-02-03,692.68,183.87,Outgoing
39013360,2023-02-07,772.8699999999999,80.19,Incoming
39013360,2023-02-12,664.7099999999999,108.16,Outgoing
39013360,2023-02-12,504.3799999999999,160.33,Outgoing
39013360,2023-02-12,410.95999999999987,93.42,Outgoing
39013360,2023-02-12,296.1899999999999,114.77,Outgoing
39013360,2023-02-12,1959.1899999999998,1663.0,Incoming
39061853,2023-01-31,353.93,,-
39061853,2023-02-01,255.88,98.05,Outgoing
39061853,2023-02-03,137.55,118.33,Outgoing
39061853,2023-02-03,30.950000000000017,106.6,Outgoing
39061853,2023-02-04,-43.25999999999998,74.21,Outgoing
39061853,2023-02-04,15.600000000000023,58.86,Incoming
39061853,2023-02-04,15.370000000000022,0.23,Outgoing
39061853,2023-02-05,132.91000000000003,117.54,Incoming
39061853,2023-02-07,233.23000000000002,100.32,Incoming
39061853,2023-02-09,418.33000000000004,185.1,Incoming
39061853,2023-02-12,504.98,86.65,Incoming
39061853,2023-02-14,587.38,82.4,Incoming
39093565,2023-01-31,107.2,,-
39093565,2023-02-04,286.14,178.94,Incoming
39093565,2023-02-08,2158.94,1872.8,Incoming
39093565,2023-02-10,2066.4500000000003,92.49,Outgoing
39097663,2023-01-31,326.42,,-
39097663,2023-02-02,201.64000000000001,124.78,Outgoing
39097663,2023-02-08,134.47000000000003,67.17,Outgoing
39097663,2023-02-12,8.990000000000023,125.48,Outgoing
39097663,2023-02-12,49.060000000000024,40.07,Incoming
39122920,2023-01-31,445.68,,-
39122920,2023-02-08,320.88,124.8,Outgoing
39122920,2023-02-08,253.91,66.97,Outgoing
39122920,2023-02-09,119.16,134.75,Outgoing
39122920,2023-02-10,-5.77000000000001,124.93,Outgoing
39122920,2023-02-12,-61.85000000000001,56.08,Outgoing
39122920,2023-02-12,49.849999999999994,111.7,Incoming
39122920,2023-02-13,-46.19000000000001,96.04,Outgoing
39122920,2023-02-13,-68.68,22.49,Outgoing
39122920,2023-02-14,6.329999999999998,75.01,Incoming
39122920,2023-02-14,148.51,142.18,Incoming
39123048,2023-01-31,687.59,,-
39123048,2023-02-01,604.1800000000001,83.41,Outgoing
39123048,2023-02-01,696.82,92.64,Incoming
39123048,2023-02-03,784.2800000000001,87.46,Incoming
39123048,2023-02-03,1297.58,513.3,Incoming
39123048,2023-02-08,1433.46,135.88,Incoming
39123048,2023-02-09,1591.25,157.79,Incoming
39123048,2023-02-09,1731.6,140.35,Incoming
39123048,2023-02-10,1745.5,13.9,Incoming
39123048,2023-02-12,1867.93,122.43,Incoming
39123048,2023-02-14,1727.93,140.0,Outgoing
39160879,2023-01-31,444.15,,-
39160879,2023-02-01,631.04,186.89,Incoming
39160879,2023-02-04,497.98999999999995,133.05,Outgoing
39160879,2023-02-13,-340.91,838.9,Outgoing
39160879,2023-02-14,-643.61,302.7,Outgoing
39161053,2023-01-31,375.28,,-
39161053,2023-02-01,233.14,142.14,Outgoing
39161053,2023-02-01,390.03,156.89,Incoming
39161053,2023-02-02,296.18999999999994,93.84,Outgoing
39161053,2023-02-03,192.75999999999993,103.43,Outgoing
39161053,2023-02-05,329.90999999999997,137.15,Incoming
39161053,2023-02-05,-150.69000000000005,480.6,Outgoing
39161053,2023-02-07,-203.83000000000004,53.14,Outgoing
39161053,2023-02-14,-89.15000000000003,114.68,Incoming
39267013,2023-01-31,516.74,,-
39267013,2023-02-02,2012.54,1495.8,Incoming
39267013,2023-02-03,2080.3,67.76,Incoming
39267013,2023-02-04,2148.44,68.14,Incoming
39267013,2023-02-12,2238.06,89.62,Incoming
39267013,2023-02-14,2381.85,143.79,Incoming
39298122,2023-01-31,607.25,,-
39298122,2023-02-01,472.25,135.0,Outgoing
39298122,2023-02-02,349.71,122.54,Outgoing
39298122,2023-02-03,156.42,193.29,Outgoing
39298122,2023-02-06,1042.32,885.9,Incoming
39298122,2023-02-08,1196.79,154.47,Incoming
39298122,2023-02-12,1250.36,53.57,Incoming
39298122,2023-02-13,1283.3,32.94,Incoming
39360799,2023-01-31,379.72,,-
39360799,2023-02-01,478.17,98.45,Incoming
39360799,2023-02-01,615.4200000000001,137.25,Incoming
39360799,2023-02-01,2250.12,1634.7,Incoming
39360799,2023-02-07,2206.88,43.24,Outgoing
39360799,2023-02-13,2088.92,117.96,Outgoing
39386771,2023-01-31,171.52,,-
39386771,2023-02-02,258.82,87.3,Incoming
39386771,2023-02-02,159.38,99.44,Outgoing
39386771,2023-02-04,322.14,162.76,Incoming
39386771,2023-02-04,416.75,94.61,Incoming
39386771,2023-02-10,330.87,85.88,Outgoing
39386771,2023-02-10,223.79000000000002,107.08,Outgoing
39386771,2023-02-10,280.98,57.19,Incoming
39398476,2023-01-31,541.52,,-
39398476,2023-02-02,434.90999999999997,106.61,Outgoing
39398476,2023-02-07,318.04999999999995,116.86,Outgoing
39398476,2023-02-10,217.88999999999996,100.16,Outgoing
39400991,2023-01-31,896.44,,-
39400991,2023-02-05,886.12,10.32,Outgoing
39400991,2023-02-11,847.67,38.45,Outgoing
39400991,2023-02-13,754.0899999999999,93.58,Outgoing
39402264,2023-01-31,993.04,,-
39402264,2023-02-01,-262.26,1255.3,Outgoing
39402264,2023-02-05,-389.25,126.99,Outgoing
39402264,2023-02-07,-488.76,99.51,Outgoing
39402264,2023-02-07,-389.83,98.93,Incoming
39402264,2023-02-11,1559.77,1949.6,Incoming
39402264,2023-02-14,1801.48,241.71,Incoming
39402264,2023-02-14,1919.16,117.68,Incoming
39427922,2023-01-31,794.1,,-
39427922,2023-02-01,925.63,131.53,Incoming
39427922,2023-02-02,779.78,145.85,Outgoing
39427922,2023-02-03,639.28,140.5,Outgoing
39427922,2023-02-04,802.56,163.28,Incoming
39427922,2023-02-07,949.3799999999999,146.82,Incoming
39427922,2023-02-08,1066.4499999999998,117.07,Incoming
39427922,2023-02-13,1036.0399999999997,30.41,Outgoing
39427922,2023-02-14,1199.3199999999997,163.28,Incoming
39491241,2023-01-31,564.0,,-
39491241,2023-02-02,464.0,100.0,Outgoing
39491241,2023-02-05,341.82,122.18,Outgoing
39491241,2023-02-06,262.37,79.45,Outgoing
39491241,2023-02-08,146.74,115.63,Outgoing
39491241,2023-02-12,66.11000000000001,80.63,Outgoing
39491241,2023-02-12,187.01000000000002,120.9,Incoming
39502821,2023-01-31,924.88,,-
39502821,2023-02-03,953.33,28.45,Incoming
39502821,2023-02-03,631.73,321.6,Outgoing
39502821,2023-02-05,604.8000000000001,26.93,Outgoing
39502821,2023-02-09,664.08,59.28,Incoming
39502821,2023-02-09,800.5600000000001,136.48,Incoming
39502821,2023-02-12,1006.84,206.28,Incoming
39504855,2023-01-31,890.63,,-
39504855,2023-02-02,772.03,118.6,Outgoing
39504855,2023-02-05,896.4,124.37,Incoming
39504855,2023-02-06,841.14,55.26,Outgoing
39504855,2023-02-11,934.46,93.32,Incoming
39504855,2023-02-11,-65.74000000000001,1000.2,Outgoing
39504855,2023-02-12,-68.81,3.07,Outgoing
39504855,2023-02-14,3.539999999999992,72.35,Incoming
39516154,2023-01-31,620.87,,-
39516154,2023-02-02,1893.9699999999998,1273.1,Incoming
39516154,2023-02-06,1871.3099999999997,22.66,Outgoing
39516154,2023-02-11,2965.3099999999995,1094.0,Incoming
39516154,2023-02-12,3071.3299999999995,106.02,Incoming
39516154,2023-02-13,2914.2399999999993,157.09,Outgoing
39516154,2023-02-13,2976.3199999999993,62.08,Incoming
39516203,2023-01-31,689.19,,-
39516203,2023-02-03,560.0,129.19,Outgoing
39516203,2023-02-07,746.08,186.08,Incoming
39516203,2023-02-10,653.0600000000001,93.02,Outgoing
39516203,2023-02-11,622.59,30.47,Outgoing
39516203,2023-02-11,599.59,23.0,Outgoing
39516203,2023-02-13,711.9000000000001,112.31,Incoming
39516203,2023-02-14,538.94,172.96,Outgoing
39529729,2023-01-31,425.66,,-
39529729,2023-02-01,339.22,86.44,Outgoing
39529729,2023-02-02,300.48,38.74,Outgoing
39529729,2023-02-06,265.1,35.38,Outgoing
39529729,2023-02-07,343.95000000000005,78.85,Incoming
39529729,2023-02-11,570.87,226.92,Incoming
39529729,2023-02-12,470.86,100.01,Outgoing
39529729,2023-02-13,534.71,63.85,Incoming
39542358,2023-01-31,671.28,,-
39542358,2023-02-06,719.73,48.45,Incoming
39542358,2023-02-07,612.47,107.26,Outgoing
39542358,2023-02-08,355.07000000000005,257.4,Outgoing
39542358,2023-02-08,426.68000000000006,71.61,Incoming
39542358,2023-02-08,-95.61999999999989,522.3,Outgoing
39542358,2023-02-10,29.420000000000115,125.04,Incoming
39542358,2023-02-11,-2332.18,2361.6,Outgoing
39542358,2023-02-11,-3500.38,1168.2,Outgoing
39542358,2023-02-11,-3438.2000000000003,62.18,Incoming
39590347,2023-01-31,180.22,,-
39590347,2023-02-04,216.01999999999998,35.8,Incoming
39590347,2023-02-05,317.46999999999997,101.45,Incoming
39590347,2023-02-09,482.92999999999995,165.46,Incoming
39590347,2023-02-12,616.5999999999999,133.67,Incoming
39590347,2023-02-12,674.4899999999999,57.89,Incoming
39602737,2023-01-31,881.44,,-
39602737,2023-02-06,797.5500000000001,83.89,Outgoing
39602737,2023-02-13,893.2600000000001,95.71,Incoming
39620163,2023-01-31,126.08,,-
39620163,2023-02-03,252.84,126.76,Incoming
39620163,2023-02-05,446.03999999999996,193.2,Incoming
39620163,2023-02-09,505.78,59.74,Incoming
39620163,2023-02-10,478.16999999999996,27.61,Outgoing
39620163,2023-02-12,355.73999999999995,122.43,Outgoing
39620163,2023-02-12,461.53,105.79,Incoming
39620163,2023-02-14,560.76,99.23,Incoming
39623640,2023-01-31,617.74,,-
39623640,2023-02-03,554.76,62.98,Outgoing
39623640,2023-02-03,413.5,141.26,Outgoing
39623640,2023-02-03,576.62,163.12,Incoming
39623640,2023-02-09,752.91,176.29,Incoming
39623640,2023-02-09,889.6999999999999,136.79,Incoming
39623640,2023-02-10,1076.3999999999999,186.7,Incoming
39623640,2023-02-11,982.2799999999999,94.12,Outgoing
39662559,2023-01-31,536.88,,-
39662559,2023-02-06,430.11,106.77,Outgoing
39662559,2023-02-08,475.34000000000003,45.23,Incoming
39662559,2023-02-09,335.23,140.11,Outgoing
39662559,2023-02-09,257.20000000000005,78.03,Outgoing
39662559,2023-02-13,212.10000000000005,45.1,Outgoing
39684993,2023-01-31,168.99,,-
39684993,2023-02-03,-443.61,612.6,Outgoing
39684993,2023-02-04,-545.83,102.22,Outgoing
39684993,2023-02-05,-572.98,27.15,Outgoing
39684993,2023-02-06,-426.76,146.22,Incoming
39684993,2023-02-08,-509.78,83.02,Outgoing
39684993,2023-02-14,-556.89,47.11,Outgoing
39710099,2023-01-31,155.88,,-
39710099,2023-02-01,50.11999999999999,105.76,Outgoing
39710099,2023-02-02,241.56,191.44,Incoming
39710099,2023-02-05,305.52,63.96,Incoming
39710099,2023-02-09,410.84999999999997,105.33,Incoming
39710099,2023-02-11,493.60999999999996,82.76,Incoming
39710099,2023-02-13,704.74,211.13,Incoming
39744047,2023-01-31,505.93,,-
39744047,2023-02-08,402.36,103.57,Outgoing
39744047,2023-02-14,-1181.04,1583.4,Outgoing
39744047,2023-02-14,-1125.25,55.79,Incoming
39749381,2023-01-31,576.13,,-
39749381,2023-02-02,646.76,70.63,Incoming
39749381,2023-02-03,854.67,207.91,Incoming
39749381,2023-02-03,837.74,16.93,Outgoing
39749381,2023-02-04,746.04,91.7,Outgoing
39749381,2023-02-06,587.93,158.11,Outgoing
39749381,2023-02-06,445.37999999999994,142.55,Outgoing
39749381,2023-02-08,262.3299999999999,183.05,Outgoing
39749381,2023-02-08,212.72999999999993,49.6,Outgoing
39749381,2023-02-09,369.43999999999994,156.71,Incoming
39749381,2023-02-11,513.3799999999999,143.94,Incoming
39749381,2023-02-14,461.01999999999987,52.36,Outgoing
39772392,2023-01-31,370.34,,-
39772392,2023-02-01,269.05999999999995,101.28,Outgoing
39772392,2023-02-01,385.7199999999999,116.66,Incoming
39772392,2023-02-02,206.7199999999999,179.0,Outgoing
39772392,2023-02-03,199.01999999999992,7.7,Outgoing
39772392,2023-02-08,160.74999999999991,38.27,Outgoing
39772392,2023-02-09,269.31999999999994,108.57,Incoming
39772392,2023-02-10,98.09999999999994,171.22,Outgoing
39822234,2023-01-31,718.73,,-
39822234,2023-02-02,37.73000000000002,681.0,Outgoing
39822234,2023-02-02,-60.16999999999999,97.9,Outgoing
39822234,2023-02-04,-173.79,113.62,Outgoing
39822234,2023-02-05,-191.67,17.88,Outgoing
39822234,2023-02-09,-351.21,159.54,Outgoing
39822234,2023-02-09,-391.97999999999996,40.77,Outgoing
39822234,2023-02-10,457.7200000000001,849.7,Incoming
39822234,2023-02-14,393.6200000000001,64.1,Outgoing
39863459,2023-01-31,387.4,,-
39863459,2023-02-02,508.5,121.1,Incoming
39863459,2023-02-04,557.13,48.63,Incoming
39863459,2023-02-13,680.62,123.49,Incoming
39863459,2023-02-13,578.75,101.87,Outgoing
39875057,2023-01-31,126.02,,-
39875057,2023-02-05,275.42,149.4,Incoming
39875057,2023-02-09,391.31,115.89,Incoming
39875057,2023-02-11,294.97,96.34,Outgoing
39875057,2023-02-11,421.47,126.5,Incoming
39875057,2023-02-13,268.31000000000006,153.16,Outgoing
39875057,2023-02-14,372.76000000000005,104.45,Incoming
39920664,2023-01-31,627.45,,-
39920664,2023-02-06,525.61,101.84,Outgoing
39920664,2023-02-10,598.22,72.61,Incoming
39920664,2023-02-10,407.57000000000005,190.65,Outgoing
39974803,2023-01-31,567.93,,-
39974803,2023-02-04,481.99999999999994,85.93,Outgoing
39974803,2023-02-04,521.8199999999999,39.82,Incoming
39974803,2023-02-07,653.66,131.84,Incoming
39974803,2023-02-08,566.75,86.91,Outgoing
39974803,2023-02-10,492.46,74.29,Outgoing
40004707,2023-01-31,206.15,,-
40004707,2023-02-04,131.31,74.84,Outgoing
40004707,2023-02-12,19.61,111.7,Outgoing
40039031,2023-01-31,124.72,,-
40039031,2023-02-02,-667.28,792.0,Outgoing
40039031,2023-02-07,914.52,1581.8,Incoming
40039031,2023-02-08,757.24,157.28,Outgoing
40039031,2023-02-08,792.37,35.13,Incoming
40039031,2023-02-09,695.22,97.15,Outgoing
40039031,2023-02-12,738.94,43.72,Incoming
40039031,2023-02-14,873.46,134.52,Incoming
40048102,2023-01-31,519.25,,-
40048102,2023-02-03,415.96,103.29,Outgoing
40048102,2023-02-06,459.84999999999997,43.89,Incoming
40048102,2023-02-08,1271.05,811.2,Incoming
40048102,2023-02-09,1390.9099999999999,119.86,Incoming
40048102,2023-02-10,1222.56,168.35,Outgoing
40048102,2023-02-12,1201.75,20.81,Outgoing
40082477,2023-01-31,171.74,,-
40082477,2023-02-01,302.85,131.11,Incoming
40082477,2023-02-07,216.69000000000003,86.16,Outgoing
40082477,2023-02-09,81.22000000000003,135.47,Outgoing
40082477,2023-02-09,-1352.8799999999999,1434.1,Outgoing
40082477,2023-02-11,-1303.7299999999998,49.15,Incoming
40082477,2023-02-13,-1425.6299999999999,121.9,Outgoing
40082477,2023-02-14,-1546.4399999999998,120.81,Outgoing
40082950,2023-01-31,322.41,,-
40082950,2023-02-04,402.78000000000003,80.37,Incoming
40082950,2023-02-04,362.38000000000005,40.4,Outgoing
40082950,2023-02-08,212.65000000000006,149.73,Outgoing
40082950,2023-02-08,43.25000000000006,169.4,Outgoing
40082950,2023-02-12,-127.86999999999995,171.12,Outgoing
40091206,2023-01-31,812.34,,-
40091206,2023-02-01,725.62,86.72,Outgoing
40091206,2023-02-08,843.73,118.11,Incoming
40091206,2023-02-09,854.9300000000001,11.2,Incoming
40091206,2023-02-11,891.3100000000001,36.38,Incoming
40091206,2023-02-12,734.2900000000001,157.02,Outgoing
40091206,2023-02-13,666.5600000000001,67.73,Outgoing
40098771,2023-01-31,742.62,,-
40098771,2023-02-03,790.4,47.78,Incoming
40098771,2023-02-08,935.8,145.4,Incoming
40098771,2023-02-10,872.9799999999999,62.82,Outgoing
40098771,2023-02-10,966.2799999999999,93.3,Incoming
40098771,2023-02-11,1026.37,60.09,Incoming
40098771,2023-02-14,955.2499999999999,71.12,Outgoing
40098912,2023-01-31,951.18,,-
40098912,2023-02-08,896.6199999999999,54.56,Outgoing
40098912,2023-02-10,817.7899999999998,78.83,Outgoing
40098912,2023-02-11,769.8099999999998,47.98,Outgoing
40098912,2023-02-14,660.3499999999998,109.46,Outgoing
40112082,2023-01-31,289.68,,-
40112082,2023-02-04,387.54,97.86,Incoming
40112082,2023-02-12,556.27,168.73,Incoming
40112082,2023-02-13,669.71,113.44,Incoming
40127778,2023-01-31,196.74,,-
40127778,2023-02-01,282.51,85.77,Incoming
40127778,2023-02-02,488.0,205.49,Incoming
40127778,2023-02-05,667.9,179.9,Incoming
40127778,2023-02-05,694.28,26.38,Incoming
40127778,2023-02-07,854.25,159.97,Incoming
40127778,2023-02-10,945.11,90.86,Incoming
40127778,2023-02-11,1777.6100000000001,832.5,Incoming
40127778,2023-02-14,1842.8000000000002,65.19,Incoming
40176462,2023-01-31,193.24,,-
40176462,2023-02-02,-550.96,744.2,Outgoing
40176462,2023-02-05,-827.36,276.4,Outgoing
40176462,2023-02-06,-904.83,77.47,Outgoing
40176462,2023-02-08,-1045.8600000000001,141.03,Outgoing
40176462,2023-02-10,-929.1400000000001,116.72,Incoming
40176462,2023-02-13,-962.8900000000001,33.75,Outgoing
40189934,2023-01-31,804.21,,-
40189934,2023-02-02,-1020.0899999999999,1824.3,Outgoing
40189934,2023-02-04,685.71,1705.8,Incoming
40189934,2023-02-07,621.69,64.02,Outgoing
40189934,2023-02-13,729.96,108.27,Incoming
40224914,2023-01-31,53.1,,-
40224914,2023-02-01,45.03,8.07,Outgoing
40224914,2023-02-05,149.92000000000002,104.89,Incoming
40224914,2023-02-13,189.66000000000003,39.74,Incoming
40224914,2023-02-14,98.13000000000002,91.53,Outgoing
40247376,2023-01-31,209.78,,-
40247376,2023-02-02,151.07999999999998,58.7,Outgoing
40247376,2023-02-04,275.79999999999995,124.72,Incoming
40247376,2023-02-11,367.72999999999996,91.93,Incoming
40247376,2023-02-12,406.05999999999995,38.33,Incoming
40247376,2023-02-13,455.9599999999999,49.9,Incoming
40374724,2023-01-31,692.58,,-
40374724,2023-02-01,879.73,187.15,Incoming
40374724,2023-02-02,843.41,36.32,Outgoing
40374724,2023-02-03,738.05,105.36,Outgoing
40374724,2023-02-04,641.0,97.05,Outgoing
40374724,2023-02-04,556.52,84.48,Outgoing
40374724,2023-02-04,596.92,40.4,Incoming
40374724,2023-02-05,660.24,63.32,Incoming
40374724,2023-02-05,597.9,62.34,Outgoing
40374724,2023-02-06,758.15,160.25,Incoming
40374724,2023-02-09,818.52,60.37,Incoming
40374724,2023-02-10,759.73,58.79,Outgoing
40374724,2023-02-14,-379.97,1139.7,Outgoing
40374724,2023-02-14,-284.77000000000004,95.2,Incoming
40436811,2023-01-31,445.93,,-
40436811,2023-02-03,486.26,40.33,Incoming
40436811,2023-02-03,541.73,55.47,Incoming
40436811,2023-02-08,608.4,66.67,Incoming
40436811,2023-02-11,565.92,42.48,Outgoing
40436811,2023-02-13,535.0,30.92,Outgoing
40436811,2023-02-13,616.01,81.01,Incoming
40507682,2023-01-31,524.63,,-
40507682,2023-02-01,437.95,86.68,Outgoing
40507682,2023-02-02,521.8299999999999,83.88,Incoming
40507682,2023-02-08,468.69999999999993,53.13,Outgoing
40507682,2023-02-10,543.1099999999999,74.41,Incoming
40507682,2023-02-12,424.6799999999999,118.43,Outgoing
40507682,2023-02-12,502.14999999999986,77.47,Incoming
40507682,2023-02-13,425.65999999999985,76.49,Outgoing
40507682,2023-02-14,-1088.44,1514.1,Outgoing
40530538,2023-01-31,364.98,,-
40530538,2023-02-06,381.06,16.08,Incoming
40530538,2023-02-06,468.27,87.21,Incoming
40530538,2023-02-06,481.88,13.61,Incoming
40530538,2023-02-07,454.40999999999997,27.47,Outgoing
40530538,2023-02-07,288.16999999999996,166.24,Outgoing
40530538,2023-02-13,400.54999999999995,112.38,Incoming
40548885,2023-01-31,160.32,,-
40548885,2023-02-04,186.14,25.82,Incoming
40548885,2023-02-05,55.44,130.7,Outgoing
40548885,2023-02-07,-61.879999999999995,117.32,Outgoing
40548885,2023-02-12,-118.25,56.37,Outgoing
40548885,2023-02-13,-453.15,334.9,Outgoing
40548885,2023-02-14,-384.30999999999995,68.84,Incoming
40550712,2023-01-31,511.4,,-
40550712,2023-02-05,426.34999999999997,85.05,Outgoing
40550712,2023-02-06,525.1999999999999,98.85,Incoming
40550712,2023-02-06,597.4499999999999,72.25,Incoming
40550712,2023-02-07,709.56,112.11,Incoming
40550712,2023-02-09,793.5899999999999,84.03,Incoming
40550712,2023-02-11,644.31,149.28,Outgoing
40551490,2023-01-31,569.45,,-
40551490,2023-02-04,474.44000000000005,95.01,Outgoing
40551490,2023-02-04,1236.3400000000001,761.9,Incoming
40551490,2023-02-05,1135.1100000000001,101.23,Outgoing
40551490,2023-02-12,1058.6000000000001,76.51,Outgoing
40600852,2023-01-31,15.08,,-
40600852,2023-02-01,-17.310000000000002,32.39,Outgoing
40600852,2023-02-01,-74.78999999999999,57.48,Outgoing
40600852,2023-02-06,-232.73,157.94,Outgoing
40600852,2023-02-08,-86.29999999999998,146.43,Incoming
40600852,2023-02-09,-110.78999999999998,24.49,Outgoing
40600852,2023-02-10,-75.88999999999999,34.9,Incoming
40600852,2023-02-11,591.21,667.1,Incoming
40600852,2023-02-11,436.5400000000001,154.67,Outgoing
40600852,2023-02-11,548.4100000000001,111.87,Incoming
40600852,2023-02-13,641.6200000000001,93.21,Incoming
40631802,2023-01-31,104.96,,-
40631802,2023-02-02,-31.320000000000007,136.28,Outgoing
40631802,2023-02-02,497.58,528.9,Incoming
40631802,2023-02-04,308.28,189.3,Outgoing
40631802,2023-02-06,171.66999999999996,136.61,Outgoing
40631802,2023-02-08,885.87,714.2,Incoming
40631802,2023-02-10,978.77,92.9,Incoming
40673170,2023-01-31,124.66,,-
40673170,2023-02-01,29.17,95.49,Outgoing
40673170,2023-02-04,132.22,103.05,Incoming
40673170,2023-02-06,212.37,80.15,Incoming
40673170,2023-02-08,89.07000000000001,123.3,Outgoing
40673170,2023-02-13,74.98,14.09,Outgoing
40712298,2023-01-31,781.72,,-
40712298,2023-02-06,673.76,107.96,Outgoing
40712298,2023-02-07,599.65,74.11,Outgoing
40712298,2023-02-11,452.55999999999995,147.09,Outgoing
40745545,2023-01-31,460.29,,-
40745545,2023-02-01,546.23,85.94,Incoming
40745545,2023-02-04,735.5600000000001,189.33,Incoming
40745545,2023-02-11,576.35,159.21,Outgoing
40745545,2023-02-11,676.39,100.04,Incoming
40745545,2023-02-12,815.97,139.58,Incoming
40745545,2023-02-13,694.58,121.39,Outgoing
40745965,2023-01-31,654.15,,-
40745965,2023-02-01,1918.4499999999998,1264.3,Incoming
40745965,2023-02-02,2115.0499999999997,196.6,Incoming
40745965,2023-02-03,2037.9799999999998,77.07,Outgoing
40745965,2023-02-05,2136.7,98.72,Incoming
40745965,2023-02-07,2178.74,42.04,Incoming
40745965,2023-02-08,2279.5899999999997,100.85,Incoming
40745965,2023-02-09,2167.7599999999998,111.83,Outgoing
40745965,2023-02-09,2249.41,81.65,Incoming
40797438,2023-01-31,679.38,,-
40797438,2023-02-01,629.69,49.69,Outgoing
40797438,2023-02-02,783.1500000000001,153.46,Incoming
40797438,2023-02-03,666.46,116.69,Outgoing
40797438,2023-02-04,743.83,77.37,Incoming
40797438,2023-02-06,550.77,193.06,Outgoing
40797438,2023-02-10,452.32,98.45,Outgoing
40797438,2023-02-12,367.6,84.72,Outgoing
40797438,2023-02-14,521.95,154.35,Incoming
40813783,2023-01-31,288.51,,-
40813783,2023-02-03,158.14999999999998,130.36,Outgoing
40813783,2023-02-06,125.94999999999997,32.2,Outgoing
40813783,2023-02-07,6.769999999999968,119.18,Outgoing
40813783,2023-02-14,188.86999999999995,182.1,Incoming
40872555,2023-01-31,115.88,,-
40872555,2023-02-02,26.179999999999993,89.7,Outgoing
40872555,2023-02-03,54.00999999999999,27.83,Incoming
40872555,2023-02-04,1272.01,1218.0,Incoming
40872555,2023-02-12,1210.41,61.6,Outgoing
40898013,2023-01-31,650.33,,-
40898013,2023-02-04,765.6,115.27,Incoming
40898013,2023-02-04,1010.83,245.23,Incoming
40898013,2023-02-05,982.37,28.46,Outgoing
40898013,2023-02-06,1051.35,68.98,Incoming
40898013,2023-02-09,1081.7099999999998,30.36,Incoming
40898013,2023-02-11,951.0999999999998,130.61,Outgoing
40898013,2023-02-13,1096.2899999999997,145.19,Incoming
40906801,2023-01-31,83.77,,-
40906801,2023-02-01,-101.67999999999999,185.45,Outgoing
40906801,2023-02-02,-77.44999999999999,24.23,Incoming
40906801,2023-02-06,-35.25999999999999,42.19,Incoming
40906801,2023-02-09,-132.8,97.54,Outgoing
40906801,2023-02-09,-171.88,39.08,Outgoing
40906801,2023-02-09,-1334.7800000000002,1162.9,Outgoing
40906801,2023-02-09,-1234.4200000000003,100.36,Incoming
41022448,2023-01-31,37.89,,-
41022448,2023-02-07,-130.89,168.78,Outgoing
41022448,2023-02-10,49.120000000000005,180.01,Incoming
41022448,2023-02-13,218.07,168.95,Incoming
41022448,2023-02-14,56.72999999999999,161.34,Outgoing
41036701,2023-01-31,249.29,,-
41036701,2023-02-01,1051.89,802.6,Incoming
41036701,2023-02-09,942.0100000000001,109.88,Outgoing
41036701,2023-02-14,119.0100000000001,823.0,Outgoing
41038634,2023-01-31,802.08,,-
41038634,2023-02-02,839.9200000000001,37.84,Incoming
41038634,2023-02-11,1042.0700000000002,202.15,Incoming
41038634,2023-02-14,1162.88,120.81,Incoming
41085190,2023-01-31,78.73,,-
41085190,2023-02-03,-34.86,113.59,Outgoing
41085190,2023-02-03,8.740000000000002,43.6,Incoming
41085190,2023-02-05,-29.25,37.99,Outgoing
41085190,2023-02-07,-172.29,143.04,Outgoing
41085190,2023-02-07,1349.71,1522.0,Incoming
41085190,2023-02-08,2517.81,1168.1,Incoming
41085190,2023-02-08,2636.35,118.54,Incoming
41085190,2023-02-10,1055.4499999999998,1580.9,Outgoing
41085190,2023-02-12,977.1899999999998,78.26,Outgoing
41085190,2023-02-14,933.2399999999998,43.95,Outgoing
41085190,2023-02-14,48.73999999999978,884.5,Outgoing
41170515,2023-01-31,713.46,,-
41170515,2023-02-03,486.41,227.05,Outgoing
41170515,2023-02-10,1633.91,1147.5,Incoming
41194009,2023-01-31,585.15,,-
41194009,2023-02-07,723.53,138.38,Incoming
41194009,2023-02-07,831.8399999999999,108.31,Incoming
41194009,2023-02-09,686.02,145.82,Outgoing
41194009,2023-02-12,790.71,104.69,Incoming
41194009,2023-02-13,843.99,53.28,Incoming
41211432,2023-01-31,205.0,,-
41211432,2023-02-01,117.41,87.59,Outgoing
41211432,2023-02-01,198.31,80.9,Incoming
41211432,2023-02-04,68.94,129.37,Outgoing
41211432,2023-02-07,129.67,60.73,Incoming
41211432,2023-02-08,8.999999999999986,120.67,Outgoing
41211432,2023-02-10,106.89999999999999,97.9,Incoming
41211432,2023-02-11,185.98,79.08,Incoming
41245288,2023-01-31,540.61,,-
41245288,2023-02-05,447.83000000000004,92.78,Outgoing
41245288,2023-02-10,412.93000000000006,34.9,Outgoing
41245288,2023-02-10,353.51000000000005,59.42,Outgoing
41245288,2023-02-11,265.94000000000005,87.57,Outgoing
41245288,2023-02-13,1353.94,1088.0,Incoming
41245288,2023-02-13,1434.81,80.87,Incoming
41245805,2023-01-31,753.91,,-
41245805,2023-02-03,870.4599999999999,116.55,Incoming
41245805,2023-02-04,1046.61,176.15,Incoming
41245805,2023-02-04,1101.85,55.24,Incoming
41245805,2023-02-04,201.14999999999986,900.7,Outgoing
41252281,2023-01-31,834.88,,-
41252281,2023-02-01,686.54,148.34,Outgoing
41252281,2023-02-03,775.5999999999999,89.06,Incoming
41252281,2023-02-03,707.8399999999999,67.76,Outgoing
41252281,2023-02-03,688.53,19.31,Outgoing
41252281,2023-02-05,778.0699999999999,89.54,Incoming
41252281,2023-02-09,-9.13000000000011,787.2,Outgoing
41252281,2023-02-10,-1062.0300000000002,1052.9,Outgoing
41282329,2023-01-31,80.32,,-
41282329,2023-02-01,122.59,42.27,Incoming
41282329,2023-02-05,-1562.8100000000002,1685.4,Outgoing
41282329,2023-02-09,-1450.4300000000003,112.38,Incoming
41282329,2023-02-10,-1526.1000000000004,75.67,Outgoing
41282329,2023-02-13,-2549.1000000000004,1023.0,Outgoing
41356963,2023-01-31,398.3,,-
41356963,2023-02-04,317.44,80.86,Outgoing
41356963,2023-02-05,242.45999999999998,74.98,Outgoing
41356963,2023-02-05,340.92999999999995,98.47,Incoming
41356963,2023-02-06,466.52,125.59,Incoming
41356963,2023-02-09,334.40999999999997,132.11,Outgoing
41420018,2023-01-31,816.5,,-
41420018,2023-02-02,935.37,118.87,Incoming
41420018,2023-02-09,1102.01,166.64,Incoming
41420018,2023-02-10,987.15,114.86,Outgoing
41420018,2023-02-13,918.29,68.86,Outgoing
41420018,2023-02-14,821.88,96.41,Outgoing
41542689,2023-01-31,246.73,,-
41542689,2023-02-03,209.79,36.94,Outgoing
41542689,2023-02-03,359.65999999999997,149.87,Incoming
41542689,2023-02-04,483.73999999999995,124.08,Incoming
41542689,2023-02-07,613.9699999999999,130.23,Incoming
41542689,2023-02-11,507.0999999999999,106.87,Outgoing
41542689,2023-02-12,-748.6000000000001,1255.7,Outgoing
41542689,2023-02-13,-681.2900000000002,67.31,Incoming
41561470,2023-01-31,750.8,,-
41561470,2023-02-01,259.9,490.9,Outgoing
41561470,2023-02-03,114.97999999999999,144.92,Outgoing
41561470,2023-02-04,56.59999999999999,58.38,Outgoing
41561470,2023-02-05,-104.65,161.25,Outgoing
41561470,2023-02-08,-300.0,195.35,Outgoing
41561470,2023-02-11,-341.42,41.42,Outgoing
41561470,2023-02-14,741.5799999999999,1083.0,Incoming
41574018,2023-01-31,254.89,,-
41574018,2023-02-01,274.77,19.88,Incoming
41574018,2023-02-01,114.15999999999997,160.61,Outgoing
41574018,2023-02-05,232.54999999999995,118.39,Incoming
41574018,2023-02-09,213.63999999999996,18.91,Outgoing
41574018,2023-02-11,155.26999999999995,58.37,Outgoing
41574018,2023-02-12,10.169999999999959,145.1,Outgoing
41574018,2023-02-14,-30.65000000000004,40.82,Outgoing
41584073,2023-01-31,561.74,,-
41584073,2023-02-03,608.33,46.59,Incoming
41584073,2023-02-04,574.11,34.22,Outgoing
41584073,2023-02-04,482.70000000000005,91.41,Outgoing
41584073,2023-02-05,385.75000000000006,96.95,Outgoing
41584073,2023-02-08,631.5500000000001,245.8,Incoming
41584073,2023-02-10,497.6600000000001,133.89,Outgoing
41584073,2023-02-11,382.82000000000005,114.84,Outgoing
41584073,2023-02-12,453.4200000000001,70.6,Incoming
41664336,2023-01-31,853.37,,-
41664336,2023-02-01,808.26,45.11,Outgoing
41706310,2023-01-31,126.08,,-
41706310,2023-02-01,91.91,34.17,Outgoing
41706310,2023-02-01,20.019999999999996,71.89,Outgoing
41706310,2023-02-01,-62.07000000000001,82.09,Outgoing
41706310,2023-02-03,-151.4,89.33,Outgoing
41706310,2023-02-04,-63.22,88.18,Incoming
41706310,2023-02-05,-152.76,89.54,Outgoing
41706310,2023-02-06,-103.22,49.54,Incoming
41706310,2023-02-06,11.530000000000001,114.75,Incoming
41706310,2023-02-12,109.35,97.82,Incoming
41716822,2023-01-31,418.05,,-
41716822,2023-02-01,339.98,78.07,Outgoing
41716822,2023-02-06,181.83,158.15,Outgoing
41716822,2023-02-10,75.06000000000002,106.77,Outgoing
41716822,2023-02-10,218.36,143.3,Incoming
41716822,2023-02-11,92.65000000000002,125.71,Outgoing
41716822,2023-02-12,161.03000000000003,68.38,Incoming
41716822,2023-02-13,208.18000000000004,47.15,Incoming
41741558,2023-01-31,435.71,,-
41741558,2023-02-02,479.26,43.55,Incoming
41741558,2023-02-05,421.46999999999997,57.79,Outgoing
41741558,2023-02-05,519.02,97.55,Incoming
41741558,2023-02-06,605.93,86.91,Incoming
41741558,2023-02-07,718.43,112.5,Incoming
41741558,2023-02-09,777.02,58.59,Incoming
41741558,2023-02-09,878.53,101.51,Incoming
41741558,2023-02-10,1030.1299999999999,151.6,Incoming
41741558,2023-02-11,40.82999999999993,989.3,Outgoing
41755476,2023-01-31,72.71,,-
41755476,2023-02-02,-132.51,205.22,Outgoing
41755476,2023-02-02,-195.01999999999998,62.51,Outgoing
41755476,2023-02-06,-254.60999999999999,59.59,Outgoing
41755476,2023-02-14,-325.78999999999996,71.18,Outgoing
41773473,2023-01-31,355.0,,-
41773473,2023-02-01,286.53,68.47,Outgoing
41773473,2023-02-06,207.53999999999996,78.99,Outgoing
41773473,2023-02-12,326.30999999999995,118.77,Incoming
41778536,2023-01-31,722.03,,-
41778536,2023-02-02,589.39,132.64,Outgoing
41778536,2023-02-07,554.92,34.47,Outgoing
41778536,2023-02-07,684.2099999999999,129.29,Incoming
41778536,2023-02-08,726.6399999999999,42.43,Incoming
41778536,2023-02-09,-132.46000000000015,859.1,Outgoing
41778536,2023-02-11,28.099999999999852,160.56,Incoming
41778536,2023-02-12,178.31999999999985,150.22,Incoming
41778536,2023-02-12,1677.9199999999998,1499.6,Incoming
41778536,2023-02-13,1565.7399999999998,112.18,Outgoing
41778536,2023-02-14,1424.12,141.62,Outgoing
41852767,2023-01-31,993.36,,-
41852767,2023-02-01,878.6800000000001,114.68,Outgoing
41852767,2023-02-03,985.0300000000001,106.35,Incoming
41852767,2023-02-04,777.1400000000001,207.89,Outgoing
41852767,2023-02-06,621.2200000000001,155.92,Outgoing
41852767,2023-02-10,529.0900000000001,92.13,Outgoing
41852767,2023-02-13,552.4600000000002,23.37,Incoming
41879906,2023-01-31,29.05,,-
41879906,2023-02-01,109.86,80.81,Incoming
41879906,2023-02-03,4.6299999999999955,105.23,Outgoing
41879906,2023-02-06,50.94,46.31,Incoming
41879906,2023-02-09,116.7,65.76,Incoming
41879906,2023-02-10,33.97,82.73,Outgoing
41879906,2023-02-10,-924.63,958.6,Outgoing
41879906,2023-02-11,-825.3199999999999,99.31,Incoming
41881442,2023-01-31,650.34,,-
41881442,2023-02-01,862.6,212.26,Incoming
41881442,2023-02-01,998.1500000000001,135.55,Incoming
41881442,2023-02-10,1138.14,139.99,Incoming
41881442,2023-02-11,1023.1700000000001,114.97,Outgoing
41881442,2023-02-12,996.82,26.35,Outgoing
41881442,2023-02-12,946.48,50.34,Outgoing
41914097,2023-01-31,921.06,,-
41914097,2023-02-02,833.76,87.3,Outgoing
41914097,2023-02-03,749.26,84.5,Outgoing
41914097,2023-02-04,844.39,95.13,Incoming
41914097,2023-02-07,905.76,61.37,Incoming
41914097,2023-02-07,713.46,192.3,Outgoing
41914097,2023-02-08,800.37,86.91,Incoming
41914097,2023-02-08,825.74,25.37,Incoming
41914097,2023-02-10,936.85,111.11,Incoming
41914097,2023-02-13,981.02,44.17,Incoming
41914097,2023-02-13,887.2,93.82,Outgoing
41919083,2023-01-31,884.52,,-
41919083,2023-02-01,1048.83,164.31,Incoming
41919083,2023-02-03,1148.51,99.68,Incoming
41919083,2023-02-07,-590.19,1738.7,Outgoing
41919083,2023-02-07,-700.08,109.89,Outgoing
41919083,2023-02-14,-786.25,86.17,Outgoing
41919083,2023-02-14,-716.98,69.27,Incoming
41954037,2023-01-31,768.8,,-
41954037,2023-02-08,796.03,27.23,Incoming
41954037,2023-02-08,761.65,34.38,Outgoing
41954037,2023-02-12,1777.4499999999998,1015.8,Incoming
41954037,2023-02-14,1922.5299999999997,145.08,Incoming
41972741,2023-01-31,374.09,,-
41972741,2023-02-02,251.07,123.02,Outgoing
41972741,2023-02-08,162.57,88.5,Outgoing
41972741,2023-02-09,6.909999999999997,155.66,Outgoing
41972741,2023-02-12,-50.42,57.33,Outgoing
41972741,2023-02-13,-98.99000000000001,48.57,Outgoing
41981752,2023-01-31,843.61,,-
41981752,2023-02-05,1023.03,179.42,Incoming
41981752,2023-02-10,-352.27,1375.3,Outgoing
41981752,2023-02-10,-466.84,114.57,Outgoing
41981752,2023-02-11,-517.75,50.91,Outgoing
42017456,2023-01-31,947.67,,-
42017456,2023-02-04,1079.79,132.12,Incoming
42017456,2023-02-04,1135.77,55.98,Incoming
42017456,2023-02-05,1198.31,62.54,Incoming
42017456,2023-02-06,976.1899999999999,222.12,Outgoing
42017456,2023-02-08,1053.23,77.04,Incoming
42017456,2023-02-10,987.04,66.19,Outgoing
42181728,2023-01-31,51.89,,-
42181728,2023-02-02,139.19,87.3,Incoming
42181728,2023-02-04,227.5,88.31,Incoming
42181728,2023-02-05,110.56,116.94,Outgoing
42181728,2023-02-06,209.42000000000002,98.86,Incoming
42181728,2023-02-06,308.39,98.97,Incoming
42181728,2023-02-07,155.23,153.16,Outgoing
42181728,2023-02-08,104.85,50.38,Outgoing
42181728,2023-02-13,165.48,60.63,Incoming
42202867,2023-01-31,614.83,,-
42202867,2023-02-06,697.5,82.67,Incoming
42202867,2023-02-06,580.48,117.02,Outgoing
42202867,2023-02-07,523.03,57.45,Outgoing
42202867,2023-02-07,393.16999999999996,129.86,Outgoing
42202867,2023-02-10,478.29999999999995,85.13,Incoming
42202867,2023-02-11,655.4,177.1,Incoming
42232896,2023-01-31,647.99,,-
42232896,2023-02-02,626.28,21.71,Outgoing
42232896,2023-02-04,669.01,42.73,Incoming
42232896,2023-02-04,753.6,84.59,Incoming
42232896,2023-02-09,655.8000000000001,97.8,Outgoing
42232896,2023-02-10,580.8600000000001,74.94,Outgoing
42232896,2023-02-10,450.29000000000013,130.57,Outgoing
42232896,2023-02-13,524.3000000000002,74.01,Incoming
42235537,2023-01-31,165.2,,-
42235537,2023-02-01,-642.0,807.2,Outgoing
42235537,2023-02-02,-540.78,101.22,Incoming
42235537,2023-02-02,-448.72999999999996,92.05,Incoming
42235537,2023-02-04,-320.77,127.96,Incoming
42235537,2023-02-06,-159.15999999999997,161.61,Incoming
42235537,2023-02-07,26.350000000000023,185.51,Incoming
42235537,2023-02-08,144.93,118.58,Incoming
42235537,2023-02-08,14.390000000000015,130.54,Outgoing
42235537,2023-02-08,-152.83999999999997,167.23,Outgoing
42235537,2023-02-08,1091.3600000000001,1244.2,Incoming
42235537,2023-02-09,990.2400000000001,101.12,Outgoing
42235537,2023-02-10,871.6000000000001,118.64,Outgoing
42235537,2023-02-12,752.5700000000002,119.03,Outgoing
42235537,2023-02-13,868.8700000000001,116.3,Incoming
42235537,2023-02-14,780.5500000000002,88.32,Outgoing
42245590,2023-01-31,229.01,,-
42245590,2023-02-01,173.92,55.09,Outgoing
42245590,2023-02-02,53.219999999999985,120.7,Outgoing
42245590,2023-02-07,-586.0799999999999,639.3,Outgoing
42245590,2023-02-09,-448.28999999999996,137.79,Incoming
42245590,2023-02-09,-593.22,144.93,Outgoing
42245590,2023-02-12,-727.27,134.05,Outgoing
42245590,2023-02-13,-727.49,0.22,Outgoing
42255054,2023-01-31,550.4,,-
42255054,2023-02-01,423.94,126.46,Outgoing
42255054,2023-02-01,294.55,129.39,Outgoing
42255054,2023-02-04,1.910000000000025,292.64,Outgoing
42255054,2023-02-05,-142.75999999999996,144.67,Outgoing
42255054,2023-02-07,-92.75999999999996,50.0,Incoming
42255054,2023-02-08,-150.47999999999996,57.72,Outgoing
42268900,2023-01-31,521.35,,-
42268900,2023-02-01,380.68000000000006,140.67,Outgoing
42268900,2023-02-03,203.01000000000008,177.67,Outgoing
42268900,2023-02-03,288.30000000000007,85.29,Incoming
42268900,2023-02-03,385.80000000000007,97.5,Incoming
42268900,2023-02-05,432.6700000000001,46.87,Incoming
42268900,2023-02-08,536.3700000000001,103.7,Incoming
42268900,2023-02-09,497.9500000000001,38.42,Outgoing
42300418,2023-01-31,151.39,,-
42300418,2023-02-01,959.79,808.4,Incoming
42300418,2023-02-04,1909.99,950.2,Incoming
42300418,2023-02-11,1782.5,127.49,Outgoing
42311039,2023-01-31,98.95,,-
42311039,2023-02-01,-57.77999999999999,156.73,Outgoing
42311039,2023-02-03,-49.20999999999999,8.57,Incoming
42311039,2023-02-05,-209.87999999999997,160.67,Outgoing
42311039,2023-02-06,-65.13999999999996,144.74,Incoming
42311039,2023-02-10,-104.35999999999996,39.22,Outgoing
42311039,2023-02-10,20.100000000000037,124.46,Incoming
42311039,2023-02-13,148.94000000000005,128.84,Incoming
42322494,2023-01-31,486.58,,-
42322494,2023-02-03,501.93,15.35,Incoming
42322494,2023-02-06,423.0,78.93,Outgoing
42322494,2023-02-07,470.31,47.31,Incoming
42322494,2023-02-12,571.71,101.4,Incoming
42322494,2023-02-12,461.57000000000005,110.14,Outgoing
42340050,2023-01-31,935.61,,-
42340050,2023-02-01,939.16,3.55,Incoming
42340050,2023-02-01,750.8299999999999,188.33,Outgoing
42340050,2023-02-03,792.05,41.22,Incoming
42340050,2023-02-05,661.3399999999999,130.71,Outgoing
42340050,2023-02-07,608.9799999999999,52.36,Outgoing
42340050,2023-02-11,434.5799999999999,174.4,Outgoing
42340050,2023-02-12,604.5799999999999,170.0,Incoming
42340050,2023-02-13,2283.38,1678.8,Incoming
42396753,2023-01-31,628.86,,-
42396753,2023-02-02,667.28,38.42,Incoming
42396753,2023-02-07,568.62,98.66,Outgoing
42396753,2023-02-08,762.9200000000001,194.3,Incoming
42396753,2023-02-08,858.0600000000001,95.14,Incoming
42396753,2023-02-09,780.3100000000001,77.75,Outgoing
42509068,2023-01-31,890.56,,-
42509068,2023-02-05,1082.03,191.47,Incoming
42509068,2023-02-05,954.51,127.52,Outgoing
42509068,2023-02-06,857.45,97.06,Outgoing
42509068,2023-02-11,720.1400000000001,137.31,Outgoing
42509068,2023-02-12,201.6400000000001,518.5,Outgoing
42509068,2023-02-14,44.85000000000011,156.79,Outgoing
42515631,2023-01-31,186.74,,-
42515631,2023-02-09,304.12,117.38,Incoming
42515631,2023-02-10,425.39,121.27,Incoming
42515631,2023-02-10,489.51,64.12,Incoming
42515631,2023-02-11,373.05,116.46,Outgoing
42515631,2023-02-13,186.70000000000002,186.35,Outgoing
42546381,2023-01-31,409.3,,-
42546381,2023-02-05,538.02,128.72,Incoming
42546381,2023-02-05,340.79999999999995,197.22,Outgoing
42546381,2023-02-06,468.65,127.85,Incoming
42546381,2023-02-09,407.5,61.15,Outgoing
42546381,2023-02-14,302.72,104.78,Outgoing
42589255,2023-01-31,282.84,,-
42589255,2023-02-03,181.41999999999996,101.42,Outgoing
42589255,2023-02-03,-59.13000000000005,240.55,Outgoing
42589255,2023-02-12,75.04999999999995,134.18,Incoming
42602631,2023-01-31,539.62,,-
42602631,2023-02-04,736.6,196.98,Incoming
42602631,2023-02-07,1501.3000000000002,764.7,Incoming
42652193,2023-01-31,566.53,,-
42652193,2023-02-04,-898.97,1465.5,Outgoing
42652193,2023-02-05,-769.46,129.51,Incoming
42652193,2023-02-10,-680.37,89.09,Incoming
42652193,2023-02-13,382.13,1062.5,Incoming
42652193,2023-02-14,556.39,174.26,Incoming
42726921,2023-01-31,590.15,,-
42726921,2023-02-05,434.39,155.76,Outgoing
42726921,2023-02-05,533.55,99.16,Incoming
42726921,2023-02-12,375.67999999999995,157.87,Outgoing
42726921,2023-02-12,-966.7200000000001,1342.4,Outgoing
42726928,2023-01-31,601.3,,-
42726928,2023-02-01,498.40999999999997,102.89,Outgoing
42726928,2023-02-04,553.99,55.58,Incoming
42726928,2023-02-04,764.24,210.25,Incoming
42726928,2023-02-04,828.07,63.83,Incoming
42726928,2023-02-05,646.6500000000001,181.42,Outgoing
42726928,2023-02-06,698.8700000000001,52.22,Incoming
42726928,2023-02-06,762.2000000000002,63.33,Incoming
42726928,2023-02-06,837.7500000000001,75.55,Incoming
42726928,2023-02-12,650.5400000000001,187.21,Outgoing
42726928,2023-02-14,813.7700000000001,163.23,Incoming
42746180,2023-01-31,12.15,,-
42746180,2023-02-04,1622.95,1610.8,Incoming
42746180,2023-02-05,1631.67,8.72,Incoming
42746180,2023-02-07,1710.67,79.0,Incoming
42746180,2023-02-08,1803.1000000000001,92.43,Incoming
42746180,2023-02-09,1980.0700000000002,176.97,Incoming
42752982,2023-01-31,526.19,,-
42752982,2023-02-06,633.1600000000001,106.97,Incoming
42752982,2023-02-07,825.46,192.3,Incoming
42752982,2023-02-11,869.24,43.78,Incoming
42752982,2023-02-14,882.04,12.8,Incoming
42752982,2023-02-14,924.9399999999999,42.9,Incoming
42783101,2023-01-31,289.82,,-
42783101,2023-02-01,350.98,61.16,Incoming
42783101,2023-02-06,258.56,92.42,Outgoing
42783101,2023-02-07,1293.76,1035.2,Incoming
42783101,2023-02-11,1168.11,125.65,Outgoing
42783101,2023-02-12,1256.77,88.66,Incoming
42783101,2023-02-13,1114.1399999999999,142.63,Outgoing
42813808,2023-01-31,633.08,,-
42813808,2023-02-08,762.45,129.37,Incoming
42813808,2023-02-09,888.08,125.63,Incoming
42838186,2023-01-31,466.48,,-
42838186,2023-02-01,409.93,56.55,Outgoing
42838186,2023-02-08,1792.43,1382.5,Incoming
42838186,2023-02-09,615.6300000000001,1176.8,Outgoing
42838186,2023-02-10,764.8200000000002,149.19,Incoming
42882563,2023-01-31,419.69,,-
42882563,2023-02-07,497.12,77.43,Incoming
42889744,2023-01-31,223.01,,-
42889744,2023-02-02,124.22999999999999,98.78,Outgoing
42889744,2023-02-03,299.90999999999997,175.68,Incoming
42889744,2023-02-04,139.78999999999996,160.12,Outgoing
43017336,2023-01-31,935.99,,-
43017336,2023-02-03,1088.85,152.86,Incoming
43017336,2023-02-12,1211.4699999999998,122.62,Incoming
43017336,2023-02-13,1015.0099999999998,196.46,Outgoing
43017336,2023-02-14,1111.7899999999997,96.78,Incoming
43017598,2023-01-31,151.6,,-
43017598,2023-02-02,299.95,148.35,Incoming
43017598,2023-02-07,135.07999999999998,164.87,Outgoing
43017598,2023-02-07,199.15999999999997,64.08,Incoming
43017598,2023-02-10,238.37999999999997,39.22,Incoming
43017598,2023-02-12,396.68999999999994,158.31,Incoming
43017598,2023-02-13,321.31999999999994,75.37,Outgoing
43017598,2023-02-13,398.78999999999996,77.47,Incoming
43017598,2023-02-14,463.4,64.61,Incoming
43032836,2023-01-31,386.83,,-
43032836,2023-02-01,248.92999999999998,137.9,Outgoing
43032836,2023-02-01,301.49,52.56,Incoming
43032836,2023-02-01,168.97,132.52,Outgoing
43032836,2023-02-02,20.930000000000007,148.04,Outgoing
43032836,2023-02-03,-35.13999999999999,56.07,Outgoing
43032836,2023-02-03,-172.05999999999997,136.92,Outgoing
43032836,2023-02-04,-122.52999999999997,49.53,Incoming
43032836,2023-02-09,7.830000000000041,130.36,Incoming
43032836,2023-02-09,50.33000000000004,42.5,Incoming
43064169,2023-01-31,555.44,,-
43064169,2023-02-02,527.75,27.69,Outgoing
43064169,2023-02-03,-245.04999999999995,772.8,Outgoing
43064169,2023-02-03,-433.52,188.47,Outgoing
43064169,2023-02-03,-292.26,141.26,Incoming
43064169,2023-02-05,-1267.06,974.8,Outgoing
43064169,2023-02-07,-1142.51,124.55,Incoming
43064169,2023-02-07,-1032.93,109.58,Incoming
43064169,2023-02-10,256.66999999999985,1289.6,Incoming
43064169,2023-02-11,146.55999999999983,110.11,Outgoing
43064169,2023-02-11,70.79999999999983,75.76,Outgoing
43064169,2023-02-13,174.78999999999982,103.99,Incoming
43074888,2023-01-31,779.86,,-
43074888,2023-02-02,910.8,130.94,Incoming
43074888,2023-02-05,904.0699999999999,6.73,Outgoing
43074888,2023-02-05,792.04,112.03,Outgoing
43074888,2023-02-11,-199.56000000000006,991.6,Outgoing
43074888,2023-02-11,-303.95000000000005,104.39,Outgoing
43074888,2023-02-13,-365.14000000000004,61.19,Outgoing
43080619,2023-01-31,426.64,,-
43080619,2023-02-03,449.21,22.57,Incoming
43080619,2023-02-05,431.28,17.93,Outgoing
43080619,2023-02-08,484.59999999999997,53.32,Incoming
43080619,2023-02-09,597.29,112.69,Incoming
43080619,2023-02-13,512.38,84.91,Outgoing
43140934,2023-01-31,820.81,,-
43140934,2023-02-05,878.68,57.87,Incoming
43140934,2023-02-05,717.77,160.91,Outgoing
43140934,2023-02-10,868.16,150.39,Incoming
43140934,2023-02-14,926.28,58.12,Incoming
43140934,2023-02-14,829.1899999999999,97.09,Outgoing
43257373,2023-01-31,483.49,,-
43257373,2023-02-04,619.21,135.72,Incoming
43257373,2023-02-04,572.2800000000001,46.93,Outgoing
43257373,2023-02-06,689.3900000000001,117.11,Incoming
43257373,2023-02-06,572.4800000000001,116.91,Outgoing
43257373,2023-02-09,476.3100000000001,96.17,Outgoing
43257373,2023-02-12,605.9200000000001,129.61,Incoming
43265708,2023-01-31,814.0,,-
43265708,2023-02-03,634.25,179.75,Outgoing
43265708,2023-02-04,538.88,95.37,Outgoing
43265708,2023-02-13,473.26,65.62,Outgoing
43265708,2023-02-14,355.96,117.3,Outgoing
43312288,2023-01-31,830.91,,-
43312288,2023-02-02,983.8599999999999,152.95,Incoming
43312288,2023-02-04,1056.73,72.87,Incoming
43312288,2023-02-05,1141.13,84.4,Incoming
43312288,2023-02-08,1030.5800000000002,110.55,Outgoing
43312288,2023-02-13,964.4900000000001,66.09,Outgoing
43312288,2023-02-14,1096.8500000000001,132.36,Incoming
43329727,2023-01-31,477.69,,-
43329727,2023-02-04,1708.89,1231.2,Incoming
43329727,2023-02-04,1805.2,96.31,Incoming
43329727,2023-02-07,1661.04,144.16,Outgoing
43329727,2023-02-07,1802.05,141.01,Incoming
43329727,2023-02-08,1702.56,99.49,Outgoing
43329727,2023-02-13,1660.02,42.54,Outgoing
43330367,2023-01-31,172.38,,-
43330367,2023-02-02,225.16,52.78,Incoming
43330367,2023-02-06,136.64,88.52,Outgoing
43330367,2023-02-10,319.45,182.81,Incoming
43330367,2023-02-11,294.55,24.9,Outgoing
43330367,2023-02-13,207.35000000000002,87.2,Outgoing
43338400,2023-01-31,783.12,,-
43338400,2023-02-01,863.82,80.7,Incoming
43338400,2023-02-04,998.6300000000001,134.81,Incoming
43338400,2023-02-08,850.8200000000002,147.81,Outgoing
43338400,2023-02-08,752.4400000000002,98.38,Outgoing
43338400,2023-02-14,-1444.7599999999998,2197.2,Outgoing
43354643,2023-01-31,863.38,,-
43354643,2023-02-02,757.79,105.59,Outgoing
43354643,2023-02-06,809.48,51.69,Incoming
43354643,2023-02-10,710.63,98.85,Outgoing
43354643,2023-02-11,584.72,125.91,Outgoing
43365633,2023-01-31,57.11,,-
43365633,2023-02-07,84.99,27.88,Incoming
43365633,2023-02-10,192.64999999999998,107.66,Incoming
43365633,2023-02-13,81.21999999999997,111.43,Outgoing
43368978,2023-01-31,133.07,,-
43368978,2023-02-01,77.57999999999998,55.49,Outgoing
43368978,2023-02-06,250.26,172.68,Incoming
43368978,2023-02-06,453.09000000000003,202.83,Incoming
43368978,2023-02-11,388.88000000000005,64.21,Outgoing
43387803,2023-01-31,646.4,,-
43387803,2023-02-02,588.56,57.84,Outgoing
43387803,2023-02-03,538.18,50.38,Outgoing
43387803,2023-02-05,409.23999999999995,128.94,Outgoing
43387803,2023-02-05,386.21999999999997,23.02,Outgoing
43387803,2023-02-05,467.42999999999995,81.21,Incoming
43387803,2023-02-06,395.88999999999993,71.54,Outgoing
43387803,2023-02-10,509.87999999999994,113.99,Incoming
43387803,2023-02-10,759.6899999999999,249.81,Incoming
43387803,2023-02-11,898.8299999999999,139.14,Incoming
43387803,2023-02-14,757.66,141.17,Outgoing
43417466,2023-01-31,874.02,,-
43417466,2023-02-01,807.18,66.84,Outgoing
43417466,2023-02-07,892.15,84.97,Incoming
43417466,2023-02-12,1045.79,153.64,Incoming
43417466,2023-02-14,1241.6299999999999,195.84,Incoming
43420385,2023-01-31,881.49,,-
43420385,2023-02-02,763.59,117.9,Outgoing
43420385,2023-02-06,834.59,71.0,Incoming
43420385,2023-02-07,782.07,52.52,Outgoing
43420385,2023-02-09,-740.63,1522.7,Outgoing
43420385,2023-02-09,-656.99,83.64,Incoming
43420385,2023-02-09,-786.1800000000001,129.19,Outgoing
43453543,2023-01-31,890.67,,-
43453543,2023-02-01,989.06,98.39,Incoming
43453543,2023-02-02,913.9,75.16,Outgoing
43453543,2023-02-10,783.5799999999999,130.32,Outgoing
43453543,2023-02-12,711.4899999999999,72.09,Outgoing
43490748,2023-01-31,807.92,,-
43490748,2023-02-01,951.78,143.86,Incoming
43490748,2023-02-07,778.36,173.42,Outgoing
43490748,2023-02-08,711.4300000000001,66.93,Outgoing
43490748,2023-02-10,576.4300000000001,135.0,Outgoing
43490748,2023-02-13,678.8700000000001,102.44,Incoming
43490748,2023-02-13,761.2400000000001,82.37,Incoming
43490748,2023-02-14,684.0300000000001,77.21,Outgoing
43499771,2023-01-31,28.4,,-
43499771,2023-02-01,-50.07,78.47,Outgoing
43499771,2023-02-06,15.009999999999998,65.08,Incoming
43499771,2023-02-06,-62.800000000000004,77.81,Outgoing
43499771,2023-02-06,-1066.0,1003.2,Outgoing
43499771,2023-02-07,-990.87,75.13,Incoming
43499771,2023-02-07,-841.39,149.48,Incoming
43499771,2023-02-11,-985.25,143.86,Outgoing
43499771,2023-02-11,-866.9,118.35,Incoming
43499771,2023-02-12,-709.88,157.02,Incoming
43499771,2023-02-12,-555.14,154.74,Incoming
43499771,2023-02-14,-784.01,228.87,Outgoing
43541008,2023-01-31,413.2,,-
43541008,2023-02-01,307.65,105.55,Outgoing
43541008,2023-02-05,1452.4499999999998,1144.8,Incoming
43541008,2023-02-05,1509.1699999999998,56.72,Incoming
43541008,2023-02-11,1551.6499999999999,42.48,Incoming
43541008,2023-02-13,1477.6899999999998,73.96,Outgoing
43597919,2023-01-31,906.64,,-
43597919,2023-02-03,1002.18,95.54,Incoming
43597919,2023-02-06,858.15,144.03,Outgoing
43597919,2023-02-06,1802.35,944.2,Incoming
43597919,2023-02-07,191.94999999999982,1610.4,Outgoing
43597919,2023-02-08,278.9599999999998,87.01,Incoming
43597919,2023-02-12,393.0199999999998,114.06,Incoming
43597919,2023-02-12,-930.3800000000003,1323.4,Outgoing
43597919,2023-02-14,-974.8200000000004,44.44,Outgoing
43616790,2023-01-31,365.67,,-
43616790,2023-02-02,303.34000000000003,62.33,Outgoing
43616790,2023-02-05,241.66000000000003,61.68,Outgoing
43616790,2023-02-06,395.90000000000003,154.24,Incoming
43616790,2023-02-07,256.27000000000004,139.63,Outgoing
43616790,2023-02-08,219.55000000000004,36.72,Outgoing
43616790,2023-02-08,-723.9499999999999,943.5,Outgoing
43616790,2023-02-09,981.65,1705.6,Incoming
43616790,2023-02-09,907.26,74.39,Outgoing
43616790,2023-02-13,803.0799999999999,104.18,Outgoing
43623061,2023-01-31,724.39,,-
43623061,2023-02-02,-777.8100000000001,1502.2,Outgoing
43623061,2023-02-04,-702.33,75.48,Incoming
43623061,2023-02-11,-1034.13,331.8,Outgoing
43623061,2023-02-12,-957.2900000000001,76.84,Incoming
43623061,2023-02-12,-1023.6200000000001,66.33,Outgoing
43623061,2023-02-13,-894.3000000000002,129.32,Incoming
43623061,2023-02-14,-844.9200000000002,49.38,Incoming
43623061,2023-02-14,-720.7300000000002,124.19,Incoming
43772330,2023-01-31,701.52,,-
43772330,2023-02-03,871.47,169.95,Incoming
43772330,2023-02-05,1015.2,143.73,Incoming
43772330,2023-02-06,1112.53,97.33,Incoming
43772330,2023-02-08,1047.04,65.49,Outgoing
43772330,2023-02-10,948.28,98.76,Outgoing
43772330,2023-02-11,857.5699999999999,90.71,Outgoing
43772330,2023-02-12,811.8,45.77,Outgoing
43781476,2023-01-31,28.83,,-
43781476,2023-02-01,-99.66000000000001,128.49,Outgoing
43781476,2023-02-02,-155.96,56.3,Outgoing
43781476,2023-02-02,-271.94,115.98,Outgoing
43781476,2023-02-04,-415.77,143.83,Outgoing
43781476,2023-02-06,-461.32,45.55,Outgoing
43781476,2023-02-08,-409.02,52.3,Incoming
43781476,2023-02-08,534.48,943.5,Incoming
43781476,2023-02-13,381.34000000000003,153.14,Outgoing
43811112,2023-01-31,99.92,,-
43811112,2023-02-02,197.61,97.69,Incoming
43811112,2023-02-05,192.17000000000002,5.44,Outgoing
43811112,2023-02-07,-1568.6299999999999,1760.8,Outgoing
43811112,2023-02-08,-1468.86,99.77,Incoming
43811112,2023-02-08,-1332.1799999999998,136.68,Incoming
43811112,2023-02-09,152.82000000000016,1485.0,Incoming
43811112,2023-02-10,205.75000000000017,52.93,Incoming
43811112,2023-02-13,140.21000000000015,65.54,Outgoing
43811112,2023-02-14,47.090000000000146,93.12,Outgoing
43830772,2023-01-31,158.17,,-
43830772,2023-02-03,68.42999999999999,89.74,Outgoing
43843937,2023-01-31,79.03,,-
43843937,2023-02-06,11.070000000000007,67.96,Outgoing
43843937,2023-02-09,-929.8299999999999,940.9,Outgoing
43843937,2023-02-10,-1085.11,155.28,Outgoing
43843937,2023-02-11,-1603.21,518.1,Outgoing
43843937,2023-02-13,-2504.71,901.5,Outgoing
43858112,2023-01-31,641.78,,-
43858112,2023-02-01,744.73,102.95,Incoming
43858112,2023-02-02,784.48,39.75,Incoming
43858112,2023-02-04,834.08,49.6,Incoming
43858112,2023-02-04,756.38,77.7,Outgoing
43858112,2023-02-05,822.2,65.82,Incoming
43858112,2023-02-08,921.69,99.49,Incoming
43858112,2023-02-13,831.69,90.0,Outgoing
43858112,2023-02-13,950.1500000000001,118.46,Incoming
43858112,2023-02-14,1120.93,170.78,Incoming
43858112,2023-02-14,949.6800000000001,171.25,Outgoing
43860538,2023-01-31,478.05,,-
43860538,2023-02-02,567.85,89.8,Incoming
43860538,2023-02-08,498.1,69.75,Outgoing
43860538,2023-02-12,552.08,53.98,Incoming
43892675,2023-01-31,997.95,,-
43892675,2023-02-03,933.9200000000001,64.03,Outgoing
43892675,2023-02-07,1084.49,150.57,Incoming
43892675,2023-02-08,1165.26,80.77,Incoming
43892675,2023-02-14,1218.61,53.35,Incoming
43930935,2023-01-31,651.22,,-
43930935,2023-02-04,771.9100000000001,120.69,Incoming
43930935,2023-02-04,793.69,21.78,Incoming
43930935,2023-02-09,856.73,63.04,Incoming
43930935,2023-02-12,786.74,69.99,Outgoing
43930935,2023-02-14,869.44,82.7,Incoming
43979238,2023-01-31,68.08,,-
43979238,2023-02-01,-102.88000000000001,170.96,Outgoing
43979238,2023-02-03,-38.030000000000015,64.85,Incoming
43979238,2023-02-03,-87.42000000000002,49.39,Outgoing
43979238,2023-02-04,-202.69,115.27,Outgoing
43979238,2023-02-06,-24.319999999999993,178.37,Incoming
43979238,2023-02-12,-1511.12,1486.8,Outgoing
44007497,2023-01-31,331.92,,-
44007497,2023-02-03,290.70000000000005,41.22,Outgoing
44007497,2023-02-05,377.77000000000004,87.07,Incoming
44007497,2023-02-06,417.68000000000006,39.91,Incoming
44007497,2023-02-07,472.20000000000005,54.52,Incoming
44007497,2023-02-08,410.81000000000006,61.39,Outgoing
44007497,2023-02-08,322.07000000000005,88.74,Outgoing
44009985,2023-01-31,763.43,,-
44009985,2023-02-02,749.75,13.68,Outgoing
44009985,2023-02-08,1695.95,946.2,Incoming
44009985,2023-02-10,790.95,905.0,Outgoing
44009985,2023-02-11,688.69,102.26,Outgoing
44009985,2023-02-11,748.74,60.05,Incoming
44009985,2023-02-13,642.14,106.6,Outgoing
44009985,2023-02-14,747.05,104.91,Incoming
44019515,2023-01-31,312.63,,-
44019515,2023-02-02,196.38,116.25,Outgoing
44019515,2023-02-04,347.7,151.32,Incoming
44019515,2023-02-06,386.4,38.7,Incoming
44019515,2023-02-06,488.52,102.12,Incoming
44019515,2023-02-07,-670.98,1159.5,Outgoing
44019515,2023-02-09,-751.11,80.13,Outgoing
44019515,2023-02-13,-852.59,101.48,Outgoing
44066457,2023-01-31,18.09,,-
44066457,2023-02-03,-1160.91,1179.0,Outgoing
44066457,2023-02-03,-1239.8300000000002,78.92,Outgoing
44066457,2023-02-03,-1146.89,92.94,Incoming
44066457,2023-02-04,-1168.67,21.78,Outgoing
44066457,2023-02-05,-1271.5700000000002,102.9,Outgoing
44066457,2023-02-11,-1374.7500000000002,103.18,Outgoing
44066457,2023-02-13,-148.65000000000032,1226.1,Incoming
44066457,2023-02-14,-96.75000000000031,51.9,Incoming
44066457,2023-02-14,53.199999999999676,149.95,Incoming
44066457,2023-02-14,-103.18000000000032,156.38,Outgoing
44075619,2023-01-31,979.0,,-
44075619,2023-02-05,761.85,217.15,Outgoing
44075619,2023-02-08,870.36,108.51,Incoming
44075619,2023-02-08,954.32,83.96,Incoming
44075619,2023-02-09,856.9300000000001,97.39,Outgoing
44075619,2023-02-10,764.72,92.21,Outgoing
44075619,2023-02-10,714.2,50.52,Outgoing
44075619,2023-02-12,793.09,78.89,Incoming
44130477,2023-01-31,918.0,,-
44130477,2023-02-04,984.17,66.17,Incoming
44130477,2023-02-04,361.77,622.4,Outgoing
44130477,2023-02-08,224.10999999999999,137.66,Outgoing
44130477,2023-02-08,94.23999999999998,129.87,Outgoing
44130477,2023-02-12,130.88,36.64,Incoming
44133867,2023-01-31,358.61,,-
44133867,2023-02-03,189.35000000000002,169.26,Outgoing
44133867,2023-02-04,280.46000000000004,91.11,Incoming
44133867,2023-02-11,-570.74,851.2,Outgoing
44133867,2023-02-14,-596.76,26.02,Outgoing
44140049,2023-01-31,372.02,,-
44140049,2023-02-06,421.34999999999997,49.33,Incoming
44140049,2023-02-10,336.88,84.47,Outgoing
44140049,2023-02-10,451.45,114.57,Incoming
44140049,2023-02-11,541.43,89.98,Incoming
44140049,2023-02-11,419.0799999999999,122.35,Outgoing
44140049,2023-02-13,341.2799999999999,77.8,Outgoing
44145489,2023-01-31,635.75,,-
44145489,2023-02-03,548.25,87.5,Outgoing
44145489,2023-02-06,496.56,51.69,Outgoing
44145489,2023-02-10,575.64,79.08,Incoming
44145489,2023-02-11,630.97,55.33,Incoming
44145489,2023-02-12,1634.67,1003.7,Incoming
44162563,2023-01-31,325.77,,-
44162563,2023-02-09,1488.67,1162.9,Incoming
44162563,2023-02-11,1530.0900000000001,41.42,Incoming
44162563,2023-02-14,1632.64,102.55,Incoming
44164363,2023-01-31,998.43,,-
44164363,2023-02-02,915.7099999999999,82.72,Outgoing
44164363,2023-02-02,751.1099999999999,164.6,Outgoing
44164363,2023-02-03,906.1299999999999,155.02,Incoming
44164363,2023-02-06,957.8399999999999,51.71,Incoming
44164363,2023-02-09,1030.03,72.19,Incoming
44228646,2023-01-31,651.3,,-
44228646,2023-02-03,705.0799999999999,53.78,Incoming
44228646,2023-02-03,575.31,129.77,Outgoing
44228646,2023-02-04,-739.8900000000001,1315.2,Outgoing
44228646,2023-02-05,-1884.69,1144.8,Outgoing
44228646,2023-02-05,-1996.7,112.01,Outgoing
44228646,2023-02-07,-2032.8500000000001,36.15,Outgoing
44228646,2023-02-08,-2138.73,105.88,Outgoing
44228646,2023-02-08,-3382.9300000000003,1244.2,Outgoing
44228646,2023-02-09,-3281.5600000000004,101.37,Incoming
44228646,2023-02-10,-3328.1100000000006,46.55,Outgoing
44228646,2023-02-12,-3158.6700000000005,169.44,Incoming
44234432,2023-01-31,399.17,,-
44234432,2023-02-01,526.63,127.46,Incoming
44234432,2023-02-06,443.96,82.67,Outgoing
44234432,2023-02-07,490.27,46.31,Incoming
44234432,2023-02-08,581.15,90.88,Incoming
44234432,2023-02-09,425.06999999999994,156.08,Outgoing
44234432,2023-02-09,329.42999999999995,95.64,Outgoing
44234432,2023-02-10,149.42999999999995,180.0,Outgoing
44234432,2023-02-11,138.43999999999994,10.99,Outgoing
44234432,2023-02-12,-2.350000000000051,140.79,Outgoing
44234432,2023-02-14,188.73999999999995,191.09,Incoming
44239230,2023-01-31,390.94,,-
44239230,2023-02-01,580.4,189.46,Incoming
44239230,2023-02-06,649.12,68.72,Incoming
44242297,2023-01-31,388.02,,-
44242297,2023-02-01,524.97,136.95,Incoming
44242297,2023-02-03,329.06000000000006,195.91,Outgoing
44242297,2023-02-05,-632.9399999999999,962.0,Outgoing
44242297,2023-02-09,-803.1299999999999,170.19,Outgoing
44242297,2023-02-10,-849.1999999999999,46.07,Outgoing
44242297,2023-02-11,-951.2199999999999,102.02,Outgoing
44242297,2023-02-12,-1075.77,124.55,Outgoing
44242297,2023-02-12,-2079.4700000000003,1003.7,Outgoing
44242297,2023-02-13,-2226.5200000000004,147.05,Outgoing
44242297,2023-02-14,-2406.0900000000006,179.57,Outgoing
44243236,2023-01-31,797.95,,-
44243236,2023-02-01,852.2,54.25,Incoming
44243236,2023-02-02,743.35,108.85,Outgoing
44243236,2023-02-04,691.54,51.81,Outgoing
44243236,2023-02-11,814.5699999999999,123.03,Incoming
44243236,2023-02-12,-152.1300000000001,966.7,Outgoing
44243236,2023-02-14,-289.5000000000001,137.37,Outgoing
44272912,2023-01-31,448.18,,-
44272912,2023-02-01,590.44,142.26,Incoming
44272912,2023-02-07,-152.3599999999999,742.8,Outgoing
44272912,2023-02-07,-133.7499999999999,18.61,Incoming
44272912,2023-02-07,-44.65999999999988,89.09,Incoming
44272912,2023-02-08,-158.1199999999999,113.46,Outgoing
44272912,2023-02-09,-236.2799999999999,78.16,Outgoing
44272912,2023-02-09,-78.58999999999989,157.69,Incoming
44272912,2023-02-09,-116.6799999999999,38.09,Outgoing
44272912,2023-02-11,-180.4799999999999,63.8,Outgoing
44272912,2023-02-12,-1063.1799999999998,882.7,Outgoing
44272912,2023-02-14,-944.4299999999998,118.75,Incoming
44281556,2023-01-31,70.7,,-
44281556,2023-02-01,188.10000000000002,117.4,Incoming
44281556,2023-02-08,129.50000000000003,58.6,Outgoing
44310966,2023-01-31,361.02,,-
44310966,2023-02-02,253.21999999999997,107.8,Outgoing
44310966,2023-02-03,389.88,136.66,Incoming
44310966,2023-02-05,252.73,137.15,Outgoing
44310966,2023-02-07,294.08,41.35,Incoming
44310966,2023-02-09,411.98,117.9,Incoming
44310966,2023-02-13,298.68,113.3,Outgoing
44310966,2023-02-14,299.04,0.36,Incoming
44317934,2023-01-31,920.21,,-
44317934,2023-02-01,-967.99,1888.2,Outgoing
44317934,2023-02-02,-805.59,162.4,Incoming
44317934,2023-02-10,-598.72,206.87,Incoming
44317934,2023-02-13,-716.49,117.77,Outgoing
44331942,2023-01-31,389.13,,-
44331942,2023-02-02,163.79,225.34,Outgoing
44331942,2023-02-03,103.32,60.47,Outgoing
44331942,2023-02-04,53.71999999999999,49.6,Outgoing
44331942,2023-02-12,-115.62,169.34,Outgoing
44358901,2023-01-31,576.73,,-
44358901,2023-02-01,721.04,144.31,Incoming
44358901,2023-02-02,583.87,137.17,Outgoing
44358901,2023-02-03,701.38,117.51,Incoming
44358901,2023-02-04,627.71,73.67,Outgoing
44358901,2023-02-08,-1177.8899999999999,1805.6,Outgoing
44358901,2023-02-10,-1253.1899999999998,75.3,Outgoing
44358901,2023-02-11,-1212.3799999999999,40.81,Incoming
44358901,2023-02-12,-1301.04,88.66,Outgoing
44364430,2023-01-31,306.44,,-
44364430,2023-02-01,372.05,65.61,Incoming
44364430,2023-02-09,514.49,142.44,Incoming
44364430,2023-02-11,427.35,87.14,Outgoing
44364430,2023-02-11,311.21000000000004,116.14,Outgoing
44364430,2023-02-13,94.84000000000003,216.37,Outgoing
44368280,2023-01-31,291.54,,-
44368280,2023-02-03,278.02000000000004,13.52,Outgoing
44368280,2023-02-09,324.31000000000006,46.29,Incoming
44368280,2023-02-11,408.6000000000001,84.29,Incoming
44368280,2023-02-11,501.1400000000001,92.54,Incoming
44368280,2023-02-12,481.5800000000001,19.56,Outgoing
44378133,2023-01-31,721.21,,-
44378133,2023-02-01,733.71,12.5,Incoming
44378133,2023-02-02,610.51,123.2,Outgoing
44378133,2023-02-03,510.13,100.38,Outgoing
44378133,2023-02-03,444.03999999999996,66.09,Outgoing
44378133,2023-02-08,399.54999999999995,44.49,Outgoing
44378133,2023-02-11,1032.75,633.2,Incoming
44378133,2023-02-12,1230.2,197.45,Incoming
44378133,2023-02-14,1337.71,107.51,Incoming
44378133,2023-02-14,1439.77,102.06,Incoming
44389169,2023-01-31,978.69,,-
44389169,2023-02-04,1030.5,51.81,Incoming
44389169,2023-02-10,1134.17,103.67,Incoming
44389169,2023-02-10,1269.17,135.0,Incoming
44413402,2023-01-31,75.55,,-
44413402,2023-02-02,52.33,23.22,Outgoing
44413402,2023-02-08,-88.39999999999999,140.73,Outgoing
44413402,2023-02-11,38.530000000000015,126.93,Incoming
44427272,2023-01-31,970.1,,-
44427272,2023-02-01,1144.29,174.19,Incoming
44427272,2023-02-02,1141.6599999999999,2.63,Outgoing
44427272,2023-02-05,1033.3999999999999,108.26,Outgoing
44427272,2023-02-07,935.7299999999999,97.67,Outgoing
44427272,2023-02-10,951.0399999999998,15.31,Incoming
44474369,2023-01-31,663.93,,-
44474369,2023-02-09,761.7199999999999,97.79,Incoming
44474369,2023-02-09,697.2599999999999,64.46,Outgoing
44474369,2023-02-10,768.6699999999998,71.41,Incoming
44474369,2023-02-11,889.2399999999998,120.57,Incoming
44474369,2023-02-12,808.6599999999997,80.58,Outgoing
44474369,2023-02-12,739.2599999999998,69.4,Outgoing
44516940,2023-01-31,930.17,,-
44516940,2023-02-01,1112.36,182.19,Incoming
44516940,2023-02-06,1284.6299999999999,172.27,Incoming
44516940,2023-02-08,1075.62,209.01,Outgoing
44516940,2023-02-09,1088.33,12.71,Incoming
44516940,2023-02-12,1029.51,58.82,Outgoing
44516940,2023-02-12,864.3299999999999,165.18,Outgoing
44516940,2023-02-12,931.6399999999999,67.31,Incoming
44537960,2023-01-31,675.03,,-
44537960,2023-02-01,843.87,168.84,Incoming
44537960,2023-02-02,748.78,95.09,Outgoing
44537960,2023-02-06,883.8199999999999,135.04,Incoming
44537960,2023-02-06,736.4799999999999,147.34,Outgoing
44537960,2023-02-09,924.2599999999999,187.78,Incoming
44537960,2023-02-10,996.3199999999999,72.06,Incoming
44537960,2023-02-12,1189.07,192.75,Incoming
44537960,2023-02-13,1305.29,116.22,Incoming
44564500,2023-01-31,355.18,,-
44564500,2023-02-01,140.16,215.02,Outgoing
44564500,2023-02-03,72.78,67.38,Outgoing
44564500,2023-02-06,38.4,34.38,Outgoing
44564500,2023-02-10,-29.199999999999996,67.6,Outgoing
44586370,2023-01-31,440.56,,-
44586370,2023-02-02,525.21,84.65,Incoming
44586370,2023-02-06,568.0300000000001,42.82,Incoming
44586370,2023-02-06,608.94,40.91,Incoming
44586370,2023-02-07,531.51,77.43,Outgoing
44586370,2023-02-07,-968.49,1500.0,Outgoing
44586370,2023-02-08,-802.13,166.36,Incoming
44586370,2023-02-12,-919.64,117.51,Outgoing
44586370,2023-02-13,-813.93,105.71,Incoming
44586370,2023-02-14,-761.15,52.78,Incoming
44586370,2023-02-14,-830.16,69.01,Outgoing
44626164,2023-01-31,915.14,,-
44626164,2023-02-07,849.77,65.37,Outgoing
44626164,2023-02-09,2016.17,1166.4,Incoming
44626164,2023-02-14,2140.96,124.79,Incoming
44662337,2023-01-31,768.12,,-
44662337,2023-02-01,648.44,119.68,Outgoing
44662337,2023-02-09,788.9300000000001,140.49,Incoming
44662337,2023-02-14,626.84,162.09,Outgoing
44701536,2023-01-31,995.4,,-
44701536,2023-02-01,1071.58,76.18,Incoming
44701536,2023-02-06,1223.02,151.44,Incoming
44701536,2023-02-08,1112.42,110.6,Outgoing
44701536,2023-02-08,1229.64,117.22,Incoming
44701536,2023-02-10,1346.74,117.1,Incoming
44701536,2023-02-11,1422.62,75.88,Incoming
44711172,2023-01-31,382.83,,-
44711172,2023-02-02,557.5799999999999,174.75,Incoming
44711172,2023-02-04,407.56999999999994,150.01,Outgoing
44711172,2023-02-04,266.2399999999999,141.33,Outgoing
44711172,2023-02-08,347.4099999999999,81.17,Incoming
44711172,2023-02-13,338.4699999999999,8.94,Outgoing
44759468,2023-01-31,962.91,,-
44759468,2023-02-01,1060.83,97.92,Incoming
44759468,2023-02-04,919.1199999999999,141.71,Outgoing
44759468,2023-02-07,834.6599999999999,84.46,Outgoing
44759468,2023-02-09,869.8399999999998,35.18,Incoming
44759468,2023-02-10,975.1899999999998,105.35,Incoming
44759468,2023-02-10,901.0399999999998,74.15,Outgoing
44759468,2023-02-11,935.8499999999999,34.81,Incoming
44759468,2023-02-12,1105.21,169.36,Incoming
44759468,2023-02-13,1215.55,110.34,Incoming
44794340,2023-01-31,488.91,,-
44794340,2023-02-13,560.45,71.54,Incoming
44812075,2023-01-31,863.71,,-
44812075,2023-02-01,262.01,601.7,Outgoing
44812075,2023-02-02,145.91,116.1,Outgoing
44812075,2023-02-02,254.42000000000002,108.51,Incoming
44812075,2023-02-06,126.83000000000001,127.59,Outgoing
44812075,2023-02-12,-0.4399999999999835,127.27,Outgoing
44812075,2023-02-13,-64.74999999999999,64.31,Outgoing
44816910,2023-01-31,185.51,,-
44816910,2023-02-01,-44.29000000000002,229.8,Outgoing
44816910,2023-02-04,-133.87,89.58,Outgoing
44816910,2023-02-05,-124.82000000000001,9.05,Incoming
44816910,2023-02-05,22.549999999999997,147.37,Incoming
44816910,2023-02-05,-34.07,56.62,Outgoing
44816910,2023-02-06,-64.52,30.45,Outgoing
44816910,2023-02-07,-821.02,756.5,Outgoing
44816910,2023-02-08,-931.8199999999999,110.8,Outgoing
44816910,2023-02-13,-899.81,32.01,Incoming
44816910,2023-02-13,-781.41,118.4,Incoming
44873253,2023-01-31,660.51,,-
44873253,2023-02-03,600.18,60.33,Outgoing
44873253,2023-02-03,591.6099999999999,8.57,Outgoing
44873253,2023-02-05,685.1799999999998,93.57,Incoming
44873253,2023-02-07,798.6099999999999,113.43,Incoming
44873253,2023-02-10,990.8699999999999,192.26,Incoming
44873253,2023-02-10,1084.61,93.74,Incoming
44873253,2023-02-11,358.40999999999985,726.2,Outgoing
44902994,2023-01-31,790.34,,-
44902994,2023-02-01,704.57,85.77,Outgoing
44902994,2023-02-02,878.7,174.13,Incoming
44902994,2023-02-03,2138.3,1259.6,Incoming
44902994,2023-02-03,2114.46,23.84,Outgoing
44902994,2023-02-03,2145.46,31.0,Incoming
44902994,2023-02-03,2203.69,58.23,Incoming
44902994,2023-02-04,2127.52,76.17,Outgoing
44902994,2023-02-04,2033.23,94.29,Outgoing
44902994,2023-02-05,1934.07,99.16,Outgoing
44902994,2023-02-06,1962.7,28.63,Incoming
44902994,2023-02-08,1845.29,117.41,Outgoing
44902994,2023-02-13,1906.98,61.69,Incoming
44912164,2023-01-31,355.61,,-
44912164,2023-02-03,466.28000000000003,110.67,Incoming
44912164,2023-02-05,496.03000000000003,29.75,Incoming
44912164,2023-02-07,546.96,50.93,Incoming
44912164,2023-02-12,521.14,25.82,Outgoing
44912164,2023-02-13,649.9,128.76,Incoming
44912164,2023-02-14,600.52,49.38,Outgoing
44912164,2023-02-14,443.09,157.43,Outgoing
45015534,2023-01-31,215.54,,-
45015534,2023-02-06,370.46,154.92,Incoming
45015534,2023-02-07,294.26,76.2,Outgoing
45015534,2023-02-08,-738.1400000000001,1032.4,Outgoing
45015534,2023-02-09,-821.5600000000001,83.42,Outgoing
45015570,2023-01-31,905.57,,-
45015570,2023-02-01,767.85,137.72,Outgoing
45015570,2023-02-01,12.950000000000045,754.9,Outgoing
45015570,2023-02-06,85.65000000000005,72.7,Incoming
45015570,2023-02-06,184.52000000000004,98.87,Incoming
45015570,2023-02-07,48.22000000000003,136.3,Outgoing
45015570,2023-02-08,198.86,150.64,Incoming
45015570,2023-02-09,344.68,145.82,Incoming
45015570,2023-02-13,184.79000000000002,159.89,Outgoing
45015570,2023-02-14,8.420000000000016,176.37,Outgoing
45020832,2023-01-31,104.89,,-
45020832,2023-02-02,12.840000000000003,92.05,Outgoing
45020832,2023-02-03,-77.11,89.95,Outgoing
45020832,2023-02-05,81.13000000000001,158.24,Incoming
45020832,2023-02-09,-28.879999999999995,110.01,Outgoing
45020832,2023-02-11,-71.72999999999999,42.85,Outgoing
45020832,2023-02-11,-87.82,16.09,Outgoing
45021115,2023-01-31,464.27,,-
45021115,2023-02-07,348.22999999999996,116.04,Outgoing
45021115,2023-02-08,537.9399999999999,189.71,Incoming
45021115,2023-02-10,412.4699999999999,125.47,Outgoing
45021115,2023-02-10,350.4599999999999,62.01,Outgoing
45021115,2023-02-11,-1463.1399999999999,1813.6,Outgoing
45021115,2023-02-12,-1504.34,41.2,Outgoing
45021115,2023-02-13,-1485.4099999999999,18.93,Incoming
45021398,2023-01-31,783.24,,-
45021398,2023-02-02,705.81,77.43,Outgoing
45021398,2023-02-04,190.20999999999992,515.6,Outgoing
45021398,2023-02-08,258.88999999999993,68.68,Incoming
45021398,2023-02-10,603.1899999999999,344.3,Incoming
45021398,2023-02-10,675.42,72.23,Incoming
45021398,2023-02-10,566.78,108.64,Outgoing
45026430,2023-01-31,745.31,,-
45026430,2023-02-04,566.3699999999999,178.94,Outgoing
45026430,2023-02-07,603.0999999999999,36.73,Incoming
45026430,2023-02-09,751.55,148.45,Incoming
45026430,2023-02-10,806.8399999999999,55.29,Incoming
45026430,2023-02-11,180.2399999999999,626.6,Outgoing
45026430,2023-02-13,265.9899999999999,85.75,Incoming
45027876,2023-01-31,80.13,,-
45027876,2023-02-01,7.780000000000001,72.35,Outgoing
45027876,2023-02-01,65.25999999999999,57.48,Incoming
45027876,2023-02-01,235.51,170.25,Incoming
45027876,2023-02-03,315.37,79.86,Incoming
45027876,2023-02-04,139.22,176.15,Outgoing
45027876,2023-02-06,220.01999999999998,80.8,Incoming
45027876,2023-02-07,165.67,54.35,Outgoing
45027876,2023-02-07,392.83,227.16,Incoming
45027876,2023-02-12,395.9,3.07,Incoming
45027876,2023-02-14,481.30999999999995,85.41,Incoming
45029598,2023-01-31,558.87,,-
45029598,2023-02-06,625.87,67.0,Incoming
45029598,2023-02-06,745.48,119.61,Incoming
45029598,2023-02-08,895.3100000000001,149.83,Incoming
45029598,2023-02-09,959.7800000000001,64.47,Incoming
45029598,2023-02-09,883.32,76.46,Outgoing
45029598,2023-02-09,812.85,70.47,Outgoing
45029598,2023-02-12,805.39,7.46,Outgoing
45029598,2023-02-14,2143.79,1338.4,Incoming
45029598,2023-02-14,2101.6,42.19,Outgoing
45067158,2023-01-31,115.23,,-
45067158,2023-02-04,194.06,78.83,Incoming
45067158,2023-02-04,295.36,101.3,Incoming
45067158,2023-02-04,397.8,102.44,Incoming
45067158,2023-02-05,291.48,106.32,Outgoing
45067158,2023-02-05,375.47,83.99,Incoming
45067158,2023-02-09,190.56000000000003,184.91,Outgoing
45067158,2023-02-10,13.370000000000033,177.19,Outgoing
45067158,2023-02-11,-77.34999999999997,90.72,Outgoing
45089475,2023-01-31,676.92,,-
45089475,2023-02-03,796.56,119.64,Incoming
45089475,2023-02-13,922.53,125.97,Incoming
45089475,2023-02-13,2504.9300000000003,1582.4,Incoming
45111669,2023-01-31,459.28,,-
45111669,2023-02-01,337.37,121.91,Outgoing
45111669,2023-02-03,320.94,16.43,Outgoing
45111669,2023-02-10,437.27,116.33,Incoming
45111669,2023-02-11,521.63,84.36,Incoming
45111669,2023-02-14,694.67,173.04,Incoming
45161114,2023-01-31,282.6,,-
45161114,2023-02-01,148.17000000000002,134.43,Outgoing
45161114,2023-02-06,15.26000000000002,132.91,Outgoing
45161114,2023-02-10,-110.88999999999999,126.15,Outgoing
45196342,2023-01-31,402.48,,-
45196342,2023-02-01,467.37,64.89,Incoming
45196342,2023-02-03,572.26,104.89,Incoming
45196342,2023-02-04,435.79999999999995,136.46,Outgoing
45196342,2023-02-10,314.89,120.91,Outgoing
45196342,2023-02-11,427.12,112.23,Incoming
45196342,2023-02-12,1619.8200000000002,1192.7,Incoming
45238909,2023-01-31,904.83,,-
45238909,2023-02-04,783.98,120.85,Outgoing
45238909,2023-02-08,822.89,38.91,Incoming
45238909,2023-02-08,70.99000000000001,751.9,Outgoing
45238909,2023-02-13,-62.97999999999999,133.97,Outgoing
45242171,2023-01-31,174.66,,-
45242171,2023-02-04,90.53999999999999,84.12,Outgoing
45242171,2023-02-09,183.68,93.14,Incoming
45242171,2023-02-13,110.37,73.31,Outgoing
45253870,2023-01-31,273.37,,-
45253870,2023-02-07,-212.52999999999997,485.9,Outgoing
45253870,2023-02-11,-134.32999999999998,78.2,Incoming
45253870,2023-02-12,-277.30999999999995,142.98,Outgoing
45275334,2023-01-31,49.55,,-
45275334,2023-02-02,-62.68000000000001,112.23,Outgoing
45275334,2023-02-03,27.269999999999996,89.95,Incoming
45397824,2023-01-31,741.62,,-
45397824,2023-02-01,872.4200000000001,130.8,Incoming
45397824,2023-02-02,694.9100000000001,177.51,Outgoing
45397824,2023-02-03,849.8600000000001,154.95,Incoming
45397824,2023-02-03,829.4400000000002,20.42,Outgoing
45397824,2023-02-07,942.9900000000001,113.55,Incoming
45397824,2023-02-11,896.3400000000001,46.65,Outgoing
45397824,2023-02-12,761.3700000000001,134.97,Outgoing
45397824,2023-02-14,1386.67,625.3,Incoming
45519330,2023-01-31,840.22,,-
45519330,2023-02-01,1021.0500000000001,180.83,Incoming
45519330,2023-02-01,1101.93,80.88,Incoming
45519330,2023-02-03,861.6700000000001,240.26,Outgoing
45519330,2023-02-07,775.9100000000001,85.76,Outgoing
45519330,2023-02-11,939.5600000000001,163.65,Incoming
45519330,2023-02-13,913.97,25.59,Outgoing
45543867,2023-01-31,419.92,,-
45543867,2023-02-01,337.5,82.42,Outgoing
45543867,2023-02-02,219.79000000000002,117.71,Outgoing
45543867,2023-02-03,113.36000000000001,106.43,Outgoing
45543867,2023-02-03,-23.299999999999983,136.66,Outgoing
45543867,2023-02-07,-1545.3,1522.0,Outgoing
45543867,2023-02-09,-1646.08,100.78,Outgoing
45543867,2023-02-11,-1567.4199999999998,78.66,Incoming
45543867,2023-02-13,-2129.8199999999997,562.4,Outgoing
45558696,2023-01-31,760.19,,-
45558696,2023-02-02,-1129.81,1890.0,Outgoing
45558696,2023-02-05,396.28999999999996,1526.1,Incoming
45558696,2023-02-07,541.22,144.93,Incoming
45558696,2023-02-07,499.03000000000003,42.19,Outgoing
45558696,2023-02-07,672.45,173.42,Incoming
45558696,2023-02-08,734.6,62.15,Incoming
45611838,2023-01-31,784.55,,-
45611838,2023-02-03,736.81,47.74,Outgoing
45611838,2023-02-04,790.3199999999999,53.51,Incoming
45611838,2023-02-04,743.8299999999999,46.49,Outgoing
45611838,2023-02-06,841.4699999999999,97.64,Incoming
45611838,2023-02-07,910.6899999999999,69.22,Incoming
45611838,2023-02-09,736.81,173.88,Outgoing
45611838,2023-02-14,614.1999999999999,122.61,Outgoing
45631973,2023-01-31,762.7,,-
45631973,2023-02-01,949.71,187.01,Incoming
45631973,2023-02-04,840.28,109.43,Outgoing
45631973,2023-02-05,1060.28,220.0,Incoming
45631973,2023-02-08,2488.2799999999997,1428.0,Incoming
45631973,2023-02-09,2382.49,105.79,Outgoing
45631973,2023-02-11,2491.27,108.78,Incoming
45639009,2023-01-31,489.05,,-
45639009,2023-02-04,561.77,72.72,Incoming
45639009,2023-02-04,670.01,108.24,Incoming
45639009,2023-02-05,742.5699999999999,72.56,Incoming
45639009,2023-02-05,748.01,5.44,Incoming
45639009,2023-02-09,792.95,44.94,Incoming
45639009,2023-02-12,906.98,114.03,Incoming
45639009,2023-02-12,701.72,205.26,Outgoing
45688415,2023-01-31,686.92,,-
45688415,2023-02-01,-706.7800000000001,1393.7,Outgoing
45688415,2023-02-03,-885.2500000000001,178.47,Outgoing
45688415,2023-02-07,-763.3400000000001,121.91,Incoming
45688415,2023-02-11,-859.7000000000002,96.36,Outgoing
45688415,2023-02-11,-724.2200000000001,135.48,Incoming
45688415,2023-02-13,-826.5300000000002,102.31,Outgoing
45706674,2023-01-31,390.73,,-
45706674,2023-02-01,1578.43,1187.7,Incoming
45706674,2023-02-04,1729.27,150.84,Incoming
45706674,2023-02-04,1614.73,114.54,Outgoing
45706674,2023-02-04,1756.04,141.31,Incoming
45706674,2023-02-05,1646.4099999999999,109.63,Outgoing
45706674,2023-02-06,1707.1799999999998,60.77,Incoming
45706674,2023-02-10,1830.5299999999997,123.35,Incoming
45706674,2023-02-12,1988.6399999999999,158.11,Incoming
45740727,2023-01-31,904.27,,-
45740727,2023-02-05,754.36,149.91,Outgoing
45740727,2023-02-08,974.7,220.34,Incoming
45740727,2023-02-13,819.34,155.36,Outgoing
45790907,2023-01-31,567.67,,-
45790907,2023-02-01,455.3299999999999,112.34,Outgoing
45790907,2023-02-01,-808.97,1264.3,Outgoing
45790907,2023-02-04,-763.44,45.53,Incoming
45790907,2023-02-04,-896.44,133.0,Outgoing
45790907,2023-02-05,-1005.36,108.92,Outgoing
45790907,2023-02-05,-1063.64,58.28,Outgoing
45790907,2023-02-07,-995.69,67.95,Incoming
45790907,2023-02-10,279.71000000000004,1275.4,Incoming
45790907,2023-02-12,424.03000000000003,144.32,Incoming
45790907,2023-02-14,491.88,67.85,Incoming
45816894,2023-01-31,227.68,,-
45816894,2023-02-02,308.69,81.01,Incoming
45816894,2023-02-08,-698.21,1006.9,Outgoing
45816894,2023-02-13,-653.37,44.84,Incoming
45816894,2023-02-13,-500.78999999999996,152.58,Incoming
45822265,2023-01-31,881.34,,-
45822265,2023-02-02,1061.5,180.16,Incoming
45822265,2023-02-03,1175.28,113.78,Incoming
45822265,2023-02-05,1792.98,617.7,Incoming
45822265,2023-02-05,1693.83,99.15,Outgoing
45822265,2023-02-05,2846.33,1152.5,Incoming
45822265,2023-02-11,2932.61,86.28,Incoming
45822265,2023-02-11,3072.76,140.15,Incoming
45822265,2023-02-12,2195.26,877.5,Outgoing
45829157,2023-01-31,361.77,,-
45829157,2023-02-01,509.37,147.6,Incoming
45829157,2023-02-03,693.24,183.87,Incoming
45829157,2023-02-05,669.5,23.74,Outgoing
45829157,2023-02-06,512.53,156.97,Outgoing
45829157,2023-02-08,592.99,80.46,Incoming
45829157,2023-02-10,478.99,114.0,Outgoing
45829157,2023-02-12,389.95,89.04,Outgoing
45829157,2023-02-14,543.43,153.48,Incoming
45859156,2023-01-31,644.5,,-
45859156,2023-02-01,790.52,146.02,Incoming
45859156,2023-02-02,670.2,120.32,Outgoing
45859156,2023-02-05,504.1700000000001,166.03,Outgoing
45859156,2023-02-07,401.95000000000005,102.22,Outgoing
45859156,2023-02-10,-1323.1499999999999,1725.1,Outgoing
45960045,2023-01-31,853.47,,-
45960045,2023-02-03,725.37,128.1,Outgoing
45960045,2023-02-03,676.09,49.28,Outgoing
45960045,2023-02-07,721.47,45.38,Incoming
45960045,2023-02-09,601.39,120.08,Outgoing
45960045,2023-02-13,649.52,48.13,Incoming
45960045,2023-02-13,684.99,35.47,Incoming
45974864,2023-01-31,957.27,,-
45974864,2023-02-03,1065.87,108.6,Incoming
45974864,2023-02-10,945.06,120.81,Outgoing
45974864,2023-02-13,881.2099999999999,63.85,Outgoing
45974864,2023-02-14,924.6299999999999,43.42,Incoming
46012936,2023-01-31,120.79,,-
46012936,2023-02-03,74.2,46.59,Outgoing
46012936,2023-02-04,187.82,113.62,Incoming
46012936,2023-02-06,132.29999999999998,55.52,Outgoing
46012936,2023-02-13,69.36999999999998,62.93,Outgoing
46012936,2023-02-14,244.43999999999997,175.07,Incoming
46059921,2023-01-31,905.78,,-
46059921,2023-02-01,1000.99,95.21,Incoming
46059921,2023-02-02,1080.29,79.3,Incoming
46059921,2023-02-10,996.77,83.52,Outgoing
46059921,2023-02-13,986.97,9.8,Outgoing
46059921,2023-02-14,1134.82,147.85,Incoming
46064017,2023-01-31,672.77,,-
46064017,2023-02-02,643.78,28.99,Outgoing
46064017,2023-02-03,514.05,129.73,Outgoing
46064017,2023-02-05,453.15,60.9,Outgoing
46064017,2023-02-10,-1122.4499999999998,1575.6,Outgoing
46064017,2023-02-11,-650.6499999999999,471.8,Incoming
46064017,2023-02-12,-796.3299999999999,145.68,Outgoing
46064017,2023-02-12,-680.4599999999999,115.87,Incoming
46064017,2023-02-13,120.44000000000005,800.9,Incoming
46064017,2023-02-14,-20.68999999999994,141.13,Outgoing
46067647,2023-01-31,677.66,,-
46067647,2023-02-03,732.0699999999999,54.41,Incoming
46067647,2023-02-03,830.3799999999999,98.31,Incoming
46067647,2023-02-03,919.3199999999999,88.94,Incoming
46067647,2023-02-06,855.03,64.29,Outgoing
46067647,2023-02-08,898.93,43.9,Incoming
46067647,2023-02-13,758.41,140.52,Outgoing
46067647,2023-02-14,656.5,101.91,Outgoing
46073044,2023-01-31,957.36,,-
46073044,2023-02-06,1115.51,158.15,Incoming
46073044,2023-02-08,1380.55,265.04,Incoming
46073044,2023-02-11,1502.06,121.51,Incoming
46073044,2023-02-14,-377.44000000000005,1879.5,Outgoing
46073044,2023-02-14,-533.26,155.82,Outgoing
46085917,2023-01-31,340.16,,-
46085917,2023-02-06,235.31000000000003,104.85,Outgoing
46085917,2023-02-08,1609.4099999999999,1374.1,Incoming
46085917,2023-02-08,1720.2099999999998,110.8,Incoming
46085917,2023-02-09,1875.87,155.66,Incoming
46085917,2023-02-10,1785.57,90.3,Outgoing
46085917,2023-02-11,1630.08,155.49,Outgoing
46085917,2023-02-13,1562.77,67.31,Outgoing
46085917,2023-02-13,1500.36,62.41,Outgoing
46100177,2023-01-31,979.25,,-
46100177,2023-02-02,1660.25,681.0,Incoming
46100177,2023-02-02,1754.23,93.98,Incoming
46100177,2023-02-03,1796.57,42.34,Incoming
46100177,2023-02-06,1871.19,74.62,Incoming
46100177,2023-02-08,1073.99,797.2,Outgoing
46100177,2023-02-09,974.55,99.44,Outgoing
46133743,2023-01-31,862.26,,-
46133743,2023-02-02,962.26,100.0,Incoming
46133743,2023-02-06,869.05,93.21,Outgoing
46133743,2023-02-10,839.53,29.52,Outgoing
46215382,2023-01-31,549.77,,-
46215382,2023-02-03,2119.17,1569.4,Incoming
46215382,2023-02-03,2195.28,76.11,Incoming
46215382,2023-02-03,2348.23,152.95,Incoming
46215382,2023-02-04,2405.64,57.41,Incoming
46215382,2023-02-05,2520.17,114.53,Incoming
46215382,2023-02-06,2348.88,171.29,Outgoing
46215382,2023-02-07,2516.6,167.72,Incoming
46215382,2023-02-10,432.5,2084.1,Outgoing
46215382,2023-02-11,488.86,56.36,Incoming
46215382,2023-02-13,527.64,38.78,Incoming
46215382,2023-02-13,391.86,135.78,Outgoing
46230315,2023-01-31,4.43,,-
46230315,2023-02-02,-116.18,120.61,Outgoing
46230315,2023-02-04,36.97999999999999,153.16,Incoming
46230315,2023-02-06,182.39999999999998,145.42,Incoming
46230315,2023-02-13,57.14999999999998,125.25,Outgoing
46230315,2023-02-13,123.29999999999998,66.15,Incoming
46231176,2023-01-31,290.35,,-
46231176,2023-02-01,1687.75,1397.4,Incoming
46231176,2023-02-01,1525.34,162.41,Outgoing
46231176,2023-02-02,1427.1899999999998,98.15,Outgoing
46231176,2023-02-05,1474.0499999999997,46.86,Incoming
46231176,2023-02-09,848.9499999999997,625.1,Outgoing
46231176,2023-02-11,866.3999999999997,17.45,Incoming
46231176,2023-02-12,904.0999999999998,37.7,Incoming
46231176,2023-02-12,848.2899999999997,55.81,Outgoing
46231176,2023-02-13,753.5999999999997,94.69,Outgoing
46231176,2023-02-13,770.1899999999997,16.59,Incoming
46255563,2023-01-31,565.42,,-
46255563,2023-02-01,472.90999999999997,92.51,Outgoing
46255563,2023-02-04,602.0699999999999,129.16,Incoming
46255563,2023-02-14,691.7399999999999,89.67,Incoming
46255563,2023-02-14,743.8399999999999,52.1,Incoming
46322903,2023-01-31,873.01,,-
46322903,2023-02-06,1052.11,179.1,Incoming
46322903,2023-02-06,1074.6499999999999,22.54,Incoming
46322903,2023-02-08,1280.7199999999998,206.07,Incoming
46322903,2023-02-08,1214.3299999999997,66.39,Outgoing
46322903,2023-02-09,1070.5599999999997,143.77,Outgoing
46322903,2023-02-14,988.8199999999997,81.74,Outgoing
46326165,2023-01-31,571.8,,-
46326165,2023-02-03,666.0799999999999,94.28,Incoming
46326165,2023-02-06,651.53,14.55,Outgoing
46326165,2023-02-07,738.62,87.09,Incoming
46326165,2023-02-10,595.0,143.62,Outgoing
46326165,2023-02-12,694.3,99.3,Incoming
46326165,2023-02-13,509.03,185.27,Outgoing
46346470,2023-01-31,787.87,,-
46346470,2023-02-02,881.81,93.94,Incoming
46346470,2023-02-04,1014.81,133.0,Incoming
46346470,2023-02-08,1050.32,35.51,Incoming
46346470,2023-02-09,980.03,70.29,Outgoing
46346470,2023-02-11,1098.22,118.19,Incoming
46346470,2023-02-12,1016.78,81.44,Outgoing
46346470,2023-02-13,1084.51,67.73,Incoming
46355307,2023-01-31,152.4,,-
46355307,2023-02-01,313.71000000000004,161.31,Incoming
46355307,2023-02-02,139.58000000000004,174.13,Outgoing
46355307,2023-02-14,1127.48,987.9,Incoming
46442210,2023-01-31,732.14,,-
46442210,2023-02-02,850.36,118.22,Incoming
46442210,2023-02-06,769.5600000000001,80.8,Outgoing
46442210,2023-02-09,1669.3600000000001,899.8,Incoming
46442210,2023-02-11,1692.94,23.58,Incoming
46442210,2023-02-14,1658.1000000000001,34.84,Outgoing
46479025,2023-01-31,323.03,,-
46479025,2023-02-04,368.53999999999996,45.51,Incoming
46479025,2023-02-04,279.65,88.89,Outgoing
46479025,2023-02-11,369.67999999999995,90.03,Incoming
46479025,2023-02-12,269.18999999999994,100.49,Outgoing
46479025,2023-02-14,441.56999999999994,172.38,Incoming
46525458,2023-01-31,938.4,,-
46525458,2023-02-05,2687.0,1748.6,Incoming
46525458,2023-02-07,2533.04,153.96,Outgoing
46525458,2023-02-07,1308.04,1225.0,Outgoing
46525458,2023-02-10,1221.8999999999999,86.14,Outgoing
46525458,2023-02-11,1260.1499999999999,38.25,Incoming
46525458,2023-02-13,1376.52,116.37,Incoming
46552077,2023-01-31,672.51,,-
46552077,2023-02-02,727.45,54.94,Incoming
46552077,2023-02-06,880.98,153.53,Incoming
46561814,2023-01-31,216.29,,-
46561814,2023-02-01,145.95,70.34,Outgoing
46561814,2023-02-06,251.95,106.0,Incoming
46561814,2023-02-07,466.12,214.17,Incoming
46561814,2023-02-07,651.51,185.39,Incoming
46561814,2023-02-07,557.5799999999999,93.93,Outgoing
46561814,2023-02-09,433.0199999999999,124.56,Outgoing
46561814,2023-02-13,592.4799999999999,159.46,Incoming
46597215,2023-01-31,455.5,,-
46597215,2023-02-06,382.0,73.5,Outgoing
46597215,2023-02-07,216.66,165.34,Outgoing
46597215,2023-02-08,-906.4399999999999,1123.1,Outgoing
46597215,2023-02-09,-894.9699999999999,11.47,Incoming
46597728,2023-01-31,920.72,,-
46597728,2023-02-04,809.73,110.99,Outgoing
46597728,2023-02-05,59.83000000000004,749.9,Outgoing
46597728,2023-02-06,-52.10999999999996,111.94,Outgoing
46597728,2023-02-13,112.96000000000004,165.07,Incoming
46597728,2023-02-13,1969.66,1856.7,Incoming
46643937,2023-01-31,751.73,,-
46643937,2023-02-03,689.8100000000001,61.92,Outgoing
46643937,2023-02-07,621.9300000000001,67.88,Outgoing
46643937,2023-02-07,696.0400000000001,74.11,Incoming
46643937,2023-02-07,2044.3400000000001,1348.3,Incoming
46643937,2023-02-11,1817.42,226.92,Outgoing
46643937,2023-02-12,775.52,1041.9,Outgoing
46643937,2023-02-12,698.5799999999999,76.94,Outgoing
46643937,2023-02-14,809.2399999999999,110.66,Incoming
46663039,2023-01-31,989.43,,-
46663039,2023-02-01,940.06,49.37,Outgoing
46663039,2023-02-03,992.3299999999999,52.27,Incoming
46663039,2023-02-03,1111.53,119.2,Incoming
46663039,2023-02-06,1077.33,34.2,Outgoing
46663039,2023-02-06,916.3,161.03,Outgoing
46663039,2023-02-09,1729.3,813.0,Incoming
46663039,2023-02-12,1608.44,120.86,Outgoing
46663039,2023-02-14,1720.91,112.47,Incoming
46730484,2023-01-31,398.49,,-
46730484,2023-02-04,286.61,111.88,Outgoing
46730484,2023-02-10,397.66,111.05,Incoming
46730484,2023-02-11,460.74,63.08,Incoming
46730484,2023-02-13,379.84000000000003,80.9,Outgoing
46730484,2023-02-14,459.12,79.28,Incoming
46741126,2023-01-31,393.18,,-
46741126,2023-02-02,508.05,114.87,Incoming
46741126,2023-02-03,677.31,169.26,Incoming
46741126,2023-02-06,723.4699999999999,46.16,Incoming
46741126,2023-02-07,784.2299999999999,60.76,Incoming
46741126,2023-02-10,599.4799999999999,184.75,Outgoing
46741126,2023-02-13,715.8499999999999,116.37,Incoming
46768821,2023-01-31,458.81,,-
46768821,2023-02-03,368.69,90.12,Outgoing
46768821,2023-02-04,233.57999999999998,135.11,Outgoing
46768821,2023-02-06,109.16999999999999,124.41,Outgoing
46768821,2023-02-08,241.78,132.61,Incoming
46768821,2023-02-13,112.5,129.28,Outgoing
46790294,2023-01-31,855.42,,-
46790294,2023-02-01,1012.3,156.88,Incoming
46790294,2023-02-01,1068.1499999999999,55.85,Incoming
46790294,2023-02-03,1140.56,72.41,Incoming
46790294,2023-02-07,1053.47,87.09,Outgoing
46790294,2023-02-08,1151.85,98.38,Incoming
46790294,2023-02-09,1114.1999999999998,37.65,Outgoing
46792863,2023-01-31,843.5,,-
46792863,2023-02-01,924.5699999999999,81.07,Incoming
46792863,2023-02-03,837.2099999999999,87.36,Outgoing
46792863,2023-02-06,677.7399999999999,159.47,Outgoing
46792863,2023-02-07,762.3999999999999,84.66,Incoming
46851905,2023-01-31,18.23,,-
46851905,2023-02-01,-198.26000000000002,216.49,Outgoing
46851905,2023-02-01,-74.97000000000001,123.29,Incoming
46851905,2023-02-04,-271.95,196.98,Outgoing
46851905,2023-02-05,-412.16999999999996,140.22,Outgoing
46851905,2023-02-06,-853.5699999999999,441.4,Outgoing
46851905,2023-02-09,-904.1999999999999,50.63,Outgoing
46854962,2023-01-31,364.03,,-
46854962,2023-02-01,328.15,35.88,Outgoing
46854962,2023-02-01,409.64,81.49,Incoming
46854962,2023-02-02,315.94,93.7,Outgoing
46854962,2023-02-13,211.67000000000002,104.27,Outgoing
46854962,2023-02-14,99.84000000000002,111.83,Outgoing
46854962,2023-02-14,643.84,544.0,Incoming
46879333,2023-01-31,462.44,,-
46879333,2023-02-06,598.21,135.77,Incoming
46879333,2023-02-10,559.26,38.95,Outgoing
46879333,2023-02-14,638.54,79.28,Incoming
46879333,2023-02-14,767.4,128.86,Incoming
46913859,2023-01-31,410.19,,-
46913859,2023-02-01,529.87,119.68,Incoming
46913859,2023-02-05,441.17,88.7,Outgoing
46913859,2023-02-07,314.23,126.94,Outgoing
46913859,2023-02-08,-812.8699999999999,1127.1,Outgoing
46913859,2023-02-09,-705.0299999999999,107.84,Incoming
46920610,2023-01-31,124.16,,-
46920610,2023-02-01,-0.7000000000000028,124.86,Outgoing
46920610,2023-02-02,-26.550000000000004,25.85,Outgoing
46920610,2023-02-05,-62.68000000000001,36.13,Outgoing
46920610,2023-02-05,98.57,161.25,Incoming
46920610,2023-02-08,129.1,30.53,Incoming
46920610,2023-02-09,222.61,93.51,Incoming
46925211,2023-01-31,509.25,,-
46925211,2023-02-01,319.78999999999996,189.46,Outgoing
46925211,2023-02-09,315.40999999999997,4.38,Outgoing
46925211,2023-02-12,520.67,205.26,Incoming
46925211,2023-02-13,470.78,49.89,Outgoing
47040996,2023-01-31,462.95,,-
47040996,2023-02-01,593.78,130.83,Incoming
47040996,2023-02-02,419.89,173.89,Outgoing
47040996,2023-02-03,298.59,121.3,Outgoing
47040996,2023-02-04,397.10999999999996,98.52,Incoming
47040996,2023-02-07,486.84,89.73,Incoming
47040996,2023-02-09,563.4499999999999,76.61,Incoming
47040996,2023-02-12,555.79,7.66,Outgoing
47091705,2023-01-31,54.6,,-
47091705,2023-02-01,130.12,75.52,Incoming
47091705,2023-02-02,88.24000000000001,41.88,Outgoing
47091705,2023-02-02,176.53000000000003,88.29,Incoming
47091705,2023-02-03,243.91000000000003,67.38,Incoming
47091705,2023-02-04,148.31000000000003,95.6,Outgoing
47091705,2023-02-05,-1046.69,1195.0,Outgoing
47091705,2023-02-05,-904.4100000000001,142.28,Incoming
47091705,2023-02-06,-996.7,92.29,Outgoing
47091705,2023-02-09,-2336.8,1340.1,Outgoing
47091705,2023-02-14,-2432.9700000000003,96.17,Outgoing
47115177,2023-01-31,759.59,,-
47115177,2023-02-01,897.34,137.75,Incoming
47115177,2023-02-01,815.98,81.36,Outgoing
47115177,2023-02-04,705.98,110.0,Outgoing
47115177,2023-02-06,1233.38,527.4,Incoming
47115177,2023-02-09,1369.8600000000001,136.48,Incoming
47115177,2023-02-11,1248.91,120.95,Outgoing
47115177,2023-02-13,1083.8400000000001,165.07,Outgoing
47115177,2023-02-13,1011.7100000000002,72.13,Outgoing
47115177,2023-02-13,843.8900000000001,167.82,Outgoing
47115177,2023-02-14,720.4700000000001,123.42,Outgoing
47127756,2023-01-31,300.02,,-
47127756,2023-02-02,401.49,101.47,Incoming
47127756,2023-02-12,485.52,84.03,Incoming
47133143,2023-01-31,723.52,,-
47133143,2023-02-01,905.88,182.36,Incoming
47133143,2023-02-03,872.71,33.17,Outgoing
47133143,2023-02-07,930.1600000000001,57.45,Incoming
47133143,2023-02-13,961.2300000000001,31.07,Incoming
47133143,2023-02-14,1002.4800000000001,41.25,Incoming
47172665,2023-01-31,11.06,,-
47172665,2023-02-08,141.62,130.56,Incoming
47172665,2023-02-08,221.75,80.13,Incoming
47172665,2023-02-13,165.34,56.41,Outgoing
47172665,2023-02-13,190.93,25.59,Incoming
47172665,2023-02-14,55.31999999999999,135.61,Outgoing
47226769,2023-01-31,449.88,,-
47226769,2023-02-01,323.38,126.5,Outgoing
47226769,2023-02-04,456.31,132.93,Incoming
47226769,2023-02-06,582.13,125.82,Incoming
47226769,2023-02-06,-483.4699999999999,1065.6,Outgoing
47226769,2023-02-07,-652.5899999999999,169.12,Outgoing
47232232,2023-01-31,53.44,,-
47232232,2023-02-01,-72.96000000000001,126.4,Outgoing
47232232,2023-02-07,61.329999999999984,134.29,Incoming
47232232,2023-02-10,197.42999999999998,136.1,Incoming
47232232,2023-02-12,354.89,157.46,Incoming
47232232,2023-02-12,472.44,117.55,Incoming
47232232,2023-02-12,319.03,153.41,Outgoing
47266645,2023-01-31,207.15,,-
47266645,2023-02-02,397.83000000000004,190.68,Incoming
47266645,2023-02-02,-478.56999999999994,876.4,Outgoing
47266645,2023-02-06,-601.26,122.69,Outgoing
47266645,2023-02-07,-117.15999999999997,484.1,Incoming
47266645,2023-02-13,-255.55999999999997,138.4,Outgoing
47313428,2023-01-31,204.67,,-
47313428,2023-02-03,-760.73,965.4,Outgoing
47313428,2023-02-08,-647.4300000000001,113.3,Incoming
47313428,2023-02-13,-519.82,127.61,Incoming
47356348,2023-01-31,65.95,,-
47356348,2023-02-03,-1157.85,1223.8,Outgoing
47356348,2023-02-13,-1017.8699999999999,139.98,Incoming
47406737,2023-01-31,963.14,,-
47406737,2023-02-01,118.53999999999996,844.6,Outgoing
47406737,2023-02-03,187.14999999999998,68.61,Incoming
47406737,2023-02-06,1391.65,1204.5,Incoming
47406737,2023-02-08,1366.71,24.94,Outgoing
47406737,2023-02-09,1187.45,179.26,Outgoing
47406737,2023-02-09,1303.2,115.75,Incoming
47406737,2023-02-12,1250.74,52.46,Outgoing
47406737,2023-02-12,1122.13,128.61,Outgoing
47406737,2023-02-12,977.8100000000002,144.32,Outgoing
47406737,2023-02-14,1106.9900000000002,129.18,Incoming
47414258,2023-01-31,900.7,,-
47414258,2023-02-06,1024.0700000000002,123.37,Incoming
47414258,2023-02-06,1052.0100000000002,27.94,Incoming
47414258,2023-02-06,1236.0200000000002,184.01,Incoming
47414258,2023-02-07,2513.42,1277.4,Incoming
47414258,2023-02-08,2576.52,63.1,Incoming
47414258,2023-02-11,2467.6,108.92,Outgoing
47414258,2023-02-13,2602.18,134.58,Incoming
47473145,2023-01-31,801.43,,-
47473145,2023-02-12,836.5999999999999,35.17,Incoming
47473145,2023-02-12,704.1199999999999,132.48,Outgoing
47483982,2023-01-31,661.58,,-
47483982,2023-02-08,738.1800000000001,76.6,Incoming
47483982,2023-02-10,663.3100000000001,74.87,Outgoing
47483982,2023-02-11,504.23,159.08,Outgoing
47483982,2023-02-13,-513.37,1017.6,Outgoing
47582488,2023-01-31,744.99,,-
47582488,2023-02-02,869.6700000000001,124.68,Incoming
47582488,2023-02-03,925.48,55.81,Incoming
47582488,2023-02-05,1013.75,88.27,Incoming
47582488,2023-02-05,1124.47,110.72,Incoming
47582488,2023-02-05,1123.3600000000001,1.11,Outgoing
47582488,2023-02-06,1036.16,87.2,Outgoing
47582488,2023-02-07,921.4200000000001,114.74,Outgoing
47582488,2023-02-12,929.3900000000001,7.97,Incoming
47582488,2023-02-13,1030.7900000000002,101.4,Incoming
47654093,2023-01-31,294.0,,-
47654093,2023-02-04,357.26,63.26,Incoming
47654093,2023-02-05,195.45999999999998,161.8,Outgoing
47654093,2023-02-10,107.41999999999997,88.04,Outgoing
47654093,2023-02-12,298.88,191.46,Incoming
47654093,2023-02-12,189.07999999999998,109.8,Outgoing
47763906,2023-01-31,980.42,,-
47763906,2023-02-02,1167.61,187.19,Incoming
47763906,2023-02-02,1188.1799999999998,20.57,Incoming
47763906,2023-02-07,1088.62,99.56,Outgoing
47763906,2023-02-12,1080.6499999999999,7.97,Outgoing
47763906,2023-02-12,1291.0099999999998,210.36,Incoming
47781255,2023-01-31,462.62,,-
47781255,2023-02-02,541.23,78.61,Incoming
47781255,2023-02-02,566.1,24.87,Incoming
47781255,2023-02-02,433.1,133.0,Outgoing
47781255,2023-02-03,332.03000000000003,101.07,Outgoing
47781255,2023-02-05,399.98,67.95,Incoming
47781255,2023-02-08,336.08000000000004,63.9,Outgoing
47781255,2023-02-10,301.73,34.35,Outgoing
47781255,2023-02-14,177.25,124.48,Outgoing
47808992,2023-01-31,885.16,,-
47808992,2023-02-09,687.53,197.63,Outgoing
47808992,2023-02-10,581.3399999999999,106.19,Outgoing
47808992,2023-02-11,702.43,121.09,Incoming
47808992,2023-02-12,747.39,44.96,Incoming
47824990,2023-01-31,704.97,,-
47824990,2023-02-12,618.8000000000001,86.17,Outgoing
47824990,2023-02-13,504.8900000000001,113.91,Outgoing
47886866,2023-01-31,399.75,,-
47886866,2023-02-02,425.36,25.61,Incoming
47886866,2023-02-04,320.19,105.17,Outgoing
47886866,2023-02-07,430.98,110.79,Incoming
47886866,2023-02-10,379.16,51.82,Outgoing
47886866,2023-02-11,512.75,133.59,Incoming
47886866,2023-02-11,387.74,125.01,Outgoing
47886866,2023-02-14,420.54,32.8,Incoming
47902339,2023-01-31,919.92,,-
47902339,2023-02-05,985.17,65.25,Incoming
47902339,2023-02-06,1066.09,80.92,Incoming
47902339,2023-02-10,901.0699999999999,165.02,Outgoing
47932460,2023-01-31,785.05,,-
47932460,2023-02-01,884.4599999999999,99.41,Incoming
47932460,2023-02-04,679.5699999999999,204.89,Outgoing
47932460,2023-02-04,900.3399999999999,220.77,Incoming
47932460,2023-02-07,981.79,81.45,Incoming
47932460,2023-02-08,1106.77,124.98,Incoming
47932460,2023-02-09,1134.3,27.53,Incoming
47932460,2023-02-11,225.19999999999993,909.1,Outgoing
47964895,2023-01-31,982.97,,-
47964895,2023-02-04,1094.85,111.88,Incoming
47964895,2023-02-05,1279.6299999999999,184.78,Incoming
47964895,2023-02-07,1325.8999999999999,46.27,Incoming
47964895,2023-02-14,1435.36,109.46,Incoming
48018851,2023-01-31,288.26,,-
48018851,2023-02-05,-609.24,897.5,Outgoing
48018851,2023-02-07,-507.42,101.82,Incoming
48018851,2023-02-13,-593.1700000000001,85.75,Outgoing
48018851,2023-02-14,-737.74,144.57,Outgoing
48029032,2023-01-31,422.88,,-
48029032,2023-02-06,353.68,69.2,Outgoing
48029032,2023-02-06,325.75,27.93,Outgoing
48029032,2023-02-09,310.38,15.37,Outgoing
48029032,2023-02-09,478.57,168.19,Incoming
48029032,2023-02-09,380.51,98.06,Outgoing
48029032,2023-02-10,445.8,65.29,Incoming
48029032,2023-02-12,453.46000000000004,7.66,Incoming
48029032,2023-02-12,361.34000000000003,92.12,Outgoing
48029032,2023-02-13,219.14000000000004,142.2,Outgoing
48050578,2023-01-31,203.26,,-
48050578,2023-02-06,143.18,60.08,Outgoing
48050578,2023-02-07,41.290000000000006,101.89,Outgoing
48056301,2023-01-31,943.28,,-
48056301,2023-02-03,858.22,85.06,Outgoing
48056301,2023-02-03,956.46,98.24,Incoming
48056301,2023-02-13,1070.8500000000001,114.39,Incoming
48056301,2023-02-13,1018.0800000000002,52.77,Outgoing
48071843,2023-01-31,997.62,,-
48071843,2023-02-01,1385.52,387.9,Incoming
48071843,2023-02-02,1226.3,159.22,Outgoing
48071843,2023-02-09,3103.6,1877.3,Incoming
48075275,2023-01-31,881.31,,-
48075275,2023-02-01,980.06,98.75,Incoming
48075275,2023-02-01,1058.0,77.94,Incoming
48075275,2023-02-04,940.21,117.79,Outgoing
48075275,2023-02-09,854.4000000000001,85.81,Outgoing
48075275,2023-02-10,712.3300000000002,142.07,Outgoing
48075275,2023-02-14,1921.3300000000002,1209.0,Incoming
48081999,2023-01-31,290.89,,-
48081999,2023-02-02,194.82,96.07,Outgoing
48081999,2023-02-04,5.759999999999991,189.06,Outgoing
48081999,2023-02-05,-105.9,111.66,Outgoing
48081999,2023-02-06,-133.62,27.72,Outgoing
48081999,2023-02-11,-206.32,72.7,Outgoing
48081999,2023-02-11,-74.13,132.19,Incoming
48081999,2023-02-12,94.44,168.57,Incoming
48081999,2023-02-12,183.87,89.43,Incoming
48081999,2023-02-12,-1108.0300000000002,1291.9,Outgoing
48081999,2023-02-13,-1003.8500000000001,104.18,Incoming
48131431,2023-01-31,809.8,,-
48131431,2023-02-01,938.73,128.93,Incoming
48131431,2023-02-14,533.83,404.9,Outgoing
48185625,2023-01-31,822.11,,-
48185625,2023-02-02,896.6,74.49,Incoming
48185625,2023-02-03,1003.4,106.8,Incoming
48185625,2023-02-07,817.89,185.51,Outgoing
48185625,2023-02-13,916.79,98.9,Incoming
48186857,2023-01-31,518.26,,-
48186857,2023-02-03,372.94,145.32,Outgoing
48186857,2023-02-06,274.09000000000003,98.85,Outgoing
48186857,2023-02-09,176.47000000000003,97.62,Outgoing
48186857,2023-02-09,107.08000000000003,69.39,Outgoing
48186857,2023-02-12,-3.7099999999999795,110.79,Outgoing
48271608,2023-01-31,343.94,,-
48271608,2023-02-01,289.23,54.71,Outgoing
48271608,2023-02-03,124.67000000000002,164.56,Outgoing
48271608,2023-02-07,-15.449999999999989,140.12,Outgoing
48271608,2023-02-10,-70.82999999999998,55.38,Outgoing
48271608,2023-02-10,-118.22999999999999,47.4,Outgoing
48271608,2023-02-10,-7.109999999999985,111.12,Incoming
48271608,2023-02-13,-1672.51,1665.4,Outgoing
48271608,2023-02-14,-1825.66,153.15,Outgoing
48318402,2023-01-31,965.28,,-
48318402,2023-02-04,1009.9,44.62,Incoming
48318402,2023-02-04,1121.08,111.18,Incoming
48318402,2023-02-08,1217.48,96.4,Incoming
48318402,2023-02-09,1187.1200000000001,30.36,Outgoing
48318402,2023-02-14,1085.5300000000002,101.59,Outgoing
48350476,2023-01-31,305.2,,-
48350476,2023-02-02,343.94,38.74,Incoming
48350476,2023-02-02,248.84,95.1,Outgoing
48350476,2023-02-03,331.55,82.71,Incoming
48350476,2023-02-04,483.58000000000004,152.03,Incoming
48350476,2023-02-05,575.98,92.4,Incoming
48350476,2023-02-06,536.07,39.91,Outgoing
48350476,2023-02-10,593.71,57.64,Incoming
48350476,2023-02-10,379.88,213.83,Outgoing
48399121,2023-01-31,984.98,,-
48399121,2023-02-09,751.07,233.91,Outgoing
48399121,2023-02-14,855.71,104.64,Incoming
48429255,2023-01-31,79.7,,-
48429255,2023-02-06,190.60000000000002,110.9,Incoming
48429255,2023-02-11,91.24000000000002,99.36,Outgoing
48429255,2023-02-12,-36.949999999999974,128.19,Outgoing
48429255,2023-02-14,51.37000000000002,88.32,Incoming
48434572,2023-01-31,351.7,,-
48434572,2023-02-01,465.39,113.69,Incoming
48434572,2023-02-03,436.94,28.45,Outgoing
48434572,2023-02-04,364.52,72.42,Outgoing
48434572,2023-02-10,288.81,75.71,Outgoing
48434572,2023-02-11,-431.89000000000004,720.7,Outgoing
48434572,2023-02-12,-313.46000000000004,118.43,Incoming
48444386,2023-01-31,962.57,,-
48444386,2023-02-05,1054.3,91.73,Incoming
48444386,2023-02-06,960.05,94.25,Outgoing
48444386,2023-02-11,807.88,152.17,Outgoing
48444386,2023-02-14,734.52,73.36,Outgoing
48491614,2023-01-31,754.45,,-
48491614,2023-02-01,633.57,120.88,Outgoing
48491614,2023-02-06,1371.77,738.2,Incoming
48491614,2023-02-11,1377.96,6.19,Incoming
48500030,2023-01-31,917.05,,-
48500030,2023-02-09,1042.1799999999998,125.13,Incoming
48500030,2023-02-13,985.4999999999999,56.68,Outgoing
48500030,2023-02-14,1133.55,148.05,Incoming
48507357,2023-01-31,980.8,,-
48507357,2023-02-03,900.26,80.54,Outgoing
48507357,2023-02-06,980.3299999999999,80.07,Incoming
48507357,2023-02-11,1061.59,81.26,Incoming
48524535,2023-01-31,265.03,,-
48524535,2023-02-01,232.27999999999997,32.75,Outgoing
48524535,2023-02-02,182.10999999999996,50.17,Outgoing
48524535,2023-02-03,258.77,76.66,Incoming
48524535,2023-02-06,309.71999999999997,50.95,Incoming
48524535,2023-02-06,388.71,78.99,Incoming
48524535,2023-02-07,514.74,126.03,Incoming
48524535,2023-02-08,471.01,43.73,Outgoing
48524535,2023-02-08,536.86,65.85,Incoming
48524535,2023-02-10,608.3,71.44,Incoming
48524535,2023-02-11,632.4799999999999,24.18,Incoming
48524535,2023-02-14,682.8399999999999,50.36,Incoming
48524535,2023-02-14,562.2199999999999,120.62,Outgoing
48532894,2023-01-31,662.86,,-
48532894,2023-02-02,553.29,109.57,Outgoing
48532894,2023-02-03,474.13,79.16,Outgoing
48532894,2023-02-11,382.75,91.38,Outgoing
48532894,2023-02-14,-214.95000000000005,597.7,Outgoing
48553648,2023-01-31,80.62,,-
48553648,2023-02-02,202.85000000000002,122.23,Incoming
48553648,2023-02-05,214.93000000000004,12.08,Incoming
48553648,2023-02-13,125.83000000000004,89.1,Outgoing
48569537,2023-01-31,374.69,,-
48569537,2023-02-01,1527.69,1153.0,Incoming
48569537,2023-02-05,1705.77,178.08,Incoming
48569537,2023-02-07,1936.08,230.31,Incoming
48569537,2023-02-07,2109.87,173.79,Incoming
48569537,2023-02-09,1171.57,938.3,Outgoing
48569537,2023-02-10,1263.78,92.21,Incoming
48569537,2023-02-11,445.5799999999999,818.2,Outgoing
48569537,2023-02-13,491.7399999999999,46.16,Incoming
48569537,2023-02-14,441.3799999999999,50.36,Outgoing
48591774,2023-01-31,422.94,,-
48591774,2023-02-01,338.90999999999997,84.03,Outgoing
48591774,2023-02-03,430.88,91.97,Incoming
48591774,2023-02-08,284.45,146.43,Outgoing
48591774,2023-02-09,167.35,117.1,Outgoing
48591774,2023-02-10,257.68,90.33,Incoming
48591774,2023-02-10,379.35,121.67,Incoming
48591774,2023-02-14,519.09,139.74,Incoming
48625559,2023-01-31,797.88,,-
48625559,2023-02-03,709.86,88.02,Outgoing
48625559,2023-02-04,856.15,146.29,Incoming
48625559,2023-02-07,750.18,105.97,Outgoing
48625559,2023-02-08,603.0999999999999,147.08,Outgoing
48625559,2023-02-08,733.0899999999999,129.99,Incoming
48625559,2023-02-09,688.8999999999999,44.19,Outgoing
48625559,2023-02-10,782.7699999999999,93.87,Incoming
48625559,2023-02-11,594.9699999999998,187.8,Outgoing
48625559,2023-02-12,509.6999999999998,85.27,Outgoing
48625559,2023-02-14,563.4199999999998,53.72,Incoming
48654969,2023-01-31,83.93,,-
48654969,2023-02-03,40.620000000000005,43.31,Outgoing
48654969,2023-02-08,159.78,119.16,Incoming
48654969,2023-02-10,-791.4200000000001,951.2,Outgoing
48654969,2023-02-10,-1538.72,747.3,Outgoing
48722022,2023-01-31,586.44,,-
48722022,2023-02-01,462.4800000000001,123.96,Outgoing
48722022,2023-02-05,507.5800000000001,45.1,Incoming
48722022,2023-02-07,359.30000000000007,148.28,Outgoing
48722022,2023-02-12,265.88000000000005,93.42,Outgoing
48722022,2023-02-12,327.31000000000006,61.43,Incoming
48733708,2023-01-31,370.74,,-
48733708,2023-02-01,431.67,60.93,Incoming
48733708,2023-02-01,644.29,212.62,Incoming
48733708,2023-02-02,637.8199999999999,6.47,Outgoing
48733708,2023-02-03,550.17,87.65,Outgoing
48733708,2023-02-04,544.63,5.54,Outgoing
48733708,2023-02-05,662.91,118.28,Incoming
48733708,2023-02-08,768.67,105.76,Incoming
48733708,2023-02-09,645.39,123.28,Outgoing
48757991,2023-01-31,676.6,,-
48757991,2023-02-01,535.0,141.6,Outgoing
48757991,2023-02-07,398.03,136.97,Outgoing
48757991,2023-02-11,311.04999999999995,86.98,Outgoing
48781678,2023-01-31,401.55,,-
48781678,2023-02-01,1258.05,856.5,Incoming
48781678,2023-02-05,1107.32,150.73,Outgoing
48783408,2023-01-31,278.34,,-
48783408,2023-02-03,137.97999999999996,140.36,Outgoing
48783408,2023-02-04,36.22999999999996,101.75,Outgoing
48783408,2023-02-07,-149.24000000000004,185.47,Outgoing
48783408,2023-02-08,-254.77000000000004,105.53,Outgoing
48783408,2023-02-09,-417.97,163.2,Outgoing
48783408,2023-02-11,-505.6,87.63,Outgoing
48799650,2023-01-31,160.75,,-
48799650,2023-02-01,77.4,83.35,Outgoing
48799650,2023-02-08,232.33,154.93,Incoming
48831634,2023-01-31,146.94,,-
48831634,2023-02-04,1740.74,1593.8,Incoming
48831634,2023-02-04,1831.65,90.91,Incoming
48831634,2023-02-06,1690.27,141.38,Outgoing
48831634,2023-02-09,1620.6299999999999,69.64,Outgoing
48831634,2023-02-09,1528.78,91.85,Outgoing
48831634,2023-02-11,1632.71,103.93,Incoming
48831634,2023-02-11,2875.71,1243.0,Incoming
48831634,2023-02-13,3024.45,148.74,Incoming
48831634,2023-02-13,2988.99,35.46,Outgoing
48860469,2023-01-31,730.37,,-
48860469,2023-02-01,896.85,166.48,Incoming
48860469,2023-02-07,701.3,195.55,Outgoing
48860469,2023-02-08,804.67,103.37,Incoming
48860469,2023-02-08,860.24,55.57,Incoming
48860469,2023-02-10,1027.37,167.13,Incoming
48875351,2023-01-31,239.7,,-
48875351,2023-02-12,139.45,100.25,Outgoing
48886521,2023-01-31,827.29,,-
48886521,2023-02-01,693.23,134.06,Outgoing
48886521,2023-02-03,594.79,98.44,Outgoing
48886521,2023-02-04,410.40999999999997,184.38,Outgoing
48886521,2023-02-05,512.01,101.6,Incoming
48886521,2023-02-08,478.37,33.64,Outgoing
48906756,2023-01-31,996.87,,-
48906756,2023-02-02,1031.43,34.56,Incoming
48906756,2023-02-02,994.83,36.6,Outgoing
48906756,2023-02-05,357.5300000000001,637.3,Outgoing
48906756,2023-02-09,587.3800000000001,229.85,Incoming
48911149,2023-01-31,580.54,,-
48911149,2023-02-05,435.90999999999997,144.63,Outgoing
48911149,2023-02-09,353.83,82.08,Outgoing
48911149,2023-02-11,871.9300000000001,518.1,Incoming
48930319,2023-01-31,595.65,,-
48930319,2023-02-01,428.12,167.53,Outgoing
48930319,2023-02-04,352.06,76.06,Outgoing
48930319,2023-02-05,529.51,177.45,Incoming
48930319,2023-02-05,598.04,68.53,Incoming
48930319,2023-02-08,574.4499999999999,23.59,Outgoing
48930319,2023-02-12,523.4,51.05,Outgoing
48940493,2023-01-31,394.19,,-
48940493,2023-02-02,416.83,22.64,Incoming
48940493,2023-02-02,199.32,217.51,Outgoing
48940493,2023-02-04,108.88,90.44,Outgoing
48940493,2023-02-04,-16.85000000000001,125.73,Outgoing
48940493,2023-02-05,-233.25,216.4,Outgoing
48940493,2023-02-05,-407.95,174.7,Outgoing
48940493,2023-02-07,-301.31,106.64,Incoming
48940493,2023-02-08,665.99,967.3,Incoming
48940493,2023-02-08,516.6800000000001,149.31,Outgoing
48940493,2023-02-08,583.25,66.57,Incoming
48940493,2023-02-12,-387.54999999999995,970.8,Outgoing
48940493,2023-02-12,-212.22999999999996,175.32,Incoming
48976336,2023-01-31,400.12,,-
48976336,2023-02-01,2427.82,2027.7,Incoming
48976336,2023-02-03,2487.02,59.2,Incoming
48976336,2023-02-06,2428.85,58.17,Outgoing
48976336,2023-02-07,2647.63,218.78,Incoming
48976336,2023-02-08,2738.87,91.24,Incoming
48976336,2023-02-10,2621.31,117.56,Outgoing
49031081,2023-01-31,788.18,,-
49031081,2023-02-02,656.3799999999999,131.8,Outgoing
49031081,2023-02-03,528.7999999999998,127.58,Outgoing
49031081,2023-02-04,625.8499999999998,97.05,Incoming
49031081,2023-02-08,549.0399999999997,76.81,Outgoing
49031081,2023-02-09,643.8499999999997,94.81,Incoming
49031081,2023-02-10,562.5899999999997,81.26,Outgoing
49031081,2023-02-10,428.3499999999997,134.24,Outgoing
49031081,2023-02-12,566.1799999999997,137.83,Incoming
49031081,2023-02-14,624.7699999999998,58.59,Incoming
49031379,2023-01-31,373.63,,-
49031379,2023-02-01,306.62,67.01,Outgoing
49031379,2023-02-03,171.18,135.44,Outgoing
49031379,2023-02-03,74.67,96.51,Outgoing
49031379,2023-02-07,28.53,46.14,Outgoing
49031379,2023-02-08,148.01,119.48,Incoming
49031379,2023-02-10,277.7,129.69,Incoming
49039474,2023-01-31,574.7,,-
49039474,2023-02-01,485.14000000000004,89.56,Outgoing
49039474,2023-02-03,341.72,143.42,Outgoing
49039474,2023-02-04,284.97,56.75,Outgoing
49039474,2023-02-05,1453.3700000000001,1168.4,Incoming
49039474,2023-02-07,1428.96,24.41,Outgoing
49039474,2023-02-11,3243.96,1815.0,Incoming
49071892,2023-01-31,909.58,,-
49071892,2023-02-04,777.46,132.12,Outgoing
49071892,2023-02-04,873.22,95.76,Incoming
49071892,2023-02-06,822.44,50.78,Outgoing
49071892,2023-02-08,709.1400000000001,113.3,Outgoing
49071892,2023-02-09,802.3200000000002,93.18,Incoming
49071892,2023-02-10,944.1500000000002,141.83,Incoming
49075324,2023-01-31,301.39,,-
49075324,2023-02-03,341.94,40.55,Incoming
49075324,2023-02-03,1058.54,716.6,Incoming
49075324,2023-02-06,985.14,73.4,Outgoing
49075324,2023-02-10,930.06,55.08,Outgoing
49095464,2023-01-31,1.3,,-
49095464,2023-02-01,-90.36,91.66,Outgoing
49095464,2023-02-01,56.02999999999999,146.39,Incoming
49095464,2023-02-06,205.44,149.41,Incoming
49095464,2023-02-06,374.03,168.59,Incoming
49095464,2023-02-11,529.8399999999999,155.81,Incoming
49095464,2023-02-11,486.7199999999999,43.12,Outgoing
49095464,2023-02-12,626.9399999999999,140.22,Incoming
49095464,2023-02-13,486.63999999999993,140.3,Outgoing
49095464,2023-02-13,367.6099999999999,119.03,Outgoing
49095464,2023-02-13,1605.01,1237.4,Incoming
49127699,2023-01-31,155.53,,-
49127699,2023-02-01,71.9,83.63,Outgoing
49127699,2023-02-07,-17.409999999999997,89.31,Outgoing
49127699,2023-02-08,-128.19,110.78,Outgoing
49127699,2023-02-08,-5.539999999999992,122.65,Incoming
49127699,2023-02-09,-114.07,108.53,Outgoing
49127699,2023-02-11,16.120000000000005,130.19,Incoming
49157903,2023-01-31,601.62,,-
49157903,2023-02-03,1595.3200000000002,993.7,Incoming
49157903,2023-02-05,1420.2700000000002,175.05,Outgoing
49157903,2023-02-06,1523.3500000000001,103.08,Incoming
49157903,2023-02-12,1429.19,94.16,Outgoing
49172838,2023-01-31,136.96,,-
49172838,2023-02-03,250.64000000000001,113.68,Incoming
49172838,2023-02-10,225.79000000000002,24.85,Outgoing
49172838,2023-02-11,322.26,96.47,Incoming
49172838,2023-02-13,-1223.24,1545.5,Outgoing
49172838,2023-02-14,-1364.72,141.48,Outgoing
49186099,2023-01-31,208.24,,-
49186099,2023-02-01,118.17000000000002,90.07,Outgoing
49186099,2023-02-01,-0.06999999999997897,118.24,Outgoing
49186099,2023-02-04,-92.33999999999997,92.27,Outgoing
49216581,2023-01-31,911.91,,-
49216581,2023-02-01,1666.81,754.9,Incoming
49216581,2023-02-07,519.4099999999999,1147.4,Outgoing
49216581,2023-02-10,2331.91,1812.5,Incoming
49216581,2023-02-13,2901.5099999999998,569.6,Incoming
49216581,2023-02-13,3028.7,127.19,Incoming
49216581,2023-02-13,2889.7599999999998,138.94,Outgoing
49253709,2023-01-31,473.46,,-
49253709,2023-02-01,408.44,65.02,Outgoing
49253709,2023-02-01,529.3199999999999,120.88,Incoming
49253709,2023-02-03,394.94999999999993,134.37,Outgoing
49253709,2023-02-04,265.78999999999996,129.16,Outgoing
49253709,2023-02-04,158.00999999999996,107.78,Outgoing
49253709,2023-02-05,367.4599999999999,209.45,Incoming
49253709,2023-02-07,238.16999999999993,129.29,Outgoing
49253709,2023-02-12,325.49999999999994,87.33,Incoming
49253709,2023-02-12,174.12999999999994,151.37,Outgoing
49253709,2023-02-12,226.93999999999994,52.81,Incoming
49253709,2023-02-13,336.2699999999999,109.33,Incoming
49310474,2023-01-31,929.16,,-
49310474,2023-02-01,1013.8399999999999,84.68,Incoming
49310474,2023-02-01,882.5699999999999,131.27,Outgoing
49310474,2023-02-06,962.02,79.45,Incoming
49310474,2023-02-07,1011.8299999999999,49.81,Incoming
49310474,2023-02-07,887.3199999999999,124.51,Outgoing
49310474,2023-02-13,721.5,165.82,Outgoing
49310474,2023-02-14,688.54,32.96,Outgoing
49310474,2023-02-14,777.31,88.77,Incoming
49400211,2023-01-31,460.24,,-
49400211,2023-02-01,247.62,212.62,Outgoing
49400211,2023-02-02,91.70000000000002,155.92,Outgoing
49400211,2023-02-08,-100.79999999999998,192.5,Outgoing
49400211,2023-02-09,-168.13,67.33,Outgoing
49400211,2023-02-10,-65.39,102.74,Incoming
49410021,2023-01-31,508.72,,-
49410021,2023-02-01,396.20000000000005,112.52,Outgoing
49410021,2023-02-06,517.8000000000001,121.6,Incoming
49410021,2023-02-12,647.25,129.45,Incoming
49410021,2023-02-14,719.86,72.61,Incoming
49427302,2023-01-31,468.73,,-
49427302,2023-02-03,389.36,79.37,Outgoing
49427302,2023-02-04,465.53000000000003,76.17,Incoming
49427302,2023-02-06,558.69,93.16,Incoming
49427302,2023-02-06,-486.71000000000004,1045.4,Outgoing
49427302,2023-02-07,-537.82,51.11,Outgoing
49427302,2023-02-08,-619.1600000000001,81.34,Outgoing
49427302,2023-02-11,-506.9200000000001,112.24,Incoming
49427302,2023-02-12,-556.33,49.41,Outgoing
49441522,2023-01-31,75.3,,-
49441522,2023-02-01,-84.33999999999999,159.64,Outgoing
49441522,2023-02-02,48.3,132.64,Incoming
49441522,2023-02-03,-135.14,183.44,Outgoing
49441522,2023-02-09,-170.16,35.02,Outgoing
49441522,2023-02-10,-181.12,10.96,Outgoing
49441522,2023-02-11,-29.00999999999999,152.11,Incoming
49454023,2023-01-31,798.72,,-
49454023,2023-02-01,17.82000000000005,780.9,Outgoing
49454023,2023-02-02,141.77000000000004,123.95,Incoming
49454023,2023-02-02,234.38000000000005,92.61,Incoming
49454023,2023-02-02,284.55000000000007,50.17,Incoming
49454023,2023-02-03,173.31000000000006,111.24,Outgoing
49454023,2023-02-06,17.430000000000064,155.88,Outgoing
49454023,2023-02-07,-1052.6699999999998,1070.1,Outgoing
49454023,2023-02-08,-300.76999999999987,751.9,Incoming
49454023,2023-02-10,-213.98999999999987,86.78,Incoming
49454023,2023-02-12,-271.4899999999999,57.5,Outgoing
49459559,2023-01-31,467.56,,-
49459559,2023-02-07,-340.54,808.1,Outgoing
49459559,2023-02-11,-244.38000000000002,96.16,Incoming
49459559,2023-02-12,-100.22000000000003,144.16,Incoming
49459559,2023-02-13,7.32999999999997,107.55,Incoming
49459559,2023-02-14,-61.23000000000003,68.56,Outgoing
49467252,2023-01-31,444.92,,-
49467252,2023-02-04,380.49,64.43,Outgoing
49467252,2023-02-05,321.34000000000003,59.15,Outgoing
49467252,2023-02-06,373.12,51.78,Incoming
49467252,2023-02-10,390.3,17.18,Incoming
49516533,2023-01-31,7.4,,-
49516533,2023-02-02,72.93,65.53,Incoming
49516533,2023-02-02,138.86,65.93,Incoming
49516533,2023-02-04,717.46,578.6,Incoming
49516533,2023-02-05,655.62,61.84,Outgoing
49516533,2023-02-07,613.58,42.04,Outgoing
49516533,2023-02-08,755.44,141.86,Incoming
49516533,2023-02-09,861.73,106.29,Incoming
49516533,2023-02-11,674.2,187.53,Outgoing
49516533,2023-02-11,695.19,20.99,Incoming
49516533,2023-02-13,1883.5900000000001,1188.4,Incoming
49520335,2023-01-31,198.79,,-
49520335,2023-02-01,121.00999999999999,77.78,Outgoing
49520335,2023-02-03,225.63,104.62,Incoming
49520335,2023-02-08,240.47,14.84,Incoming
49520335,2023-02-10,-1555.43,1795.9,Outgoing
49520335,2023-02-12,-1643.63,88.2,Outgoing
49520335,2023-02-14,-1554.96,88.67,Incoming
49533543,2023-01-31,190.64,,-
49533543,2023-02-04,355.02,164.38,Incoming
49533543,2023-02-04,400.04999999999995,45.03,Incoming
49533543,2023-02-05,1386.75,986.7,Incoming
49533543,2023-02-11,1329.64,57.11,Outgoing
49533543,2023-02-11,1407.41,77.77,Incoming
49533543,2023-02-11,1546.6100000000001,139.2,Incoming
49534905,2023-01-31,383.91,,-
49534905,2023-02-07,277.81000000000006,106.1,Outgoing
49536707,2023-01-31,37.3,,-
49536707,2023-02-01,174.05,136.75,Incoming
49536707,2023-02-02,279.03000000000003,104.98,Incoming
49536707,2023-02-03,399.89000000000004,120.86,Incoming
49536707,2023-02-03,572.9000000000001,173.01,Incoming
49536707,2023-02-05,425.5300000000001,147.37,Outgoing
49536707,2023-02-08,389.7200000000001,35.81,Outgoing
49536707,2023-02-11,502.9200000000001,113.2,Incoming
49536707,2023-02-14,604.6100000000001,101.69,Incoming
49536707,2023-02-14,725.4400000000002,120.83,Incoming
49536707,2023-02-14,954.3100000000002,228.87,Incoming
49540328,2023-01-31,458.12,,-
49540328,2023-02-02,556.23,98.11,Incoming
49540328,2023-02-04,678.4200000000001,122.19,Incoming
49540328,2023-02-05,771.45,93.03,Incoming
49540328,2023-02-09,660.94,110.51,Outgoing
49540328,2023-02-13,833.48,172.54,Incoming
49550154,2023-01-31,178.14,,-
49550154,2023-02-01,300.84,122.7,Incoming
49550154,2023-02-05,224.79999999999995,76.04,Outgoing
49550154,2023-02-08,303.9599999999999,79.16,Incoming
49550154,2023-02-08,367.3699999999999,63.41,Incoming
49550154,2023-02-10,547.3199999999999,179.95,Incoming
49550154,2023-02-13,395.55999999999995,151.76,Outgoing
49550154,2023-02-14,229.17999999999995,166.38,Outgoing
49581833,2023-01-31,117.56,,-
49581833,2023-02-01,169.56,52.0,Incoming
49581833,2023-02-02,355.3,185.74,Incoming
49581833,2023-02-02,1995.5,1640.2,Incoming
49581833,2023-02-04,2052.25,56.75,Incoming
49581833,2023-02-13,1038.85,1013.4,Outgoing
49581833,2023-02-14,1177.56,138.71,Incoming
49696722,2023-01-31,142.69,,-
49696722,2023-02-02,-10.77000000000001,153.46,Outgoing
49696722,2023-02-04,77.38,88.15,Incoming
49696722,2023-02-07,204.75,127.37,Incoming
49696722,2023-02-11,77.82,126.93,Outgoing
49696722,2023-02-13,122.02,44.2,Incoming
49696722,2023-02-13,-1169.38,1291.4,Outgoing
49834565,2023-01-31,51.12,,-
49834565,2023-02-03,-21.32,72.44,Outgoing
49834565,2023-02-12,55.61000000000001,76.93,Incoming
49840526,2023-01-31,461.64,,-
49840526,2023-02-03,365.93,95.71,Outgoing
49840526,2023-02-05,566.7,200.77,Incoming
49840526,2023-02-08,-2024.9999999999998,2591.7,Outgoing
49840526,2023-02-09,-2193.6499999999996,168.65,Outgoing
49840526,2023-02-09,-2135.2599999999998,58.39,Incoming
49840526,2023-02-09,-2365.1099999999997,229.85,Outgoing
49840526,2023-02-09,-3896.0099999999998,1530.9,Outgoing
49840526,2023-02-10,-4003.5699999999997,107.56,Outgoing
49941860,2023-01-31,655.66,,-
49941860,2023-02-01,594.73,60.93,Outgoing
49941860,2023-02-03,527.83,66.9,Outgoing
49941860,2023-02-08,562.76,34.93,Incoming
49961732,2023-01-31,673.71,,-
49961732,2023-02-01,624.23,49.48,Outgoing
49961732,2023-02-01,525.1700000000001,99.06,Outgoing
49961732,2023-02-08,658.71,133.54,Incoming
49961732,2023-02-08,610.7,48.01,Outgoing
49961732,2023-02-09,587.7700000000001,22.93,Outgoing
49961732,2023-02-11,480.2600000000001,107.51,Outgoing
49961732,2023-02-11,548.4000000000001,68.14,Incoming
49966528,2023-01-31,641.18,,-
49966528,2023-02-01,507.89,133.29,Outgoing
49966528,2023-02-03,600.62,92.73,Incoming
49966528,2023-02-04,716.16,115.54,Incoming
49966528,2023-02-05,539.79,176.37,Outgoing
49966528,2023-02-06,387.35999999999996,152.43,Outgoing
49966528,2023-02-06,548.48,161.12,Incoming
49966528,2023-02-07,368.20000000000005,180.28,Outgoing
49966528,2023-02-09,252.70000000000005,115.5,Outgoing
49966528,2023-02-12,138.67000000000004,114.03,Outgoing
50018070,2023-01-31,450.64,,-
50018070,2023-02-03,1106.94,656.3,Incoming
50018070,2023-02-05,994.01,112.93,Outgoing
50018070,2023-02-08,1086.26,92.25,Incoming
50018070,2023-02-10,1176.56,90.3,Incoming
50024545,2023-01-31,867.21,,-
50024545,2023-02-03,782.4200000000001,84.79,Outgoing
50024545,2023-02-07,895.5500000000001,113.13,Incoming
50024545,2023-02-07,1500.75,605.2,Incoming
50024545,2023-02-09,1320.71,180.04,Outgoing
50024545,2023-02-11,1442.9,122.19,Incoming
50024545,2023-02-11,3176.5,1733.6,Incoming
50024545,2023-02-13,3248.2,71.7,Incoming
50024545,2023-02-13,3285.6699999999996,37.47,Incoming
50031425,2023-01-31,695.18,,-
50031425,2023-02-03,201.67999999999995,493.5,Outgoing
50031425,2023-02-03,86.51999999999995,115.16,Outgoing
50031425,2023-02-07,-38.04000000000005,124.56,Outgoing
50031425,2023-02-10,-218.05000000000004,180.01,Outgoing
50031425,2023-02-12,-93.46000000000004,124.59,Incoming
50031425,2023-02-14,-135.49000000000004,42.03,Outgoing
50114041,2023-01-31,60.83,,-
50114041,2023-02-06,213.26,152.43,Incoming
50115324,2023-01-31,329.32,,-
50115324,2023-02-01,248.45999999999998,80.86,Outgoing
50115324,2023-02-03,378.99,130.53,Incoming
50115324,2023-02-03,332.14,46.85,Outgoing
50115324,2023-02-08,211.58999999999997,120.55,Outgoing
50115324,2023-02-12,40.87999999999997,170.71,Outgoing
50115324,2023-02-13,854.38,813.5,Incoming
50115324,2023-02-13,984.56,130.18,Incoming
50115324,2023-02-13,950.78,33.78,Outgoing
50122119,2023-01-31,264.61,,-
50122119,2023-02-01,-509.99,774.6,Outgoing
50122119,2023-02-03,-476.82,33.17,Incoming
50122119,2023-02-12,493.97999999999996,970.8,Incoming
50122119,2023-02-12,474.98999999999995,18.99,Outgoing
50132654,2023-01-31,562.17,,-
50132654,2023-02-02,384.66999999999996,177.5,Outgoing
50132654,2023-02-04,482.51,97.84,Incoming
50132654,2023-02-05,313.77,168.74,Outgoing
50132654,2023-02-07,224.90999999999997,88.86,Outgoing
50132654,2023-02-08,161.80999999999997,63.1,Outgoing
50132654,2023-02-09,250.89,89.08,Incoming
50132654,2023-02-12,133.40999999999997,117.48,Outgoing
50132654,2023-02-14,221.50999999999996,88.1,Incoming
50150279,2023-01-31,567.24,,-
50150279,2023-02-05,641.76,74.52,Incoming
50150279,2023-02-06,535.23,106.53,Outgoing
50150279,2023-02-09,472.31,62.92,Outgoing
50161801,2023-01-31,180.69,,-
50161801,2023-02-02,5.939999999999998,174.75,Outgoing
50161801,2023-02-02,-94.52,100.46,Outgoing
50161801,2023-02-03,-202.61,108.09,Outgoing
50161801,2023-02-03,-374.85,172.24,Outgoing
50161801,2023-02-03,-464.36,89.51,Outgoing
50161801,2023-02-07,-577.79,113.43,Outgoing
50161801,2023-02-08,-656.77,78.98,Outgoing
50161801,2023-02-09,-468.46999999999997,188.3,Incoming
50161801,2023-02-10,-612.5699999999999,144.1,Outgoing
50161801,2023-02-11,-717.8399999999999,105.27,Outgoing
50161801,2023-02-14,-2391.84,1674.0,Outgoing
50217872,2023-01-31,667.95,,-
50217872,2023-02-02,602.02,65.93,Outgoing
50217872,2023-02-03,1227.52,625.5,Incoming
50217872,2023-02-07,1298.1399999999999,70.62,Incoming
50217872,2023-02-08,1418.4499999999998,120.31,Incoming
50217872,2023-02-10,1481.7699999999998,63.32,Incoming
50217872,2023-02-11,1342.6999999999998,139.07,Outgoing
50217872,2023-02-11,1390.0199999999998,47.32,Incoming
50217872,2023-02-13,1509.0499999999997,119.03,Incoming
50217872,2023-02-14,773.5499999999997,735.5,Outgoing
50219545,2023-01-31,548.12,,-
50219545,2023-02-01,-509.58000000000004,1057.7,Outgoing
50219545,2023-02-06,-458.91,50.67,Incoming
50219545,2023-02-07,-583.33,124.42,Outgoing
50219545,2023-02-11,234.87,818.2,Incoming
50219545,2023-02-14,-974.13,1209.0,Outgoing
50231864,2023-01-31,117.34,,-
50231864,2023-02-02,245.70000000000002,128.36,Incoming
50231864,2023-02-02,109.75000000000003,135.95,Outgoing
50231864,2023-02-04,244.21000000000004,134.46,Incoming
50231864,2023-02-07,214.42000000000004,29.79,Outgoing
50231864,2023-02-07,63.85000000000005,150.57,Outgoing
50231864,2023-02-10,-84.18999999999994,148.04,Outgoing
50231864,2023-02-14,-262.2299999999999,178.04,Outgoing
50276595,2023-01-31,686.91,,-
50276595,2023-02-01,789.51,102.6,Incoming
50276595,2023-02-03,877.84,88.33,Incoming
50276595,2023-02-03,976.25,98.41,Incoming
50276595,2023-02-04,889.35,86.9,Outgoing
50276595,2023-02-06,-218.55000000000007,1107.9,Outgoing
50276595,2023-02-11,-71.60000000000008,146.95,Incoming
50276595,2023-02-11,9.599999999999923,81.2,Incoming
50276595,2023-02-11,-78.56000000000007,88.16,Outgoing
50276595,2023-02-12,-22.710000000000072,55.85,Incoming
50324230,2023-01-31,945.15,,-
50324230,2023-02-05,1009.66,64.51,Incoming
50324230,2023-02-05,1154.79,145.13,Incoming
50324230,2023-02-07,2535.29,1380.5,Incoming
50324230,2023-02-09,2630.93,95.64,Incoming
50335174,2023-01-31,650.98,,-
50335174,2023-02-05,750.22,99.24,Incoming
50335174,2023-02-09,573.38,176.84,Outgoing
50335174,2023-02-09,415.59000000000003,157.79,Outgoing
50335174,2023-02-11,221.21000000000004,194.38,Outgoing
50335174,2023-02-14,206.23000000000005,14.98,Outgoing
50360111,2023-01-31,193.83,,-
50360111,2023-02-02,152.89000000000001,40.94,Outgoing
50360111,2023-02-05,-30.19999999999999,183.09,Outgoing
50360111,2023-02-12,-56.78999999999999,26.59,Outgoing
50402197,2023-01-31,717.07,,-
50402197,2023-02-01,1186.67,469.6,Incoming
50402197,2023-02-01,1251.69,65.02,Incoming
50402197,2023-02-02,2214.49,962.8,Incoming
50402197,2023-02-05,2139.43,75.06,Outgoing
50402197,2023-02-05,2069.5,69.93,Outgoing
50402197,2023-02-11,1901.94,167.56,Outgoing
50402197,2023-02-11,1835.55,66.39,Outgoing
50402197,2023-02-12,1944.6299999999999,109.08,Incoming
50428641,2023-01-31,271.51,,-
50428641,2023-02-05,373.89,102.38,Incoming
50428641,2023-02-07,311.03999999999996,62.85,Outgoing
50428641,2023-02-07,430.21999999999997,119.18,Incoming
50428641,2023-02-09,556.68,126.46,Incoming
50428641,2023-02-10,369.97999999999996,186.7,Outgoing
50428641,2023-02-13,268.77,101.21,Outgoing
50463777,2023-01-31,143.45,,-
50463777,2023-02-04,227.39999999999998,83.95,Incoming
50463777,2023-02-08,162.52999999999997,64.87,Outgoing
50463777,2023-02-09,253.32,90.79,Incoming
50463777,2023-02-13,334.22,80.9,Incoming
50463777,2023-02-14,484.55000000000007,150.33,Incoming
50463777,2023-02-14,639.1300000000001,154.58,Incoming
50463777,2023-02-14,712.8400000000001,73.71,Incoming
50520009,2023-01-31,892.55,,-
50520009,2023-02-04,960.65,68.1,Incoming
50520009,2023-02-06,1097.26,136.61,Incoming
50520009,2023-02-08,-711.1400000000001,1808.4,Outgoing
50520009,2023-02-12,-642.2500000000001,68.89,Incoming
50520009,2023-02-13,-787.3500000000001,145.1,Outgoing
50520009,2023-02-14,-925.0800000000002,137.73,Outgoing
50547726,2023-01-31,675.06,,-
50547726,2023-02-04,628.93,46.13,Outgoing
50547726,2023-02-04,485.04999999999995,143.88,Outgoing
50547726,2023-02-07,1555.1499999999999,1070.1,Incoming
50547726,2023-02-08,1676.87,121.72,Incoming
50547726,2023-02-10,1783.06,106.19,Incoming
50547726,2023-02-11,1915.82,132.76,Incoming
50610780,2023-01-31,536.41,,-
50610780,2023-02-02,402.81999999999994,133.59,Outgoing
50610780,2023-02-02,569.17,166.35,Incoming
50610780,2023-02-05,2681.9700000000003,2112.8,Incoming
50610780,2023-02-06,3118.07,436.1,Incoming
50610780,2023-02-07,2380.67,737.4,Outgoing
50610780,2023-02-08,2632.57,251.9,Incoming
50610780,2023-02-10,2760.28,127.71,Incoming
50610780,2023-02-12,2678.75,81.53,Outgoing
50610780,2023-02-13,2589.33,89.42,Outgoing
50624960,2023-01-31,5.03,,-
50624960,2023-02-04,31.790000000000003,26.76,Incoming
50624960,2023-02-11,-127.3,159.09,Outgoing
50624960,2023-02-11,-7.429999999999993,119.87,Incoming
50624960,2023-02-12,106.29,113.72,Incoming
50624960,2023-02-13,232.75,126.46,Incoming
50624960,2023-02-13,64.99000000000001,167.76,Outgoing
50627436,2023-01-31,183.41,,-
50627436,2023-02-02,152.89,30.52,Outgoing
50627436,2023-02-04,104.48999999999998,48.4,Outgoing
50627436,2023-02-05,207.84999999999997,103.36,Incoming
50627436,2023-02-07,145.49999999999997,62.35,Outgoing
50627436,2023-02-07,-1.0000000000000284,146.5,Outgoing
50627436,2023-02-08,161.58999999999997,162.59,Incoming
50627436,2023-02-08,-311.61,473.2,Outgoing
50627436,2023-02-09,-197.79000000000002,113.82,Incoming
50627436,2023-02-10,-107.06000000000002,90.73,Incoming
50627436,2023-02-14,-212.09000000000003,105.03,Outgoing
50647892,2023-01-31,540.71,,-
50647892,2023-02-03,419.13000000000005,121.58,Outgoing
50647892,2023-02-04,599.4200000000001,180.29,Incoming
50647892,2023-02-05,387.21000000000004,212.21,Outgoing
50647892,2023-02-05,291.23,95.98,Outgoing
50647892,2023-02-05,267.35,23.88,Outgoing
50647892,2023-02-06,146.57000000000002,120.78,Outgoing
50647892,2023-02-10,51.73000000000002,94.84,Outgoing
50693024,2023-01-31,171.87,,-
50693024,2023-02-02,24.159999999999997,147.71,Outgoing
50693024,2023-02-05,124.49,100.33,Incoming
50693024,2023-02-09,9.39,115.1,Outgoing
50693024,2023-02-09,64.31,54.92,Incoming
50693024,2023-02-10,163.07,98.76,Incoming
50693024,2023-02-13,127.6,35.47,Outgoing
50693024,2023-02-14,-12.219999999999999,139.82,Outgoing
50756739,2023-01-31,177.65,,-
50756739,2023-02-02,98.35000000000001,79.3,Outgoing
50756739,2023-02-06,257.39,159.04,Incoming
50756739,2023-02-07,178.65999999999997,78.73,Outgoing
50756739,2023-02-07,84.38999999999997,94.27,Outgoing
50756739,2023-02-09,-82.86000000000003,167.25,Outgoing
50756739,2023-02-12,-103.07000000000002,20.21,Outgoing
50756739,2023-02-13,-128.73000000000002,25.66,Outgoing
50756739,2023-02-13,-234.81,106.08,Outgoing
50772829,2023-01-31,47.57,,-
50772829,2023-02-10,-68.16999999999999,115.74,Outgoing
50772829,2023-02-11,-5.1599999999999895,63.01,Incoming
50772829,2023-02-12,1273.74,1278.9,Incoming
50772829,2023-02-12,1073.7,200.04,Outgoing
50772829,2023-02-12,996.86,76.84,Outgoing
50772829,2023-02-13,916.94,79.92,Outgoing
50772829,2023-02-13,850.44,66.5,Outgoing
50772829,2023-02-14,14.440000000000055,836.0,Outgoing
50813708,2023-01-31,339.04,,-
50813708,2023-02-01,166.26000000000002,172.78,Outgoing
50813708,2023-02-03,306.62,140.36,Incoming
50813708,2023-02-04,404.29,97.67,Incoming
50813708,2023-02-05,358.82000000000005,45.47,Outgoing
50813708,2023-02-05,467.15000000000003,108.33,Incoming
50813708,2023-02-06,495.49,28.34,Incoming
50813708,2023-02-08,327.83000000000004,167.66,Outgoing
50813708,2023-02-10,318.08000000000004,9.75,Outgoing
50813708,2023-02-13,402.28000000000003,84.2,Incoming
50837270,2023-01-31,613.53,,-
50837270,2023-02-02,466.09,147.44,Outgoing
50837270,2023-02-04,571.9,105.81,Incoming
50837270,2023-02-12,457.84,114.06,Outgoing
50837270,2023-02-13,895.3399999999999,437.5,Incoming
50837270,2023-02-14,828.6599999999999,66.68,Outgoing
50880352,2023-01-31,12.46,,-
50880352,2023-02-05,145.56,133.1,Incoming
50880352,2023-02-06,205.15,59.59,Incoming
50880352,2023-02-08,185.56,19.59,Outgoing
50880352,2023-02-09,-20.180000000000007,205.74,Outgoing
50887252,2023-01-31,464.78,,-
50887252,2023-02-03,408.42999999999995,56.35,Outgoing
50887252,2023-02-04,527.9599999999999,119.53,Incoming
50887252,2023-02-05,-244.54000000000008,772.5,Outgoing
50887252,2023-02-06,-454.9000000000001,210.36,Outgoing
50887252,2023-02-09,-630.3800000000001,175.48,Outgoing
50887252,2023-02-09,-767.5500000000001,137.17,Outgoing
50887252,2023-02-10,-872.48,104.93,Outgoing
50887252,2023-02-14,-742.89,129.59,Incoming
50893310,2023-01-31,185.13,,-
50893310,2023-02-06,94.94,90.19,Outgoing
50893310,2023-02-08,-9.379999999999995,104.32,Outgoing
50893310,2023-02-12,-139.44,130.06,Outgoing
50893310,2023-02-13,-69.73,69.71,Incoming
50959802,2023-01-31,821.37,,-
50959802,2023-02-01,918.48,97.11,Incoming
50959802,2023-02-02,-517.8199999999999,1436.3,Outgoing
50959802,2023-02-10,-296.5999999999999,221.22,Incoming
50959802,2023-02-14,-1453.6999999999998,1157.1,Outgoing
51079213,2023-01-31,783.58,,-
51079213,2023-02-01,853.85,70.27,Incoming
51079213,2023-02-03,773.35,80.5,Outgoing
51079213,2023-02-05,957.4100000000001,184.06,Incoming
51079213,2023-02-05,1101.51,144.1,Incoming
51079213,2023-02-07,1162.52,61.01,Incoming
51079213,2023-02-08,975.28,187.24,Outgoing
51079213,2023-02-11,1002.15,26.87,Incoming
51079213,2023-02-14,1072.67,70.52,Incoming
51102699,2023-01-31,626.91,,-
51102699,2023-02-02,683.8499999999999,56.94,Incoming
51102699,2023-02-08,851.9899999999999,168.14,Incoming
51102699,2023-02-10,757.5399999999998,94.45,Outgoing
51102699,2023-02-12,823.8699999999999,66.33,Incoming
51102699,2023-02-13,785.8299999999999,38.04,Outgoing
51122335,2023-01-31,219.24,,-
51122335,2023-02-02,369.44,150.2,Incoming
51122335,2023-02-08,326.56,42.88,Outgoing
51122335,2023-02-10,414.6,88.04,Incoming
51198722,2023-01-31,559.63,,-
51198722,2023-02-06,1554.83,995.2,Incoming
51198722,2023-02-06,2600.23,1045.4,Incoming
51198722,2023-02-07,2619.44,19.21,Incoming
51198722,2023-02-07,1584.24,1035.2,Outgoing
51266306,2023-01-31,163.99,,-
51266306,2023-02-01,-1023.71,1187.7,Outgoing
51266306,2023-02-01,-930.85,92.86,Incoming
51266306,2023-02-04,-1049.45,118.6,Outgoing
51266306,2023-02-05,-931.22,118.23,Incoming
51272805,2023-01-31,135.47,,-
51272805,2023-02-01,239.41,103.94,Incoming
51272805,2023-02-01,85.50999999999999,153.9,Outgoing
51272805,2023-02-03,803.71,718.2,Incoming
51272805,2023-02-05,760.4300000000001,43.28,Outgoing
51272805,2023-02-12,842.6300000000001,82.2,Incoming
51272805,2023-02-13,736.6800000000001,105.95,Outgoing
51298007,2023-01-31,427.17,,-
51298007,2023-02-04,353.47,73.7,Outgoing
51298007,2023-02-05,1202.17,848.7,Incoming
51298007,2023-02-07,2815.37,1613.2,Incoming
51298007,2023-02-09,2677.93,137.44,Outgoing
51298007,2023-02-09,2581.1099999999997,96.82,Outgoing
51298007,2023-02-12,2491.5599999999995,89.55,Outgoing
51298007,2023-02-12,2596.3399999999997,104.78,Incoming
51313899,2023-01-31,189.04,,-
51313899,2023-02-01,1261.74,1072.7,Incoming
51313899,2023-02-02,1313.85,52.11,Incoming
51313899,2023-02-03,-174.1500000000001,1488.0,Outgoing
51313899,2023-02-04,-302.4100000000001,128.26,Outgoing
51313899,2023-02-05,-182.5300000000001,119.88,Incoming
51313899,2023-02-06,-91.00000000000009,91.53,Incoming
51313899,2023-02-07,-374.4000000000001,283.4,Outgoing
51313899,2023-02-09,-2027.5,1653.1,Outgoing
51325070,2023-01-31,933.4,,-
51325070,2023-02-01,828.55,104.85,Outgoing
51325070,2023-02-01,912.3199999999999,83.77,Incoming
51325070,2023-02-02,1067.1699999999998,154.85,Incoming
51325070,2023-02-03,1063.1499999999999,4.02,Outgoing
51325070,2023-02-03,1001.8599999999999,61.29,Outgoing
51325070,2023-02-04,818.6099999999999,183.25,Outgoing
51325070,2023-02-05,778.5799999999999,40.03,Outgoing
51325070,2023-02-06,786.6199999999999,8.04,Incoming
51325070,2023-02-06,733.0899999999999,53.53,Outgoing
51325070,2023-02-06,704.3799999999999,28.71,Outgoing
51325070,2023-02-07,803.5899999999999,99.21,Incoming
51325070,2023-02-08,772.3899999999999,31.2,Outgoing
51325070,2023-02-08,675.9599999999998,96.43,Outgoing
51325070,2023-02-11,569.9399999999998,106.02,Outgoing
51325070,2023-02-12,669.4999999999998,99.56,Incoming
51353910,2023-01-31,523.88,,-
51353910,2023-02-07,670.05,146.17,Incoming
51353910,2023-02-09,629.28,40.77,Outgoing
51358248,2023-01-31,222.93,,-
51358248,2023-02-02,402.12,179.19,Incoming
51358248,2023-02-10,274.41,127.71,Outgoing
51358248,2023-02-14,144.32000000000002,130.09,Outgoing
51358248,2023-02-14,101.38000000000002,42.94,Outgoing
51389636,2023-01-31,917.98,,-
51389636,2023-02-02,1095.3400000000001,177.36,Incoming
51389636,2023-02-02,1204.63,109.29,Incoming
51389636,2023-02-09,1283.96,79.33,Incoming
51398784,2023-01-31,909.2,,-
51398784,2023-02-07,595.7,313.5,Outgoing
51398784,2023-02-13,584.59,11.11,Outgoing
51401655,2023-01-31,877.47,,-
51401655,2023-02-02,999.0500000000001,121.58,Incoming
51401655,2023-02-04,936.3600000000001,62.69,Outgoing
51401655,2023-02-04,839.1000000000001,97.26,Outgoing
51401655,2023-02-05,638.3300000000002,200.77,Outgoing
51435617,2023-01-31,140.46,,-
51435617,2023-02-03,29.790000000000006,110.67,Outgoing
51435617,2023-02-05,117.45,87.66,Incoming
51435617,2023-02-06,-15.749999999999986,133.2,Outgoing
51435617,2023-02-12,39.640000000000015,55.39,Incoming
51435617,2023-02-12,116.15000000000002,76.51,Incoming
51435617,2023-02-13,97.22000000000003,18.93,Outgoing
51450938,2023-01-31,157.37,,-
51450938,2023-02-06,59.16000000000001,98.21,Outgoing
51450938,2023-02-07,-91.75999999999998,150.92,Outgoing
51450938,2023-02-10,-24.74999999999997,67.01,Incoming
51471469,2023-01-31,611.19,,-
51471469,2023-02-05,714.4000000000001,103.21,Incoming
51471469,2023-02-10,2439.5,1725.1,Incoming
51471469,2023-02-12,2490.44,50.94,Incoming
51493379,2023-01-31,436.15,,-
51493379,2023-02-01,366.63,69.52,Outgoing
51493379,2023-02-08,416.27,49.64,Incoming
51504474,2023-01-31,153.25,,-
51504474,2023-02-01,-66.46000000000001,219.71,Outgoing
51504474,2023-02-04,-84.71000000000001,18.25,Outgoing
51504474,2023-02-04,-152.85000000000002,68.14,Outgoing
51504474,2023-02-07,-29.610000000000028,123.24,Incoming
51504474,2023-02-08,1225.09,1254.7,Incoming
51504474,2023-02-09,1090.57,134.52,Outgoing
51504474,2023-02-12,1217.56,126.99,Incoming
51504474,2023-02-13,1287.19,69.63,Incoming
51653690,2023-01-31,280.41,,-
51653690,2023-02-01,358.81000000000006,78.4,Incoming
51653690,2023-02-02,231.21000000000006,127.6,Outgoing
51653690,2023-02-06,410.7900000000001,179.58,Incoming
51653690,2023-02-08,-426.5099999999999,837.3,Outgoing
51653868,2023-01-31,410.88,,-
51653868,2023-02-02,590.8199999999999,179.94,Incoming
51653868,2023-02-03,486.81999999999994,104.0,Outgoing
51653868,2023-02-04,409.15999999999997,77.66,Outgoing
51653868,2023-02-06,547.99,138.83,Incoming
51653868,2023-02-07,591.62,43.63,Incoming
51653868,2023-02-07,502.02,89.6,Outgoing
51653868,2023-02-09,448.04999999999995,53.97,Outgoing
51653868,2023-02-10,1072.85,624.8,Incoming
51653868,2023-02-10,1164.51,91.66,Incoming
51653868,2023-02-10,117.71000000000004,1046.8,Outgoing
51653868,2023-02-12,165.80000000000004,48.09,Incoming
51653868,2023-02-13,135.49000000000004,30.31,Outgoing
51653868,2023-02-14,268.24,132.75,Incoming
51653868,2023-02-14,108.51000000000002,159.73,Outgoing
51718829,2023-01-31,260.45,,-
51718829,2023-02-04,1165.85,905.4,Incoming
51718829,2023-02-05,984.6199999999999,181.23,Outgoing
51718829,2023-02-05,1845.32,860.7,Incoming
51718829,2023-02-06,1904.1599999999999,58.84,Incoming
51718829,2023-02-08,1714.2399999999998,189.92,Outgoing
51718829,2023-02-09,2758.04,1043.8,Incoming
51718829,2023-02-13,1944.54,813.5,Outgoing
51718829,2023-02-14,2044.42,99.88,Incoming
51771015,2023-01-31,876.29,,-
51771015,2023-02-04,789.1899999999999,87.1,Outgoing
51771015,2023-02-05,948.78,159.59,Incoming
51771015,2023-02-07,848.46,100.32,Outgoing
51771015,2023-02-11,701.1500000000001,147.31,Outgoing
51771015,2023-02-11,-333.9499999999998,1035.1,Outgoing
51771015,2023-02-12,-449.8199999999998,115.87,Outgoing
51771015,2023-02-14,-364.0099999999998,85.81,Incoming
51774315,2023-01-31,291.01,,-
51774315,2023-02-06,192.04,98.97,Outgoing
51774315,2023-02-07,153.42,38.62,Outgoing
51774315,2023-02-10,97.53999999999999,55.88,Outgoing
51774315,2023-02-11,199.38,101.84,Incoming
51774315,2023-02-12,278.36,78.98,Incoming
51793205,2023-01-31,715.25,,-
51793205,2023-02-02,-1186.95,1902.2,Outgoing
51793205,2023-02-07,-1010.69,176.26,Incoming
51793205,2023-02-08,-877.1,133.59,Incoming
51906599,2023-01-31,174.48,,-
51906599,2023-02-01,299.62,125.14,Incoming
51906599,2023-02-04,263.38,36.24,Outgoing
51906599,2023-02-06,347.96,84.58,Incoming
51906599,2023-02-06,403.79999999999995,55.84,Incoming
51906599,2023-02-08,350.54999999999995,53.25,Outgoing
51906599,2023-02-10,437.29999999999995,86.75,Incoming
51906599,2023-02-13,279.4,157.9,Outgoing
52104303,2023-01-31,810.97,,-
52104303,2023-02-03,711.12,99.85,Outgoing
52104303,2023-02-04,788.25,77.13,Incoming
52104303,2023-02-06,875.8199999999999,87.57,Incoming
52104303,2023-02-09,2406.7200000000003,1530.9,Incoming
52117174,2023-01-31,932.96,,-
52117174,2023-02-03,1053.52,120.56,Incoming
52117174,2023-02-05,1145.3,91.78,Incoming
52117174,2023-02-08,1189.03,43.73,Incoming
52117174,2023-02-09,1248.57,59.54,Incoming
52117174,2023-02-09,2380.17,1131.6,Incoming
52125171,2023-01-31,973.17,,-
52125171,2023-02-01,860.4,112.77,Outgoing
52125171,2023-02-02,727.76,132.64,Outgoing
52125171,2023-02-05,626.16,101.6,Outgoing
52125171,2023-02-09,689.91,63.75,Incoming
52127978,2023-01-31,84.8,,-
52127978,2023-02-08,687.8,603.0,Incoming
52127978,2023-02-09,713.75,25.95,Incoming
52127978,2023-02-12,700.18,13.57,Outgoing
52127978,2023-02-12,834.54,134.36,Incoming
52141048,2023-01-31,102.68,,-
52141048,2023-02-03,-50.900000000000006,153.58,Outgoing
52141048,2023-02-04,-82.84,31.94,Outgoing
52141048,2023-02-07,-935.44,852.6,Outgoing
52141048,2023-02-08,-1057.63,122.19,Outgoing
52141048,2023-02-11,-1201.8000000000002,144.17,Outgoing
52146995,2023-01-31,322.52,,-
52146995,2023-02-01,253.11999999999998,69.4,Outgoing
52146995,2023-02-02,324.64,71.52,Incoming
52146995,2023-02-02,-182.46000000000004,507.1,Outgoing
52146995,2023-02-05,-74.38000000000004,108.08,Incoming
52146995,2023-02-05,-25.180000000000035,49.2,Incoming
52146995,2023-02-07,-160.90000000000003,135.72,Outgoing
52146995,2023-02-09,-197.61000000000004,36.71,Outgoing
52146995,2023-02-11,-104.08000000000004,93.53,Incoming
52146995,2023-02-12,829.92,934.0,Incoming
52146995,2023-02-14,721.27,108.65,Outgoing
52203356,2023-01-31,899.39,,-
52203356,2023-02-03,816.14,83.25,Outgoing
52203356,2023-02-05,984.88,168.74,Incoming
52203356,2023-02-05,795.53,189.35,Outgoing
52203356,2023-02-08,-520.8700000000001,1316.4,Outgoing
52203356,2023-02-11,-572.6000000000001,51.73,Outgoing
52213806,2023-01-31,597.62,,-
52213806,2023-02-12,543.52,54.1,Outgoing
52213806,2023-02-14,533.3,10.22,Outgoing
52213806,2023-02-14,436.23999999999995,97.06,Outgoing
52230539,2023-01-31,394.34,,-
52230539,2023-02-03,417.58,23.24,Incoming
52230539,2023-02-12,220.13,197.45,Outgoing
52230539,2023-02-13,370.03,149.9,Incoming
52230539,2023-02-14,457.33,87.3,Incoming
52264506,2023-01-31,934.07,,-
52264506,2023-02-02,946.94,12.87,Incoming
52264506,2023-02-05,807.84,139.1,Outgoing
52264506,2023-02-06,913.09,105.25,Incoming
52264506,2023-02-08,780.3100000000001,132.78,Outgoing
52264506,2023-02-09,640.6100000000001,139.7,Outgoing
52264506,2023-02-09,698.0600000000002,57.45,Incoming
52264506,2023-02-13,733.5200000000002,35.46,Incoming
52264506,2023-02-14,672.5500000000002,60.97,Outgoing
52310499,2023-01-31,954.51,,-
52310499,2023-02-02,901.51,53.0,Outgoing
52310499,2023-02-06,819.91,81.6,Outgoing
52310499,2023-02-14,746.72,73.19,Outgoing
52317175,2023-01-31,25.94,,-
52317175,2023-02-10,115.98,90.04,Incoming
52317175,2023-02-12,1261.68,1145.7,Incoming
52317175,2023-02-12,1407.23,145.55,Incoming
52317175,2023-02-14,1499.4,92.17,Incoming
52365238,2023-01-31,822.17,,-
52365238,2023-02-09,736.7199999999999,85.45,Outgoing
52365238,2023-02-12,644.3,92.42,Outgoing
52366360,2023-01-31,465.67,,-
52366360,2023-02-02,527.33,61.66,Incoming
52366360,2023-02-03,438.59000000000003,88.74,Outgoing
52366360,2023-02-06,265.91,172.68,Outgoing
52366360,2023-02-06,338.79,72.88,Incoming
52366360,2023-02-07,403.20000000000005,64.41,Incoming
52390463,2023-01-31,172.82,,-
52390463,2023-02-01,25.23999999999998,147.58,Outgoing
52390463,2023-02-02,559.74,534.5,Incoming
52390463,2023-02-03,638.9,79.16,Incoming
52390463,2023-02-03,859.73,220.83,Incoming
52390463,2023-02-04,890.09,30.36,Incoming
52390463,2023-02-14,1007.21,117.12,Incoming
52436120,2023-01-31,904.47,,-
52436120,2023-02-03,794.8100000000001,109.66,Outgoing
52436120,2023-02-07,679.4100000000001,115.4,Outgoing
52436120,2023-02-11,1239.6100000000001,560.2,Incoming
52442629,2023-01-31,617.92,,-
52442629,2023-02-03,2080.72,1462.8,Incoming
52442629,2023-02-03,1883.9899999999998,196.73,Outgoing
52442629,2023-02-11,2029.4399999999998,145.45,Incoming
52442629,2023-02-12,1939.1599999999999,90.28,Outgoing
52442629,2023-02-14,648.7599999999998,1290.4,Outgoing
52461586,2023-01-31,596.3,,-
52461586,2023-02-02,-159.5,755.8,Outgoing
52461586,2023-02-06,-100.08,59.42,Incoming
52461586,2023-02-08,926.7199999999999,1026.8,Incoming
52461586,2023-02-08,824.8299999999999,101.89,Outgoing
52468167,2023-01-31,369.42,,-
52468167,2023-02-01,472.18,102.76,Incoming
52468167,2023-02-02,309.78,162.4,Outgoing
52468167,2023-02-10,260.87,48.91,Outgoing
52480554,2023-01-31,263.38,,-
52480554,2023-02-04,393.95,130.57,Incoming
52480554,2023-02-06,1023.25,629.3,Incoming
52480554,2023-02-10,1108.56,85.31,Incoming
52480554,2023-02-11,986.14,122.42,Outgoing
52480554,2023-02-12,918.0699999999999,68.07,Outgoing
52560688,2023-01-31,622.16,,-
52560688,2023-02-03,566.3499999999999,55.81,Outgoing
52560688,2023-02-04,450.8099999999999,115.54,Outgoing
52560688,2023-02-10,1671.31,1220.5,Incoming
52560688,2023-02-11,2730.01,1058.7,Incoming
52560688,2023-02-11,2838.42,108.41,Incoming
52560688,2023-02-12,2954.29,115.87,Incoming
52560688,2023-02-12,2827.09,127.2,Outgoing
52747145,2023-01-31,546.71,,-
52747145,2023-02-02,654.51,107.8,Incoming
52747145,2023-02-04,491.23,163.28,Outgoing
52747145,2023-02-09,646.23,155.0,Incoming
52747145,2023-02-11,753.77,107.54,Incoming
52747145,2023-02-12,918.95,165.18,Incoming
52756904,2023-01-31,428.77,,-
52756904,2023-02-04,546.85,118.08,Incoming
52756904,2023-02-05,432.82000000000005,114.03,Outgoing
52756904,2023-02-13,519.85,87.03,Incoming
52756904,2023-02-13,571.4200000000001,51.57,Incoming
52756904,2023-02-14,638.97,67.55,Incoming
52805510,2023-01-31,580.66,,-
52805510,2023-02-09,545.27,35.39,Outgoing
52805510,2023-02-09,630.5899999999999,85.32,Incoming
52805510,2023-02-10,783.78,153.19,Incoming
52805510,2023-02-13,-67.92000000000007,851.7,Outgoing
52814597,2023-01-31,899.39,,-
52814597,2023-02-01,2720.99,1821.6,Incoming
52814597,2023-02-06,2746.85,25.86,Incoming
52814597,2023-02-10,3578.25,831.4,Incoming
52814597,2023-02-11,3534.36,43.89,Outgoing
52814597,2023-02-11,4664.26,1129.9,Incoming
52814597,2023-02-14,4657.17,7.09,Outgoing
52835507,2023-01-31,306.68,,-
52835507,2023-02-01,393.59000000000003,86.91,Incoming
52835507,2023-02-03,426.36,32.77,Incoming
52835507,2023-02-05,1232.56,806.2,Incoming
52835507,2023-02-05,1123.1499999999999,109.41,Outgoing
52835507,2023-02-08,1027.4899999999998,95.66,Outgoing
52835507,2023-02-10,-70.71000000000026,1098.2,Outgoing
52835507,2023-02-13,191.6899999999997,262.4,Incoming
52835507,2023-02-14,-861.8100000000003,1053.5,Outgoing
52840001,2023-01-31,746.12,,-
52840001,2023-02-01,657.9300000000001,88.19,Outgoing
52840001,2023-02-04,759.45,101.52,Incoming
52840001,2023-02-07,-54.94999999999993,814.4,Outgoing
52855120,2023-01-31,880.21,,-
52855120,2023-02-01,719.73,160.48,Outgoing
52855120,2023-02-02,557.82,161.91,Outgoing
52855120,2023-02-04,630.0600000000001,72.24,Incoming
52855120,2023-02-09,524.24,105.82,Outgoing
52855120,2023-02-10,585.4,61.16,Incoming
52855120,2023-02-11,759.5899999999999,174.19,Incoming
52855120,2023-02-12,2400.39,1640.8,Incoming
52911248,2023-01-31,430.16,,-
52911248,2023-02-01,592.05,161.89,Incoming
52911248,2023-02-03,697.41,105.36,Incoming
52911248,2023-02-05,829.13,131.72,Incoming
52911248,2023-02-07,991.36,162.23,Incoming
52911248,2023-02-08,919.1700000000001,72.19,Outgoing
52911248,2023-02-10,1054.16,134.99,Incoming
52911248,2023-02-10,3138.26,2084.1,Incoming
52911248,2023-02-10,4089.46,951.2,Incoming
52911248,2023-02-10,4173.41,83.95,Incoming
52911248,2023-02-12,4298.88,125.47,Incoming
52911248,2023-02-12,4428.61,129.73,Incoming
52911248,2023-02-13,4364.63,63.98,Outgoing
52973634,2023-01-31,417.09,,-
52973634,2023-02-02,312.10999999999996,104.98,Outgoing
52973634,2023-02-02,232.09999999999997,80.01,Outgoing
52973634,2023-02-03,-140.10000000000002,372.2,Outgoing
52973634,2023-02-11,-10.750000000000028,129.35,Incoming
52973634,2023-02-11,-17.290000000000028,6.54,Outgoing
52973634,2023-02-12,-189.42000000000002,172.13,Outgoing
52973634,2023-02-13,-324.0,134.58,Outgoing
52996436,2023-01-31,883.35,,-
52996436,2023-02-01,797.32,86.03,Outgoing
52996436,2023-02-03,970.99,173.67,Incoming
52996436,2023-02-08,1066.65,95.66,Incoming
52996436,2023-02-14,2357.05,1290.4,Incoming
53006272,2023-01-31,761.95,,-
53006272,2023-02-03,627.6,134.35,Outgoing
53006272,2023-02-06,718.24,90.64,Incoming
53006272,2023-02-08,807.23,88.99,Incoming
53006272,2023-02-08,647.13,160.1,Outgoing
53006272,2023-02-14,489.99,157.14,Outgoing
53010345,2023-01-31,131.63,,-
53010345,2023-02-06,255.24,123.61,Incoming
53010345,2023-02-10,86.24000000000001,169.0,Outgoing
53010345,2023-02-10,231.78,145.54,Incoming
53010345,2023-02-14,143.01,88.77,Outgoing
53046005,2023-01-31,669.82,,-
53046005,2023-02-01,633.3900000000001,36.43,Outgoing
53046005,2023-02-02,581.1400000000001,52.25,Outgoing
53046005,2023-02-04,639.1700000000001,58.03,Incoming
53046005,2023-02-06,768.6800000000001,129.51,Incoming
53046005,2023-02-13,611.4100000000001,157.27,Outgoing
53046005,2023-02-13,536.9000000000001,74.51,Outgoing
53046005,2023-02-13,662.7500000000001,125.85,Incoming
53059420,2023-01-31,531.72,,-
53059420,2023-02-01,629.51,97.79,Incoming
53059420,2023-02-02,759.34,129.83,Incoming
53059420,2023-02-07,618.97,140.37,Outgoing
53059420,2023-02-07,420.76,198.21,Outgoing
53079883,2023-01-31,489.35,,-
53079883,2023-02-05,640.08,150.73,Incoming
53079883,2023-02-05,755.1600000000001,115.08,Incoming
53079883,2023-02-09,1012.2600000000001,257.1,Incoming
53079883,2023-02-10,1563.06,550.8,Incoming
53079883,2023-02-14,1552.49,10.57,Outgoing
53085668,2023-01-31,199.11,,-
53085668,2023-02-05,92.57000000000001,106.54,Outgoing
53085668,2023-02-05,167.63,75.06,Incoming
53085668,2023-02-07,1112.83,945.2,Incoming
53085668,2023-02-10,1214.3899999999999,101.56,Incoming
53085668,2023-02-11,1331.55,117.16,Incoming
53085668,2023-02-14,1290.3,41.25,Outgoing
53085668,2023-02-14,1314.34,24.04,Incoming
53086727,2023-01-31,408.74,,-
53086727,2023-02-02,293.45,115.29,Outgoing
53086727,2023-02-10,1655.55,1362.1,Incoming
53089607,2023-01-31,567.87,,-
53089607,2023-02-01,405.98,161.89,Outgoing
53089607,2023-02-02,258.56000000000006,147.42,Outgoing
53089607,2023-02-05,435.44000000000005,176.88,Incoming
53089607,2023-02-11,274.11,161.33,Outgoing
53089607,2023-02-12,411.25,137.14,Incoming
53089607,2023-02-13,340.07,71.18,Outgoing
53091928,2023-01-31,235.6,,-
53091928,2023-02-02,484.29999999999995,248.7,Incoming
53091928,2023-02-06,612.43,128.13,Incoming
53091928,2023-02-07,778.67,166.24,Incoming
53091928,2023-02-07,-963.2300000000001,1741.9,Outgoing
53091928,2023-02-09,-849.2200000000001,114.01,Incoming
53091928,2023-02-11,-878.0200000000001,28.8,Outgoing
53091928,2023-02-12,-915.2400000000001,37.22,Outgoing
53107499,2023-01-31,237.09,,-
53107499,2023-02-01,153.23000000000002,83.86,Outgoing
53107499,2023-02-09,212.09000000000003,58.86,Incoming
53107499,2023-02-13,43.410000000000025,168.68,Outgoing
53107499,2023-02-13,113.95000000000003,70.54,Incoming
53107499,2023-02-14,154.08000000000004,40.13,Incoming
53161068,2023-01-31,945.53,,-
53161068,2023-02-02,768.17,177.36,Outgoing
53161068,2023-02-02,-194.63,962.8,Outgoing
53161068,2023-02-03,1371.9699999999998,1566.6,Incoming
53161068,2023-02-03,1309.3799999999999,62.59,Outgoing
53161068,2023-02-04,1379.2099999999998,69.83,Incoming
53161068,2023-02-05,1859.81,480.6,Incoming
53161068,2023-02-05,1768.25,91.56,Outgoing
53161068,2023-02-05,1849.43,81.18,Incoming
53161068,2023-02-07,1741.1200000000001,108.31,Outgoing
53161068,2023-02-10,1633.46,107.66,Outgoing
53161068,2023-02-10,1582.96,50.5,Outgoing
53170488,2023-01-31,219.2,,-
53170488,2023-02-04,292.7,73.5,Incoming
53170488,2023-02-08,242.39,50.31,Outgoing
53192110,2023-01-31,588.04,,-
53192110,2023-02-06,470.58,117.46,Outgoing
53192110,2023-02-07,524.36,53.78,Incoming
53192110,2023-02-14,612.72,88.36,Incoming
53204515,2023-01-31,689.65,,-
53204515,2023-02-02,606.3199999999999,83.33,Outgoing
53204515,2023-02-04,742.8299999999999,136.51,Incoming
53204515,2023-02-06,628.68,114.15,Outgoing
53211412,2023-01-31,69.51,,-
53211412,2023-02-05,-24.059999999999988,93.57,Outgoing
53211412,2023-02-07,77.44000000000001,101.5,Incoming
53211412,2023-02-09,97.62,20.18,Incoming
53211412,2023-02-11,295.52,197.9,Incoming
53211412,2023-02-11,253.63,41.89,Outgoing
53211412,2023-02-12,131.95,121.68,Outgoing
53211412,2023-02-13,182.63,50.68,Incoming
53211412,2023-02-13,-719.37,902.0,Outgoing
53234515,2023-01-31,854.67,,-
53234515,2023-02-01,925.17,70.5,Incoming
53234515,2023-02-02,870.5999999999999,54.57,Outgoing
53234515,2023-02-04,-478.60000000000014,1349.2,Outgoing
53234515,2023-02-05,-626.9300000000002,148.33,Outgoing
53234515,2023-02-06,-635.2800000000002,8.35,Outgoing
53240505,2023-01-31,188.87,,-
53240505,2023-02-03,69.23,119.64,Outgoing
53240505,2023-02-14,106.44,37.21,Incoming
53240505,2023-02-14,194.79,88.35,Incoming
53260868,2023-01-31,966.85,,-
53260868,2023-02-01,758.62,208.23,Outgoing
53260868,2023-02-02,624.38,134.24,Outgoing
53260868,2023-02-07,2053.48,1429.1,Incoming
53260868,2023-02-10,1955.7,97.78,Outgoing
53260868,2023-02-12,1981.68,25.98,Incoming
53332086,2023-01-31,273.51,,-
53332086,2023-02-03,371.95,98.44,Incoming
53332086,2023-02-06,257.0,114.95,Outgoing
53332086,2023-02-06,140.01,116.99,Outgoing
53332086,2023-02-09,225.45999999999998,85.45,Incoming
53332086,2023-02-12,304.51,79.05,Incoming
53332086,2023-02-14,364.41999999999996,59.91,Incoming
53366488,2023-01-31,337.18,,-
53366488,2023-02-01,221.77,115.41,Outgoing
53366488,2023-02-02,326.49,104.72,Incoming
53366488,2023-02-03,215.95,110.54,Outgoing
53366488,2023-02-04,350.19,134.24,Incoming
53366488,2023-02-07,242.64999999999998,107.54,Outgoing
53366488,2023-02-10,345.57,102.92,Incoming
53366488,2023-02-13,269.46,76.11,Outgoing
53376344,2023-01-31,228.65,,-
53376344,2023-02-02,147.64,81.01,Outgoing
53376344,2023-02-03,281.58,133.94,Incoming
53376344,2023-02-04,246.05999999999997,35.52,Outgoing
53376344,2023-02-05,160.27999999999997,85.78,Outgoing
53376344,2023-02-14,-1204.72,1365.0,Outgoing
53380359,2023-01-31,0.81,,-
53380359,2023-02-01,134.1,133.29,Incoming
53380359,2023-02-04,55.709999999999994,78.39,Outgoing
53380359,2023-02-08,184.51,128.8,Incoming
53380359,2023-02-08,234.10999999999999,49.6,Incoming
53380359,2023-02-08,348.03,113.92,Incoming
53380359,2023-02-08,213.79999999999998,134.23,Outgoing
53380359,2023-02-13,-553.5,767.3,Outgoing
53380359,2023-02-13,-938.3,384.8,Outgoing
53421312,2023-01-31,937.86,,-
53421312,2023-02-03,978.25,40.39,Incoming
53421312,2023-02-04,933.88,44.37,Outgoing
53421312,2023-02-04,1133.31,199.43,Incoming
53421312,2023-02-07,1147.02,13.71,Incoming
53421312,2023-02-08,1011.5699999999999,135.45,Outgoing
53421312,2023-02-11,1081.36,69.79,Incoming
53421312,2023-02-12,954.3699999999999,126.99,Outgoing
53496996,2023-01-31,303.15,,-
53496996,2023-02-01,156.86999999999998,146.28,Outgoing
53496996,2023-02-02,82.15999999999998,74.71,Outgoing
53496996,2023-02-05,188.58999999999997,106.43,Incoming
53496996,2023-02-07,92.80999999999997,95.78,Outgoing
53496996,2023-02-11,-56.380000000000024,149.19,Outgoing
53496996,2023-02-12,-163.41000000000003,107.03,Outgoing
53502347,2023-01-31,18.89,,-
53502347,2023-02-01,509.78999999999996,490.9,Incoming
53502347,2023-02-01,425.65,84.14,Outgoing
53502347,2023-02-08,548.71,123.06,Incoming
53502347,2023-02-10,415.25,133.46,Outgoing
53502347,2023-02-14,1884.55,1469.3,Incoming
53502347,2023-02-14,2092.55,208.0,Incoming
53513558,2023-01-31,235.44,,-
53513558,2023-02-02,336.33,100.89,Incoming
53513558,2023-02-04,491.96,155.63,Incoming
53513558,2023-02-05,1192.36,700.4,Incoming
53513558,2023-02-08,1030.9299999999998,161.43,Outgoing
53513558,2023-02-09,971.6499999999999,59.28,Outgoing
53518299,2023-01-31,953.96,,-
53518299,2023-02-01,1070.23,116.27,Incoming
53518299,2023-02-08,1023.8000000000001,46.43,Outgoing
53518299,2023-02-10,1158.13,134.33,Incoming
53538823,2023-01-31,750.37,,-
53538823,2023-02-05,829.19,78.82,Incoming
53538823,2023-02-06,1234.89,405.7,Incoming
53538823,2023-02-06,1211.76,23.13,Outgoing
53538823,2023-02-08,1269.53,57.77,Incoming
53634705,2023-01-31,853.12,,-
53634705,2023-02-05,701.85,151.27,Outgoing
53634705,2023-02-05,638.64,63.21,Outgoing
53634705,2023-02-14,862.63,223.99,Incoming
53665038,2023-01-31,624.95,,-
53665038,2023-02-02,597.4300000000001,27.52,Outgoing
53665038,2023-02-07,625.1800000000001,27.75,Incoming
53665038,2023-02-09,880.8000000000001,255.62,Incoming
53665038,2023-02-13,767.7600000000001,113.04,Outgoing
53727603,2023-01-31,517.25,,-
53727603,2023-02-02,392.57,124.68,Outgoing
53727603,2023-02-04,300.52,92.05,Outgoing
53727603,2023-02-08,237.33999999999997,63.18,Outgoing
53727603,2023-02-10,2713.44,2476.1,Incoming
53727603,2023-02-11,3851.34,1137.9,Incoming
53727603,2023-02-13,3926.71,75.37,Incoming
53727603,2023-02-13,3860.17,66.54,Outgoing
53753986,2023-01-31,252.69,,-
53753986,2023-02-03,373.02,120.33,Incoming
53753986,2023-02-04,1432.12,1059.1,Incoming
53753986,2023-02-06,1597.79,165.67,Incoming
53753986,2023-02-11,1517.04,80.75,Outgoing
53753986,2023-02-12,656.24,860.8,Outgoing
53754887,2023-01-31,162.05,,-
53754887,2023-02-02,59.80000000000001,102.25,Outgoing
53754887,2023-02-06,-89.26999999999998,149.07,Outgoing
53754887,2023-02-09,-144.19,54.92,Outgoing
53762957,2023-01-31,245.78,,-
53762957,2023-02-01,346.9,101.12,Incoming
53762957,2023-02-09,526.55,179.65,Incoming
53762957,2023-02-10,377.35999999999996,149.19,Outgoing
53762957,2023-02-10,477.52,100.16,Incoming
53762957,2023-02-11,620.24,142.72,Incoming
53762957,2023-02-11,729.16,108.92,Incoming
53762957,2023-02-11,595.0,134.16,Outgoing
53762957,2023-02-12,745.86,150.86,Incoming
53762957,2023-02-14,901.6800000000001,155.82,Incoming
53762957,2023-02-14,849.7800000000001,51.9,Outgoing
53764356,2023-01-31,447.88,,-
53764356,2023-02-01,364.51,83.37,Outgoing
53764356,2023-02-02,166.89,197.62,Outgoing
53764356,2023-02-02,241.70999999999998,74.82,Incoming
53764356,2023-02-04,317.65,75.94,Incoming
53764356,2023-02-04,181.45,136.2,Outgoing
53764356,2023-02-07,265.64,84.19,Incoming
53764356,2023-02-08,410.41999999999996,144.78,Incoming
53764356,2023-02-10,344.9,65.52,Outgoing
53764356,2023-02-11,504.24,159.34,Incoming
53764356,2023-02-12,684.1700000000001,179.93,Incoming
53831793,2023-01-31,799.66,,-
53831793,2023-02-06,943.23,143.57,Incoming
53831793,2023-02-08,1102.58,159.35,Incoming
53831793,2023-02-08,1213.02,110.44,Incoming
53831793,2023-02-09,1109.83,103.19,Outgoing
53831793,2023-02-10,973.9399999999999,135.89,Outgoing
53831793,2023-02-13,846.51,127.43,Outgoing
53831793,2023-02-13,-379.5899999999999,1226.1,Outgoing
53845552,2023-01-31,285.52,,-
53845552,2023-02-06,-682.28,967.8,Outgoing
53845552,2023-02-09,-599.74,82.54,Incoming
53845615,2023-01-31,597.04,,-
53845615,2023-02-05,644.55,47.51,Incoming
53845615,2023-02-06,573.55,71.0,Outgoing
53845615,2023-02-06,637.25,63.7,Incoming
53845615,2023-02-07,788.46,151.21,Incoming
53845615,2023-02-07,889.24,100.78,Incoming
53845615,2023-02-10,881.95,7.29,Outgoing
53845615,2023-02-10,1934.8500000000001,1052.9,Incoming
53858816,2023-01-31,539.38,,-
53858816,2023-02-01,631.58,92.2,Incoming
53858816,2023-02-03,730.11,98.53,Incoming
53858816,2023-02-05,836.02,105.91,Incoming
53858816,2023-02-05,802.6999999999999,33.32,Outgoing
53858816,2023-02-09,958.7299999999999,156.03,Incoming
53858816,2023-02-11,-272.57000000000005,1231.3,Outgoing
53858816,2023-02-12,-158.79000000000005,113.78,Incoming
53884266,2023-01-31,21.72,,-
53884266,2023-02-12,-163.79,185.51,Outgoing
53884266,2023-02-13,-55.80999999999999,107.98,Incoming
53884266,2023-02-13,30.030000000000015,85.84,Incoming
53884626,2023-01-31,478.38,,-
53884626,2023-02-02,1891.98,1413.6,Incoming
53884626,2023-02-03,1776.27,115.71,Outgoing
53884626,2023-02-07,1865.1299999999999,88.86,Incoming
53884626,2023-02-09,1731.1299999999999,134.0,Outgoing
53884626,2023-02-13,1657.12,74.01,Outgoing
53884626,2023-02-13,131.91999999999985,1525.2,Outgoing
53887772,2023-01-31,541.43,,-
53887772,2023-02-02,650.7299999999999,109.3,Incoming
53887772,2023-02-02,585.5299999999999,65.2,Outgoing
53887772,2023-02-04,721.7299999999998,136.2,Incoming
53887772,2023-02-06,836.6799999999998,114.95,Incoming
53887772,2023-02-06,892.0399999999998,55.36,Incoming
53887772,2023-02-11,1034.57,142.53,Incoming
53887772,2023-02-11,1076.76,42.19,Incoming
53887772,2023-02-14,974.67,102.09,Outgoing
53959112,2023-01-31,103.99,,-
53959112,2023-02-06,-55.07000000000001,159.06,Outgoing
53959112,2023-02-06,-115.84,60.77,Outgoing
53959112,2023-02-07,-44.7,71.14,Incoming
53959112,2023-02-07,-180.39999999999998,135.7,Outgoing
53959112,2023-02-08,-233.39,52.99,Outgoing
53959112,2023-02-09,-335.98,102.59,Outgoing
53959112,2023-02-10,-261.04,74.94,Incoming
53960481,2023-01-31,490.82,,-
53960481,2023-02-04,387.77,103.05,Outgoing
53960481,2023-02-06,285.65,102.12,Outgoing
53960481,2023-02-08,211.26,74.39,Outgoing
53971767,2023-01-31,958.87,,-
53971767,2023-02-01,1083.11,124.24,Incoming
53971767,2023-02-02,1145.08,61.97,Incoming
53977562,2023-01-31,398.76,,-
53977562,2023-02-02,414.69,15.93,Incoming
53977562,2023-02-06,587.72,173.03,Incoming
53977562,2023-02-06,728.5500000000001,140.83,Incoming
53977562,2023-02-07,615.5200000000001,113.03,Outgoing
53977562,2023-02-08,764.8300000000002,149.31,Incoming
53977562,2023-02-14,619.7500000000001,145.08,Outgoing
53977562,2023-02-14,645.0300000000001,25.28,Incoming
54032229,2023-01-31,176.12,,-
54032229,2023-02-03,263.62,87.5,Incoming
54032229,2023-02-05,115.16,148.46,Outgoing
54032229,2023-02-08,41.03,74.13,Outgoing
54032229,2023-02-09,137.23000000000002,96.2,Incoming
54032229,2023-02-13,1640.63,1503.4,Incoming
54033811,2023-01-31,534.83,,-
54033811,2023-02-01,723.1600000000001,188.33,Incoming
54033811,2023-02-03,786.0500000000001,62.89,Incoming
54033811,2023-02-03,935.0,148.95,Incoming
54033811,2023-02-06,820.14,114.86,Outgoing
54033811,2023-02-06,791.51,28.63,Outgoing
54033811,2023-02-08,657.92,133.59,Outgoing
54033811,2023-02-09,593.4499999999999,64.47,Outgoing
54067346,2023-01-31,180.91,,-
54067346,2023-02-02,84.11,96.8,Outgoing
54067346,2023-02-08,-7.420000000000002,91.53,Outgoing
54067346,2023-02-10,-64.61,57.19,Outgoing
54067346,2023-02-11,-1700.2099999999998,1635.6,Outgoing
54067346,2023-02-11,-1541.6299999999999,158.58,Incoming
54067346,2023-02-12,-1515.81,25.82,Incoming
54071589,2023-01-31,765.81,,-
54071589,2023-02-03,883.03,117.22,Incoming
54071589,2023-02-09,990.25,107.22,Incoming
54071589,2023-02-11,870.42,119.83,Outgoing
54071589,2023-02-11,811.48,58.94,Outgoing
54071589,2023-02-11,1537.68,726.2,Incoming
54137851,2023-01-31,30.67,,-
54137851,2023-02-05,111.85000000000001,81.18,Incoming
54137851,2023-02-13,40.31,71.54,Outgoing
54154999,2023-01-31,962.14,,-
54154999,2023-02-01,854.96,107.18,Outgoing
54154999,2023-02-02,904.1,49.14,Incoming
54154999,2023-02-03,946.01,41.91,Incoming
54154999,2023-02-05,1088.8,142.79,Incoming
54154999,2023-02-05,1060.9199999999998,27.88,Outgoing
54154999,2023-02-07,1021.3799999999999,39.54,Outgoing
54154999,2023-02-07,918.8399999999999,102.54,Outgoing
54154999,2023-02-08,883.7099999999999,35.13,Outgoing
54189995,2023-01-31,401.27,,-
54189995,2023-02-03,414.88,13.61,Incoming
54189995,2023-02-04,317.21,97.67,Outgoing
54189995,2023-02-09,158.59999999999997,158.61,Outgoing
54189995,2023-02-14,301.63,143.03,Incoming
54189995,2023-02-14,184.39999999999998,117.23,Outgoing
54230889,2023-01-31,597.31,,-
54230889,2023-02-09,610.0,12.69,Incoming
54230889,2023-02-11,534.97,75.03,Outgoing
54278560,2023-01-31,161.8,,-
54278560,2023-02-01,329.26,167.46,Incoming
54278560,2023-02-07,236.70999999999998,92.55,Outgoing
54278560,2023-02-08,370.93999999999994,134.23,Incoming
54288062,2023-01-31,336.75,,-
54288062,2023-02-03,231.86,104.89,Outgoing
54288062,2023-02-03,278.40000000000003,46.54,Incoming
54288062,2023-02-04,1544.8000000000002,1266.4,Incoming
54288062,2023-02-04,1391.64,153.16,Outgoing
54288062,2023-02-07,1239.39,152.25,Outgoing
54288062,2023-02-14,1119.23,120.16,Outgoing
54288062,2023-02-14,1255.96,136.73,Incoming
54300071,2023-01-31,317.35,,-
54300071,2023-02-01,-270.94999999999993,588.3,Outgoing
54300071,2023-02-03,-358.38999999999993,87.44,Outgoing
54300071,2023-02-03,-469.8499999999999,111.46,Outgoing
54300071,2023-02-05,-528.3,58.45,Outgoing
54300071,2023-02-05,-445.65999999999997,82.64,Incoming
54300071,2023-02-06,-352.45,93.21,Incoming
54300071,2023-02-08,-506.65,154.2,Outgoing
54300071,2023-02-09,-2083.25,1576.6,Outgoing
54300071,2023-02-12,-1948.28,134.97,Incoming
54300071,2023-02-12,-1830.83,117.45,Incoming
54300071,2023-02-13,-3366.5299999999997,1535.7,Outgoing
54300071,2023-02-13,-3539.89,173.36,Outgoing
54301151,2023-01-31,408.16,,-
54301151,2023-02-07,888.1600000000001,480.0,Incoming
54301151,2023-02-12,-731.1399999999999,1619.3,Outgoing
54307382,2023-01-31,452.52,,-
54307382,2023-02-02,354.83,97.69,Outgoing
54307382,2023-02-03,514.93,160.1,Incoming
54307382,2023-02-07,629.2099999999999,114.28,Incoming
54307382,2023-02-07,782.4799999999999,153.27,Incoming
54307382,2023-02-13,1318.3799999999999,535.9,Incoming
54349805,2023-01-31,752.49,,-
54349805,2023-02-02,848.81,96.32,Incoming
54349805,2023-02-04,749.31,99.5,Outgoing
54349805,2023-02-07,864.6999999999999,115.39,Incoming
54349805,2023-02-08,177.5999999999999,687.1,Outgoing
54349805,2023-02-09,326.1599999999999,148.56,Incoming
54349805,2023-02-09,263.56999999999994,62.59,Outgoing
54349805,2023-02-09,253.51999999999992,10.05,Outgoing
54349805,2023-02-10,403.3299999999999,149.81,Incoming
54349805,2023-02-13,343.87999999999994,59.45,Outgoing
54377130,2023-01-31,425.86,,-
54377130,2023-02-03,517.52,91.66,Incoming
54377130,2023-02-04,534.03,16.51,Incoming
54377130,2023-02-05,409.65999999999997,124.37,Outgoing
54377130,2023-02-06,286.28999999999996,123.37,Outgoing
54377130,2023-02-08,1405.8899999999999,1119.6,Incoming
54377130,2023-02-11,1378.31,27.58,Outgoing
54377130,2023-02-12,1561.72,183.41,Incoming
54377538,2023-01-31,845.93,,-
54377538,2023-02-02,769.9399999999999,75.99,Outgoing
54377538,2023-02-02,1915.04,1145.1,Incoming
54377538,2023-02-02,2006.61,91.57,Incoming
54377538,2023-02-07,1828.4099999999999,178.2,Outgoing
54377538,2023-02-11,1716.31,112.1,Outgoing
54405539,2023-01-31,397.2,,-
54405539,2023-02-03,309.6,87.6,Outgoing
54405539,2023-02-03,202.8,106.8,Outgoing
54405539,2023-02-04,283.55,80.75,Incoming
54405539,2023-02-10,94.04000000000002,189.51,Outgoing
54405539,2023-02-11,172.33000000000004,78.29,Incoming
54405539,2023-02-13,256.99,84.66,Incoming
54452317,2023-01-31,358.39,,-
54452317,2023-02-04,392.08,33.69,Incoming
54452317,2023-02-05,335.36,56.72,Outgoing
54452317,2023-02-06,194.58,140.78,Outgoing
54452317,2023-02-07,293.24,98.66,Incoming
54452317,2023-02-07,186.76,106.48,Outgoing
54452317,2023-02-09,1045.8600000000001,859.1,Incoming
54452317,2023-02-11,906.7200000000001,139.14,Outgoing
54458410,2023-01-31,973.1,,-
54458410,2023-02-04,1102.66,129.56,Incoming
54458410,2023-02-09,963.8600000000001,138.8,Outgoing
54458410,2023-02-10,1051.4900000000002,87.63,Incoming
54458410,2023-02-12,982.6900000000003,68.8,Outgoing
54458410,2023-02-13,1080.4600000000003,97.77,Incoming
54541943,2023-01-31,433.92,,-
54541943,2023-02-02,277.42,156.5,Outgoing
54541943,2023-02-03,354.78000000000003,77.36,Incoming
54541943,2023-02-08,-1331.22,1686.0,Outgoing
54541943,2023-02-09,-1256.26,74.96,Incoming
54541943,2023-02-10,-1458.95,202.69,Outgoing
54541943,2023-02-11,-1580.04,121.09,Outgoing
54541943,2023-02-14,-1638.67,58.63,Outgoing
54565625,2023-01-31,472.76,,-
54565625,2023-02-01,324.12,148.64,Outgoing
54565625,2023-02-03,403.8,79.68,Incoming
54565625,2023-02-06,-1543.5,1947.3,Outgoing
54565625,2023-02-07,-1481.33,62.17,Incoming
54565625,2023-02-08,-1585.51,104.18,Outgoing
54565625,2023-02-09,-1476.43,109.08,Incoming
54565625,2023-02-10,-1324.26,152.17,Incoming
54565625,2023-02-11,-1077.84,246.42,Incoming
54565625,2023-02-11,-906.9499999999999,170.89,Incoming
54565625,2023-02-11,-949.9,42.95,Outgoing
54565625,2023-02-13,-1020.75,70.85,Outgoing
54565625,2023-02-13,-943.23,77.52,Incoming
54565625,2023-02-14,-842.82,100.41,Incoming
54570251,2023-01-31,430.68,,-
54570251,2023-02-03,510.19,79.51,Incoming
54570251,2023-02-03,400.33,109.86,Outgoing
54570251,2023-02-04,374.59,25.74,Outgoing
54570251,2023-02-06,479.92999999999995,105.34,Incoming
54570251,2023-02-09,646.0899999999999,166.16,Incoming
54570251,2023-02-09,775.9399999999999,129.85,Incoming
54570251,2023-02-14,827.8399999999999,51.9,Incoming
54589543,2023-01-31,817.51,,-
54589543,2023-02-02,1934.51,1117.0,Incoming
54589543,2023-02-06,957.51,977.0,Outgoing
54589543,2023-02-08,861.06,96.45,Outgoing
54589543,2023-02-10,706.67,154.39,Outgoing
54589543,2023-02-12,886.8399999999999,180.17,Incoming
54589543,2023-02-12,993.7599999999999,106.92,Incoming
54589543,2023-02-13,1119.6799999999998,125.92,Incoming
54673873,2023-01-31,71.58,,-
54673873,2023-02-05,-2.4099999999999966,73.99,Outgoing
54673873,2023-02-11,29.790000000000006,32.2,Incoming
54673873,2023-02-11,-25.229999999999997,55.02,Outgoing
54673873,2023-02-14,-159.92,134.69,Outgoing
54720837,2023-01-31,166.15,,-
54720837,2023-02-04,32.599999999999994,133.55,Outgoing
54720837,2023-02-05,175.14,142.54,Incoming
54720837,2023-02-10,53.16999999999999,121.97,Outgoing
54720837,2023-02-11,462.97,409.8,Incoming
54720837,2023-02-13,337.0,125.97,Outgoing
54720837,2023-02-13,243.47,93.53,Outgoing
54786481,2023-01-31,96.87,,-
54786481,2023-02-04,243.55,146.68,Incoming
54786481,2023-02-07,109.26000000000002,134.29,Outgoing
54786481,2023-02-08,40.630000000000024,68.63,Outgoing
54786481,2023-02-09,4.150000000000027,36.48,Outgoing
54786481,2023-02-11,-117.09999999999997,121.25,Outgoing
54786481,2023-02-12,-80.04999999999997,37.05,Incoming
54786481,2023-02-13,19.010000000000034,99.06,Incoming
54824933,2023-01-31,721.47,,-
54824933,2023-02-05,852.1800000000001,130.71,Incoming
54824933,2023-02-09,-696.9199999999998,1549.1,Outgoing
54824933,2023-02-10,-802.9499999999998,106.03,Outgoing
54824933,2023-02-10,-814.8499999999998,11.9,Outgoing
54824933,2023-02-12,-694.0699999999998,120.78,Incoming
54852109,2023-01-31,521.7,,-
54852109,2023-02-09,-471.69999999999993,993.4,Outgoing
54852109,2023-02-13,-541.9499999999999,70.25,Outgoing
54868017,2023-01-31,789.86,,-
54868017,2023-02-06,740.53,49.33,Outgoing
54868017,2023-02-08,574.96,165.57,Outgoing
54868017,2023-02-08,1599.56,1024.6,Incoming
54868017,2023-02-10,1440.62,158.94,Outgoing
54868017,2023-02-11,1584.3999999999999,143.78,Incoming
54868017,2023-02-11,1402.7199999999998,181.68,Outgoing
54868017,2023-02-13,1551.1499999999999,148.43,Incoming
54878364,2023-01-31,80.24,,-
54878364,2023-02-03,-5.0,85.24,Outgoing
54878364,2023-02-07,1684.7,1689.7,Incoming
54878364,2023-02-08,1621.28,63.42,Outgoing
54910290,2023-01-31,11.12,,-
54910290,2023-02-04,-939.08,950.2,Outgoing
54910290,2023-02-06,-890.2,48.88,Incoming
54910290,2023-02-06,-770.0300000000001,120.17,Incoming
54910290,2023-02-06,-718.9800000000001,51.05,Incoming
54910290,2023-02-07,-589.3200000000002,129.66,Incoming
54910290,2023-02-08,-675.3000000000002,85.98,Outgoing
54910290,2023-02-09,-612.3800000000002,62.92,Incoming
54910290,2023-02-12,-777.8000000000002,165.42,Outgoing
54932317,2023-01-31,378.86,,-
54932317,2023-02-04,363.54,15.32,Outgoing
54932317,2023-02-06,310.6,52.94,Outgoing
54932317,2023-02-08,300.42,10.18,Outgoing
54932317,2023-02-09,217.85000000000002,82.57,Outgoing
54932317,2023-02-10,334.38,116.53,Incoming
54932317,2023-02-11,1193.08,858.7,Incoming
54932317,2023-02-13,1148.24,44.84,Outgoing
54932317,2023-02-14,1306.57,158.33,Incoming
54937975,2023-01-31,218.66,,-
54937975,2023-02-07,281.01,62.35,Incoming
54937975,2023-02-09,318.53999999999996,37.53,Incoming
54937975,2023-02-11,1825.94,1507.4,Incoming
54937975,2023-02-14,1630.02,195.92,Outgoing
54937975,2023-02-14,1533.24,96.78,Outgoing
54958511,2023-01-31,454.61,,-
54958511,2023-02-06,611.79,157.18,Incoming
54958511,2023-02-08,656.13,44.34,Incoming
54958511,2023-02-09,475.31,180.82,Outgoing
54958511,2023-02-12,556.6800000000001,81.37,Incoming
54958587,2023-01-31,874.83,,-
54958587,2023-02-03,981.34,106.51,Incoming
54958587,2023-02-04,1062.97,81.63,Incoming
54958587,2023-02-06,1113.75,50.78,Incoming
54958587,2023-02-07,1231.2,117.45,Incoming
54958587,2023-02-08,1281.91,50.71,Incoming
54958587,2023-02-08,1171.76,110.15,Outgoing
54958587,2023-02-14,1283.99,112.23,Incoming
54997427,2023-01-31,825.84,,-
54997427,2023-02-02,863.46,37.62,Incoming
54997427,2023-02-08,974.0600000000001,110.6,Incoming
55009163,2023-01-31,435.8,,-
55009163,2023-02-05,312.02,123.78,Outgoing
55009163,2023-02-07,389.11,77.09,Incoming
55009163,2023-02-08,433.16,44.05,Incoming
55009163,2023-02-08,620.83,187.67,Incoming
55009163,2023-02-10,483.49,137.34,Outgoing
55009163,2023-02-10,396.88,86.61,Outgoing
55009163,2023-02-13,420.05,23.17,Incoming
55022533,2023-01-31,341.29,,-
55022533,2023-02-05,376.73,35.44,Incoming
55022533,2023-02-05,551.4300000000001,174.7,Incoming
55022533,2023-02-07,410.6600000000001,140.77,Outgoing
55022533,2023-02-09,508.69000000000005,98.03,Incoming
55088029,2023-01-31,920.53,,-
55088029,2023-02-01,1073.3899999999999,152.86,Incoming
55088029,2023-02-03,516.8899999999999,556.5,Outgoing
55088029,2023-02-11,394.1799999999999,122.71,Outgoing
55106431,2023-01-31,460.48,,-
55106431,2023-02-04,297.33000000000004,163.15,Outgoing
55106431,2023-02-04,147.31000000000003,150.02,Outgoing
55106431,2023-02-08,45.440000000000026,101.87,Outgoing
55122249,2023-01-31,43.86,,-
55122249,2023-02-11,109.92999999999999,66.07,Incoming
55122249,2023-02-12,25.179999999999993,84.75,Outgoing
55122249,2023-02-14,-127.66000000000001,152.84,Outgoing
55122249,2023-02-14,-196.5,68.84,Outgoing
55168205,2023-01-31,578.4,,-
55168205,2023-02-01,656.5,78.1,Incoming
55168205,2023-02-04,776.88,120.38,Incoming
55168205,2023-02-06,681.77,95.11,Outgoing
55168205,2023-02-07,593.62,88.15,Outgoing
55168205,2023-02-13,527.47,66.15,Outgoing
55168205,2023-02-14,1665.17,1137.7,Incoming
55168205,2023-02-14,1641.13,24.04,Outgoing
55304418,2023-01-31,968.71,,-
55304418,2023-02-07,1056.8600000000001,88.15,Incoming
55304418,2023-02-08,1164.2700000000002,107.41,Incoming
55304418,2023-02-09,1106.9100000000003,57.36,Outgoing
55304418,2023-02-10,2902.8100000000004,1795.9,Incoming
55304418,2023-02-11,4117.41,1214.6,Incoming
55304418,2023-02-12,3958.5899999999997,158.82,Outgoing
55304418,2023-02-13,4830.09,871.5,Incoming
55341552,2023-01-31,768.94,,-
55341552,2023-02-02,720.59,48.35,Outgoing
55341552,2023-02-02,-34.70999999999992,755.3,Outgoing
55341552,2023-02-04,-602.41,567.7,Outgoing
55341552,2023-02-09,-433.76,168.65,Incoming
55341552,2023-02-12,-363.3,70.46,Incoming
55341552,2023-02-13,-221.26000000000002,142.04,Incoming
55353228,2023-01-31,923.38,,-
55353228,2023-02-05,1464.1799999999998,540.8,Incoming
55353228,2023-02-09,1493.8899999999999,29.71,Incoming
55353228,2023-02-11,1626.85,132.96,Incoming
55353228,2023-02-13,1521.6699999999998,105.18,Outgoing
55397453,2023-01-31,820.88,,-
55397453,2023-02-01,724.11,96.77,Outgoing
55397453,2023-02-02,-689.4899999999999,1413.6,Outgoing
55397453,2023-02-06,-887.6899999999998,198.2,Outgoing
55397453,2023-02-07,-1009.1499999999999,121.46,Outgoing
55397453,2023-02-07,-876.2399999999999,132.91,Incoming
55397453,2023-02-08,-956.6999999999999,80.46,Outgoing
55397453,2023-02-08,-1099.9199999999998,143.22,Outgoing
55397453,2023-02-08,-947.9299999999998,151.99,Incoming
55397453,2023-02-14,-1142.31,194.38,Outgoing
55398856,2023-01-31,663.43,,-
55398856,2023-02-01,1308.9299999999998,645.5,Incoming
55398856,2023-02-02,424.6299999999999,884.3,Outgoing
55398856,2023-02-03,329.08999999999986,95.54,Outgoing
55398856,2023-02-04,348.21999999999986,19.13,Incoming
55398856,2023-02-07,300.90999999999985,47.31,Outgoing
55398856,2023-02-11,389.0699999999998,88.16,Incoming
55398856,2023-02-12,249.4899999999998,139.58,Outgoing
55459151,2023-01-31,451.21,,-
55459151,2023-02-02,613.31,162.1,Incoming
55459151,2023-02-06,691.39,78.08,Incoming
55459151,2023-02-06,529.78,161.61,Outgoing
55459151,2023-02-09,576.0799999999999,46.3,Incoming
55459151,2023-02-09,1473.08,897.0,Incoming
55459151,2023-02-14,1328.23,144.85,Outgoing
55459151,2023-02-14,1263.78,64.45,Outgoing
55472786,2023-01-31,634.29,,-
55513887,2023-01-31,722.45,,-
55513887,2023-02-02,838.8800000000001,116.43,Incoming
55513887,2023-02-03,913.3800000000001,74.5,Incoming
55513887,2023-02-11,694.5700000000002,218.81,Outgoing
55513887,2023-02-11,744.7000000000002,50.13,Incoming
55513887,2023-02-13,628.3300000000002,116.37,Outgoing
55513887,2023-02-14,704.6500000000001,76.32,Incoming
55552232,2023-01-31,953.87,,-
55552232,2023-02-01,801.28,152.59,Outgoing
55552232,2023-02-06,749.53,51.75,Outgoing
55552232,2023-02-06,916.99,167.46,Incoming
55552232,2023-02-10,1596.79,679.8,Incoming
55552232,2023-02-12,1746.36,149.57,Incoming
55590263,2023-01-31,605.12,,-
55590263,2023-02-01,415.8,189.32,Outgoing
55590263,2023-02-03,630.89,215.09,Incoming
55590263,2023-02-07,707.09,76.2,Incoming
55590263,2023-02-07,590.35,116.74,Outgoing
55590263,2023-02-09,512.13,78.22,Outgoing
55607955,2023-01-31,274.23,,-
55607955,2023-02-07,363.40000000000003,89.17,Incoming
55607955,2023-02-12,364.34000000000003,0.94,Incoming
55607955,2023-02-13,310.41,53.93,Outgoing
55714753,2023-01-31,703.59,,-
55714753,2023-02-03,768.02,64.43,Incoming
55714753,2023-02-06,798.4,30.38,Incoming
55714753,2023-02-07,760.36,38.04,Outgoing
55714753,2023-02-10,786.91,26.55,Incoming
55753843,2023-01-31,524.57,,-
55753843,2023-02-04,682.61,158.04,Incoming
55753843,2023-02-05,830.36,147.75,Incoming
55753843,2023-02-10,1025.33,194.97,Incoming
55753843,2023-02-11,1152.58,127.25,Incoming
55791547,2023-01-31,758.17,,-
55791547,2023-02-07,843.52,85.35,Incoming
55791547,2023-02-08,-722.1800000000001,1565.7,Outgoing
55791547,2023-02-09,-780.57,58.39,Outgoing
55791547,2023-02-11,-654.86,125.71,Incoming
55791547,2023-02-13,-843.48,188.62,Outgoing
55795603,2023-01-31,241.17,,-
55795603,2023-02-02,353.33,112.16,Incoming
55795603,2023-02-04,836.03,482.7,Incoming
55795603,2023-02-08,656.73,179.3,Outgoing
55795603,2023-02-10,696.75,40.02,Incoming
55795603,2023-02-12,969.55,272.8,Incoming
55819086,2023-01-31,608.13,,-
55819086,2023-02-01,517.42,90.71,Outgoing
55819086,2023-02-01,307.53,209.89,Outgoing
55819086,2023-02-03,89.37999999999997,218.15,Outgoing
55819086,2023-02-03,-420.72,510.1,Outgoing
55819086,2023-02-03,-290.36,130.36,Incoming
55819086,2023-02-04,-378.54,88.18,Outgoing
55819086,2023-02-09,-243.31000000000003,135.23,Incoming
55819086,2023-02-10,-342.27000000000004,98.96,Outgoing
55819086,2023-02-13,-290.56000000000006,51.71,Incoming
55819086,2023-02-14,-375.52000000000004,84.96,Outgoing
55912413,2023-01-31,297.61,,-
55912413,2023-02-03,388.19,90.58,Incoming
55912413,2023-02-03,311.19,77.0,Outgoing
55912413,2023-02-11,413.27,102.08,Incoming
55912413,2023-02-13,316.21999999999997,97.05,Outgoing
55912413,2023-02-13,341.88,25.66,Incoming
55916056,2023-01-31,377.36,,-
55916056,2023-02-06,233.92000000000002,143.44,Outgoing
55916056,2023-02-06,294.0,60.08,Incoming
55916056,2023-02-06,472.4,178.4,Incoming
55916056,2023-02-06,-865.6,1338.0,Outgoing
55916056,2023-02-08,-968.63,103.03,Outgoing
55916056,2023-02-10,-888.77,79.86,Incoming
55975906,2023-01-31,112.69,,-
55975906,2023-02-03,207.48000000000002,94.79,Incoming
55975906,2023-02-04,251.98000000000002,44.5,Incoming
55975906,2023-02-05,177.70000000000002,74.28,Outgoing
55975906,2023-02-14,29.07000000000002,148.63,Outgoing
55986027,2023-01-31,38.94,,-
55986027,2023-02-03,139.32,100.38,Incoming
55986027,2023-02-05,40.599999999999994,98.72,Outgoing
55986027,2023-02-06,880.9,840.3,Incoming
55986027,2023-02-09,975.1899999999999,94.29,Incoming
55986027,2023-02-11,1065.9099999999999,90.72,Incoming
55986027,2023-02-12,1105.6799999999998,39.77,Incoming
55986027,2023-02-13,2725.4799999999996,1619.8,Incoming
55986093,2023-01-31,586.34,,-
55986093,2023-02-07,-712.5600000000001,1298.9,Outgoing
55986093,2023-02-08,-623.82,88.74,Incoming
55986093,2023-02-11,-763.6800000000001,139.86,Outgoing
55986093,2023-02-14,-756.3900000000001,7.29,Incoming
55986093,2023-02-14,-620.7800000000001,135.61,Incoming
56041976,2023-01-31,56.45,,-
56041976,2023-02-04,0.5100000000000051,55.94,Outgoing
56041976,2023-02-07,123.5,122.99,Incoming
56041976,2023-02-08,15.670000000000002,107.83,Outgoing
56041976,2023-02-09,-77.84,93.51,Outgoing
56041976,2023-02-10,-66.88,10.96,Incoming
56070421,2023-01-31,286.85,,-
56070421,2023-02-03,352.0,65.15,Incoming
56070421,2023-02-13,238.56,113.44,Outgoing
56094156,2023-01-31,531.43,,-
56094156,2023-02-07,672.1999999999999,140.77,Incoming
56094156,2023-02-08,413.5999999999999,258.6,Outgoing
56094156,2023-02-09,458.6699999999999,45.07,Incoming
56094156,2023-02-10,265.5099999999999,193.16,Outgoing
56094156,2023-02-13,-971.8900000000002,1237.4,Outgoing
56116199,2023-01-31,615.98,,-
56116199,2023-02-01,745.8100000000001,129.83,Incoming
56116199,2023-02-03,781.1300000000001,35.32,Incoming
56116199,2023-02-06,907.6700000000001,126.54,Incoming
56116199,2023-02-10,816.6300000000001,91.04,Outgoing
56120063,2023-01-31,94.32,,-
56120063,2023-02-02,-85.37,179.69,Outgoing
56120063,2023-02-04,3.739999999999995,89.11,Incoming
56120063,2023-02-06,-133.36,137.1,Outgoing
56120063,2023-02-07,-231.78000000000003,98.42,Outgoing
56120063,2023-02-07,-353.91,122.13,Outgoing
56120063,2023-02-08,-179.67000000000002,174.24,Incoming
56120063,2023-02-11,-138.44000000000003,41.23,Incoming
56189750,2023-01-31,365.48,,-
56189750,2023-02-07,487.13,121.65,Incoming
56189750,2023-02-10,537.67,50.54,Incoming
56189750,2023-02-12,382.5,155.17,Outgoing
56189750,2023-02-14,-1854.5,2237.0,Outgoing
56297850,2023-01-31,320.47,,-
56297850,2023-02-01,435.15000000000003,114.68,Incoming
56297850,2023-02-05,382.81000000000006,52.34,Outgoing
56297850,2023-02-08,352.2800000000001,30.53,Outgoing
56297850,2023-02-12,373.8900000000001,21.61,Incoming
56422161,2023-01-31,990.84,,-
56422161,2023-02-07,944.5500000000001,46.29,Outgoing
56422161,2023-02-08,881.6600000000001,62.89,Outgoing
56422161,2023-02-09,770.83,110.83,Outgoing
56422161,2023-02-10,732.45,38.38,Outgoing
56422161,2023-02-14,636.5400000000001,95.91,Outgoing
56422161,2023-02-14,440.70000000000005,195.84,Outgoing
56453199,2023-01-31,605.38,,-
56453199,2023-02-01,676.6,71.22,Incoming
56453199,2023-02-08,782.13,105.53,Incoming
56453199,2023-02-08,1479.9299999999998,697.8,Incoming
56453199,2023-02-10,1534.9499999999998,55.02,Incoming
56458213,2023-01-31,731.3,,-
56458213,2023-02-01,1319.6,588.3,Incoming
56458213,2023-02-02,2670.8,1351.2,Incoming
56458213,2023-02-06,2812.03,141.23,Incoming
56458213,2023-02-10,2932.84,120.81,Incoming
56458213,2023-02-12,3053.84,121.0,Incoming
56458213,2023-02-14,2872.6000000000004,181.24,Outgoing
56468624,2023-01-31,655.33,,-
56468624,2023-02-03,639.13,16.2,Outgoing
56468624,2023-02-03,727.87,88.74,Incoming
56468624,2023-02-08,635.49,92.38,Outgoing
56468624,2023-02-12,-274.61,910.1,Outgoing
56468624,2023-02-13,-205.68,68.93,Incoming
56483442,2023-01-31,151.85,,-
56483442,2023-02-02,1450.6499999999999,1298.8,Incoming
56483442,2023-02-10,1287.4699999999998,163.18,Outgoing
56573058,2023-01-31,34.66,,-
56573058,2023-02-01,-94.86000000000001,129.52,Outgoing
56573058,2023-02-02,-33.66000000000001,61.2,Incoming
56573058,2023-02-04,-71.41000000000001,37.75,Outgoing
56573058,2023-02-04,-234.99,163.58,Outgoing
56573058,2023-02-06,-283.87,48.88,Outgoing
56573058,2023-02-07,-146.3,137.57,Incoming
56573058,2023-02-09,-27.480000000000018,118.82,Incoming
56573058,2023-02-12,-934.58,907.1,Outgoing
56573058,2023-02-12,-1148.77,214.19,Outgoing
56573058,2023-02-13,-1094.84,53.93,Incoming
56609826,2023-01-31,14.24,,-
56609826,2023-02-05,-160.72,174.96,Outgoing
56609826,2023-02-09,-295.0,134.28,Outgoing
56609826,2023-02-12,-158.07,136.93,Incoming
56609826,2023-02-14,-245.37,87.3,Outgoing
56723864,2023-01-31,246.21,,-
56723864,2023-02-01,374.70000000000005,128.49,Incoming
56723864,2023-02-02,237.11000000000004,137.59,Outgoing
56723864,2023-02-03,72.75000000000003,164.36,Outgoing
56723864,2023-02-06,-94.70999999999998,167.46,Outgoing
56723864,2023-02-07,-17.869999999999976,76.84,Incoming
56723864,2023-02-11,-87.65999999999998,69.79,Outgoing
56723864,2023-02-11,-205.27999999999997,117.62,Outgoing
56723864,2023-02-12,-100.81999999999998,104.46,Incoming
56723864,2023-02-14,-30.789999999999978,70.03,Incoming
56751728,2023-01-31,610.52,,-
56751728,2023-02-02,739.23,128.71,Incoming
56751728,2023-02-02,832.9300000000001,93.7,Incoming
56751728,2023-02-06,749.1,83.83,Outgoing
56751728,2023-02-07,812.22,63.12,Incoming
56751728,2023-02-08,1786.52,974.3,Incoming
56751728,2023-02-13,1906.68,120.16,Incoming
56759680,2023-01-31,479.7,,-
56759680,2023-02-11,389.04999999999995,90.65,Outgoing
56760248,2023-01-31,571.55,,-
56760248,2023-02-03,620.87,49.32,Incoming
56760248,2023-02-03,563.98,56.89,Outgoing
56760248,2023-02-03,558.6,5.38,Outgoing
56760248,2023-02-06,447.19000000000005,111.41,Outgoing
56760248,2023-02-06,556.7800000000001,109.59,Incoming
56760248,2023-02-06,730.7,173.92,Incoming
56760248,2023-02-08,768.97,38.27,Incoming
56760248,2023-02-09,679.89,89.08,Outgoing
56760248,2023-02-12,781.72,101.83,Incoming
56760248,2023-02-13,424.42,357.3,Outgoing
56842874,2023-01-31,22.02,,-
56842874,2023-02-06,91.22,69.2,Incoming
56842874,2023-02-12,218.42000000000002,127.2,Incoming
56843498,2023-01-31,509.55,,-
56843498,2023-02-01,386.85,122.7,Outgoing
56843498,2023-02-02,282.06,104.79,Outgoing
56843498,2023-02-04,180.54000000000002,101.52,Outgoing
56843498,2023-02-05,340.77,160.23,Incoming
56843498,2023-02-05,1685.87,1345.1,Incoming
56843498,2023-02-09,1550.6399999999999,135.23,Outgoing
56843498,2023-02-09,393.7399999999998,1156.9,Outgoing
56843498,2023-02-13,515.6399999999998,121.9,Incoming
56875373,2023-01-31,633.79,,-
56875373,2023-02-01,705.52,71.73,Incoming
56875373,2023-02-03,601.73,103.79,Outgoing
56875373,2023-02-04,702.39,100.66,Incoming
56875373,2023-02-07,771.78,69.39,Incoming
56875373,2023-02-11,612.01,159.77,Outgoing
56878640,2023-01-31,846.85,,-
56878640,2023-02-03,707.69,139.16,Outgoing
56878640,2023-02-05,608.45,99.24,Outgoing
56878640,2023-02-10,486.74000000000007,121.71,Outgoing
56878640,2023-02-12,637.83,151.09,Incoming
56878640,2023-02-12,601.19,36.64,Outgoing
56899079,2023-01-31,445.39,,-
56899079,2023-02-09,1272.69,827.3,Incoming
56922739,2023-01-31,174.07,,-
56922739,2023-02-03,394.21,220.14,Incoming
56922739,2023-02-05,292.03999999999996,102.17,Outgoing
56922739,2023-02-07,372.97999999999996,80.94,Incoming
56922739,2023-02-11,479.98999999999995,107.01,Incoming
56936624,2023-01-31,503.74,,-
56936624,2023-02-02,-1417.66,1921.4,Outgoing
56936624,2023-02-03,-1490.97,73.31,Outgoing
56936624,2023-02-03,-1389.17,101.8,Incoming
56936624,2023-02-07,-1494.3500000000001,105.18,Outgoing
56936624,2023-02-12,-1619.6200000000001,125.27,Outgoing
56936624,2023-02-14,-1453.2400000000002,166.38,Incoming
56946115,2023-01-31,298.13,,-
56946115,2023-02-02,343.35,45.22,Incoming
56946115,2023-02-07,269.0,74.35,Outgoing
56946115,2023-02-12,361.42,92.42,Incoming
57027965,2023-01-31,979.57,,-
57027965,2023-02-02,1094.8600000000001,115.29,Incoming
57027965,2023-02-02,991.1100000000001,103.75,Outgoing
57027965,2023-02-02,1103.0100000000002,111.9,Incoming
57027965,2023-02-05,1212.2500000000002,109.24,Incoming
57027965,2023-02-06,1409.8600000000001,197.61,Incoming
57027965,2023-02-08,1502.45,92.59,Incoming
57027965,2023-02-09,1447.76,54.69,Outgoing
57027965,2023-02-10,1658.38,210.62,Incoming
57027965,2023-02-11,1507.3600000000001,151.02,Outgoing
57027965,2023-02-14,1634.7,127.34,Incoming
57043647,2023-01-31,552.06,,-
57043647,2023-02-01,655.41,103.35,Incoming
57043647,2023-02-03,596.5999999999999,58.81,Outgoing
57043647,2023-02-03,472.4199999999999,124.18,Outgoing
57043647,2023-02-09,525.9799999999999,53.56,Incoming
57043647,2023-02-11,373.51999999999987,152.46,Outgoing
57043647,2023-02-12,359.2599999999999,14.26,Outgoing
57043647,2023-02-13,252.08999999999986,107.17,Outgoing
57043647,2023-02-13,1459.6899999999998,1207.6,Incoming
57063886,2023-01-31,384.17,,-
57063886,2023-02-04,249.71,134.46,Outgoing
57063886,2023-02-07,215.73000000000002,33.98,Outgoing
57063886,2023-02-09,325.87,110.14,Incoming
57063886,2023-02-10,143.12,182.75,Outgoing
57063886,2023-02-13,241.56,98.44,Incoming
57071366,2023-01-31,911.45,,-
57071366,2023-02-01,830.87,80.58,Outgoing
57071366,2023-02-01,754.69,76.18,Outgoing
57071366,2023-02-03,774.58,19.89,Incoming
57071366,2023-02-03,677.95,96.63,Outgoing
57071366,2023-02-08,589.3900000000001,88.56,Outgoing
57071366,2023-02-09,645.2200000000001,55.83,Incoming
57071366,2023-02-09,770.9000000000001,125.68,Incoming
57071366,2023-02-11,720.94,49.96,Outgoing
57084496,2023-01-31,58.05,,-
57084496,2023-02-01,-1000.6500000000001,1058.7,Outgoing
57084496,2023-02-01,-1803.25,802.6,Outgoing
57084496,2023-02-04,-1681.42,121.83,Incoming
57084496,2023-02-07,-1700.03,18.61,Outgoing
57084496,2023-02-10,-1708.8799999999999,8.85,Outgoing
57084496,2023-02-10,-1626.55,82.33,Incoming
57084496,2023-02-12,-375.3499999999999,1251.2,Incoming
57084496,2023-02-14,-312.3499999999999,63.0,Incoming
57096259,2023-01-31,540.54,,-
57096259,2023-02-02,371.55999999999995,168.98,Outgoing
57096259,2023-02-03,270.25999999999993,101.3,Outgoing
57096259,2023-02-05,1177.36,907.1,Incoming
57096259,2023-02-05,1099.4099999999999,77.95,Outgoing
57096259,2023-02-06,1124.2499999999998,24.84,Incoming
57096259,2023-02-09,1026.3599999999997,97.89,Outgoing
57108303,2023-01-31,737.04,,-
57108303,2023-02-03,618.41,118.63,Outgoing
57108303,2023-02-04,2414.21,1795.8,Incoming
57108303,2023-02-05,2364.43,49.78,Outgoing
57108303,2023-02-13,2266.45,97.98,Outgoing
57121657,2023-01-31,847.9,,-
57121657,2023-02-01,712.3499999999999,135.55,Outgoing
57121657,2023-02-05,657.56,54.79,Outgoing
57121657,2023-02-08,557.29,100.27,Outgoing
57121657,2023-02-08,567.27,9.98,Incoming
57121657,2023-02-08,-229.02999999999997,796.3,Outgoing
57121657,2023-02-12,-94.66999999999996,134.36,Incoming
57121657,2023-02-12,-28.739999999999952,65.93,Incoming
57121657,2023-02-13,-183.31999999999996,154.58,Outgoing
57121657,2023-02-14,-280.29999999999995,96.98,Outgoing
57133159,2023-01-31,734.4,,-
57133159,2023-02-09,632.05,102.35,Outgoing
57133159,2023-02-13,503.93999999999994,128.11,Outgoing
57145139,2023-01-31,708.46,,-
57145139,2023-02-02,770.7900000000001,62.33,Incoming
57145139,2023-02-04,956.8000000000001,186.01,Incoming
57145139,2023-02-05,2190.5,1233.7,Incoming
57145139,2023-02-07,2047.46,143.04,Outgoing
57145139,2023-02-07,1938.58,108.88,Outgoing
57145139,2023-02-07,2020.54,81.96,Incoming
57145139,2023-02-08,2120.81,100.27,Incoming
57148382,2023-01-31,638.49,,-
57148382,2023-02-01,557.33,81.16,Outgoing
57148382,2023-02-04,683.51,126.18,Incoming
57148382,2023-02-05,839.15,155.64,Incoming
57148382,2023-02-06,1715.65,876.5,Incoming
57148382,2023-02-07,1800.9,85.25,Incoming
57148382,2023-02-10,1695.8200000000002,105.08,Outgoing
57148382,2023-02-12,1551.66,144.16,Outgoing
57160773,2023-01-31,802.9,,-
57160773,2023-02-01,706.6999999999999,96.2,Outgoing
57160773,2023-02-03,1179.1999999999998,472.5,Incoming
57160773,2023-02-05,1059.9199999999998,119.28,Outgoing
57160773,2023-02-08,1137.7599999999998,77.84,Incoming
57160773,2023-02-10,970.2499999999998,167.51,Outgoing
57160773,2023-02-13,1015.8099999999997,45.56,Incoming
57186194,2023-01-31,824.69,,-
57186194,2023-02-01,931.0200000000001,106.33,Incoming
57186194,2023-02-02,1040.0800000000002,109.06,Incoming
57186194,2023-02-05,1152.0000000000002,111.92,Incoming
57186194,2023-02-09,1333.3100000000002,181.31,Incoming
57186194,2023-02-13,1285.18,48.13,Outgoing
57186194,2023-02-14,2042.08,756.9,Incoming
57186194,2023-02-14,1883.6999999999998,158.38,Outgoing
57224848,2023-01-31,30.59,,-
57224848,2023-02-02,105.09,74.5,Incoming
57224848,2023-02-02,8.240000000000009,96.85,Outgoing
57224848,2023-02-05,85.24000000000001,77.0,Incoming
57224848,2023-02-07,-0.4899999999999949,85.73,Outgoing
57224848,2023-02-10,1986.81,1987.3,Incoming
57224848,2023-02-12,2014.55,27.74,Incoming
57224848,2023-02-12,2127.13,112.58,Incoming
57273397,2023-01-31,403.21,,-
57273397,2023-02-06,537.29,134.08,Incoming
57273397,2023-02-06,383.04999999999995,154.24,Outgoing
57273397,2023-02-09,346.55999999999995,36.49,Outgoing
57273397,2023-02-11,265.29999999999995,81.26,Outgoing
57273397,2023-02-11,148.13999999999996,117.16,Outgoing
57273397,2023-02-13,334.43999999999994,186.3,Incoming
57273397,2023-02-14,431.53,97.09,Incoming
57300901,2023-01-31,302.87,,-
57300901,2023-02-01,368.22,65.35,Incoming
57300901,2023-02-03,440.25,72.03,Incoming
57300901,2023-02-03,332.12,108.13,Outgoing
57300901,2023-02-04,1652.3200000000002,1320.2,Incoming
57300901,2023-02-04,1438.5200000000002,213.8,Outgoing
57300901,2023-02-09,1516.6200000000001,78.1,Incoming
57300901,2023-02-10,1678.98,162.36,Incoming
57300901,2023-02-12,1541.8400000000001,137.14,Outgoing
57300901,2023-02-12,1441.0300000000002,100.81,Outgoing
57302841,2023-01-31,341.02,,-
57302841,2023-02-01,268.83,72.19,Outgoing
57302841,2023-02-08,115.83999999999997,152.99,Outgoing
57302841,2023-02-08,206.95,91.11,Incoming
57302841,2023-02-13,341.91999999999996,134.97,Incoming
57372684,2023-01-31,249.26,,-
57372684,2023-02-01,137.77999999999997,111.48,Outgoing
57372684,2023-02-02,-99.24000000000004,237.02,Outgoing
57372684,2023-02-06,42.13999999999996,141.38,Incoming
57372684,2023-02-08,94.58999999999996,52.45,Incoming
57372684,2023-02-10,-26.700000000000045,121.29,Outgoing
57372684,2023-02-10,67.43999999999996,94.14,Incoming
57372684,2023-02-12,161.00999999999993,93.57,Incoming
57395511,2023-01-31,747.89,,-
57395511,2023-02-02,899.48,151.59,Incoming
57395511,2023-02-06,991.33,91.85,Incoming
57395511,2023-02-07,870.83,120.5,Outgoing
57395511,2023-02-09,953.4000000000001,82.57,Incoming
57395511,2023-02-11,868.0400000000001,85.36,Outgoing
57395511,2023-02-12,963.2900000000001,95.25,Incoming
57395511,2023-02-13,839.6000000000001,123.69,Outgoing
57395511,2023-02-14,922.7100000000002,83.11,Incoming
57413609,2023-01-31,219.01,,-
57413609,2023-02-08,249.22,30.21,Incoming
57413609,2023-02-12,317.43,68.21,Incoming
57426365,2023-01-31,606.03,,-
57426365,2023-02-01,482.79999999999995,123.23,Outgoing
57426365,2023-02-01,388.50999999999993,94.29,Outgoing
57426365,2023-02-01,323.15999999999997,65.35,Outgoing
57426365,2023-02-03,270.89,52.27,Outgoing
57426365,2023-02-05,347.13,76.24,Incoming
57426365,2023-02-05,340.26,6.87,Outgoing
57426365,2023-02-06,466.75,126.49,Incoming
57426365,2023-02-10,413.82,52.93,Outgoing
57426365,2023-02-12,514.43,100.61,Incoming
57426365,2023-02-14,476.8399999999999,37.59,Outgoing
57436108,2023-01-31,899.46,,-
57436108,2023-02-02,998.24,98.78,Incoming
57436108,2023-02-02,948.48,49.76,Outgoing
57436108,2023-02-04,2297.6800000000003,1349.2,Incoming
57436108,2023-02-05,2427.17,129.49,Incoming
57436108,2023-02-10,2530.66,103.49,Incoming
57436108,2023-02-13,2403.0499999999997,127.61,Outgoing
57446648,2023-01-31,542.41,,-
57446648,2023-02-02,363.21999999999997,179.19,Outgoing
57446648,2023-02-06,-837.8799999999999,1201.1,Outgoing
57446648,2023-02-09,-961.4999999999999,123.62,Outgoing
57446648,2023-02-12,-1091.34,129.84,Outgoing
57450523,2023-01-31,609.41,,-
57450523,2023-02-03,527.0,82.41,Outgoing
57450523,2023-02-06,609.1,82.1,Incoming
57450523,2023-02-08,549.63,59.47,Outgoing
57450523,2023-02-11,627.38,77.75,Incoming
57450523,2023-02-11,1618.98,991.6,Incoming
57450523,2023-02-12,1481.15,137.83,Outgoing
57507102,2023-01-31,374.17,,-
57507102,2023-02-01,458.31,84.14,Incoming
57507102,2023-02-09,490.18,31.87,Incoming
57507102,2023-02-11,638.22,148.04,Incoming
57507102,2023-02-12,606.47,31.75,Outgoing
57507102,2023-02-13,490.25,116.22,Outgoing
57507102,2023-02-14,415.53,74.72,Outgoing
57584855,2023-01-31,37.86,,-
57584855,2023-02-01,121.23,83.37,Incoming
57584855,2023-02-07,246.47,125.24,Incoming
57584855,2023-02-09,91.47,155.0,Outgoing
57584855,2023-02-11,10.269999999999996,81.2,Outgoing
57584855,2023-02-11,61.449999999999996,51.18,Incoming
57584855,2023-02-12,118.41,56.96,Incoming
57610201,2023-01-31,931.52,,-
57610201,2023-02-03,1608.02,676.5,Incoming
57610201,2023-02-04,1510.12,97.9,Outgoing
57610201,2023-02-06,1568.83,58.71,Incoming
57610201,2023-02-11,1625.1999999999998,56.37,Incoming
57610201,2023-02-12,1770.8799999999999,145.68,Incoming
57610201,2023-02-12,1744.8999999999999,25.98,Outgoing
57610201,2023-02-13,1903.1899999999998,158.29,Incoming
57610201,2023-02-14,1838.3199999999997,64.87,Outgoing
57612494,2023-01-31,499.3,,-
57612494,2023-02-05,389.70000000000005,109.6,Outgoing
57612494,2023-02-12,286.38000000000005,103.32,Outgoing
57612494,2023-02-12,330.47,44.09,Incoming
57675131,2023-01-31,410.85,,-
57675131,2023-02-02,320.78000000000003,90.07,Outgoing
57675131,2023-02-04,208.56000000000003,112.22,Outgoing
57675131,2023-02-07,359.48,150.92,Incoming
57675131,2023-02-07,236.24,123.24,Outgoing
57687949,2023-01-31,542.92,,-
57687949,2023-02-01,423.71999999999997,119.2,Outgoing
57687949,2023-02-03,511.73999999999995,88.02,Incoming
57687949,2023-02-07,300.53999999999996,211.2,Outgoing
57687949,2023-02-08,420.04999999999995,119.51,Incoming
57687949,2023-02-09,-262.55000000000007,682.6,Outgoing
57687949,2023-02-12,-406.0200000000001,143.47,Outgoing
57687949,2023-02-13,-311.3300000000001,94.69,Incoming
57717550,2023-01-31,832.39,,-
57717550,2023-02-01,936.0699999999999,103.68,Incoming
57717550,2023-02-01,816.8599999999999,119.21,Outgoing
57717550,2023-02-03,942.6299999999999,125.77,Incoming
57717550,2023-02-09,881.4999999999999,61.13,Outgoing
57790631,2023-01-31,893.46,,-
57790631,2023-02-01,998.62,105.16,Incoming
57790631,2023-02-09,1069.88,71.26,Incoming
57790631,2023-02-11,903.0800000000002,166.8,Outgoing
57790631,2023-02-14,2042.7800000000002,1139.7,Incoming
57886631,2023-01-31,369.6,,-
57886631,2023-02-05,308.51,61.09,Outgoing
57886631,2023-02-06,-235.39,543.9,Outgoing
57886631,2023-02-07,-288.37,52.98,Outgoing
57886631,2023-02-08,-174.01,114.36,Incoming
57886631,2023-02-11,-284.51,110.5,Outgoing
57886631,2023-02-11,-129.84,154.67,Incoming
57886631,2023-02-12,-43.91,85.93,Incoming
57886631,2023-02-13,99.22999999999999,143.14,Incoming
57897038,2023-01-31,399.72,,-
57897038,2023-02-01,438.39000000000004,38.67,Incoming
57897038,2023-02-02,392.08000000000004,46.31,Outgoing
57897038,2023-02-04,273.74,118.34,Outgoing
57897038,2023-02-06,154.13,119.61,Outgoing
57897038,2023-02-09,1807.23,1653.1,Incoming
57897038,2023-02-11,1895.64,88.41,Incoming
57941886,2023-01-31,270.81,,-
57941886,2023-02-02,104.71000000000001,166.1,Outgoing
57941886,2023-02-02,-119.41,224.12,Outgoing
57941886,2023-02-06,34.66,154.07,Incoming
57941886,2023-02-08,94.63,59.97,Incoming
57941886,2023-02-12,56.209999999999994,38.42,Outgoing
57941886,2023-02-14,93.57999999999998,37.37,Incoming
57948925,2023-01-31,194.11,,-
57948925,2023-02-03,289.40000000000003,95.29,Incoming
57948925,2023-02-04,1754.9,1465.5,Incoming
57948925,2023-02-07,1572.21,182.69,Outgoing
57948925,2023-02-09,1668.38,96.17,Incoming
57948925,2023-02-09,1675.5,7.12,Incoming
57948925,2023-02-13,3181.2,1505.7,Incoming
57975842,2023-01-31,101.94,,-
57975842,2023-02-10,-79.06,181.0,Outgoing
58009817,2023-01-31,887.22,,-
58009817,2023-02-02,766.12,121.1,Outgoing
58009817,2023-02-03,911.04,144.92,Incoming
58009817,2023-02-04,760.28,150.76,Outgoing
58009817,2023-02-05,816.9,56.62,Incoming
58009817,2023-02-06,881.5699999999999,64.67,Incoming
58009817,2023-02-08,904.54,22.97,Incoming
58009817,2023-02-08,793.49,111.05,Outgoing
58009817,2023-02-12,2147.8900000000003,1354.4,Incoming
58099419,2023-01-31,185.74,,-
58099419,2023-02-01,338.03,152.29,Incoming
58099419,2023-02-05,193.85999999999999,144.17,Outgoing
58099419,2023-02-14,273.86,80.0,Incoming
58126511,2023-01-31,940.27,,-
58126511,2023-02-03,864.16,76.11,Outgoing
58126511,2023-02-03,949.4599999999999,85.3,Incoming
58126511,2023-02-04,-689.7400000000001,1639.2,Outgoing
58126511,2023-02-05,-541.4100000000001,148.33,Incoming
58126511,2023-02-07,-442.6400000000001,98.77,Incoming
58126511,2023-02-08,-531.6300000000001,88.99,Outgoing
58126511,2023-02-09,-485.9300000000001,45.7,Incoming
58126511,2023-02-11,-364.7700000000001,121.16,Incoming
58126511,2023-02-13,-473.0400000000001,108.27,Outgoing
58126511,2023-02-14,-563.1500000000001,90.11,Outgoing
58126511,2023-02-14,-599.3500000000001,36.2,Outgoing
58176810,2023-01-31,219.07,,-
58176810,2023-02-02,244.92,25.85,Incoming
58176810,2023-02-03,350.03,105.11,Incoming
58176810,2023-02-05,236.72999999999996,113.3,Outgoing
58176810,2023-02-09,341.05999999999995,104.33,Incoming
58176810,2023-02-14,207.34999999999994,133.71,Outgoing
58182495,2023-01-31,223.57,,-
58182495,2023-02-05,1173.17,949.6,Incoming
58182495,2023-02-12,1331.99,158.82,Incoming
58216756,2023-01-31,642.13,,-
58216756,2023-02-02,591.13,51.0,Outgoing
58216756,2023-02-02,476.03999999999996,115.09,Outgoing
58216756,2023-02-03,-149.46000000000004,625.5,Outgoing
58216756,2023-02-06,-269.63000000000005,120.17,Outgoing
58216756,2023-02-09,-190.58000000000004,79.05,Incoming
58216756,2023-02-11,-99.55000000000004,91.03,Incoming
58216756,2023-02-12,1591.3500000000001,1690.9,Incoming
58216756,2023-02-13,1759.17,167.82,Incoming
58249518,2023-01-31,14.63,,-
58249518,2023-02-07,-42.21,56.84,Outgoing
58249518,2023-02-12,41.82,84.03,Incoming
58254002,2023-01-31,94.53,,-
58254002,2023-02-01,186.19,91.66,Incoming
58254002,2023-02-11,351.96000000000004,165.77,Incoming
58254002,2023-02-11,167.30000000000004,184.66,Outgoing
58254002,2023-02-11,121.46000000000004,45.84,Outgoing
58254002,2023-02-11,-39.789999999999964,161.25,Outgoing
58254002,2023-02-13,1218.31,1258.1,Incoming
58254002,2023-02-14,1255.8999999999999,37.59,Incoming
58254002,2023-02-14,1397.07,141.17,Incoming
58258401,2023-01-31,873.05,,-
58258401,2023-02-03,718.0999999999999,154.95,Outgoing
58258401,2023-02-06,837.68,119.58,Incoming
58258401,2023-02-06,1016.56,178.88,Incoming
58258401,2023-02-07,1141.07,124.51,Incoming
58258401,2023-02-12,1246.27,105.2,Incoming
58265755,2023-01-31,494.05,,-
58265755,2023-02-01,337.16,156.89,Outgoing
58265755,2023-02-02,461.37,124.21,Incoming
58265755,2023-02-03,282.83000000000004,178.54,Outgoing
58265755,2023-02-03,410.27000000000004,127.44,Incoming
58265755,2023-02-07,525.08,114.81,Incoming
58265755,2023-02-08,698.8900000000001,173.81,Incoming
58265755,2023-02-14,582.1500000000001,116.74,Outgoing
58290957,2023-01-31,580.25,,-
58290957,2023-02-06,737.36,157.11,Incoming
58290957,2023-02-10,871.6,134.24,Incoming
58304487,2023-01-31,5.31,,-
58304487,2023-02-03,121.06,115.75,Incoming
58304487,2023-02-03,61.86,59.2,Outgoing
58304487,2023-02-04,-33.269999999999996,95.13,Outgoing
58304487,2023-02-09,113.06000000000002,146.33,Incoming
58304487,2023-02-13,199.71000000000004,86.65,Incoming
58305943,2023-01-31,970.56,,-
58305943,2023-02-01,912.54,58.02,Outgoing
58305943,2023-02-02,1077.1399999999999,164.6,Incoming
58305943,2023-02-04,959.0599999999998,118.08,Outgoing
58305943,2023-02-04,859.1299999999999,99.93,Outgoing
58305943,2023-02-07,981.6599999999999,122.53,Incoming
58305943,2023-02-07,1106.08,124.42,Incoming
58305943,2023-02-08,1228.26,122.18,Incoming
58305943,2023-02-09,1367.11,138.85,Incoming
58305943,2023-02-10,1481.11,114.0,Incoming
58306431,2023-01-31,576.56,,-
58306431,2023-02-01,679.4499999999999,102.89,Incoming
58306431,2023-02-02,575.9799999999999,103.47,Outgoing
58306431,2023-02-03,699.3599999999999,123.38,Incoming
58306431,2023-02-04,663.9699999999999,35.39,Outgoing
58306431,2023-02-06,-78.33000000000004,742.3,Outgoing
58306431,2023-02-12,0.5799999999999557,78.91,Incoming
58306431,2023-02-12,202.79999999999995,202.22,Incoming
58306431,2023-02-13,134.91999999999996,67.88,Outgoing
58306431,2023-02-14,1620.52,1485.6,Incoming
58332273,2023-01-31,299.3,,-
58332273,2023-02-06,479.12,179.82,Incoming
58332273,2023-02-09,406.07,73.05,Outgoing
58332273,2023-02-12,386.11,19.96,Outgoing
58345258,2023-01-31,749.07,,-
58345258,2023-02-02,604.5600000000001,144.51,Outgoing
58345258,2023-02-06,43.260000000000105,561.3,Outgoing
58345258,2023-02-08,991.0600000000001,947.8,Incoming
58345258,2023-02-11,921.36,69.7,Outgoing
58345258,2023-02-13,103.65999999999997,817.7,Outgoing
58362636,2023-01-31,89.45,,-
58362636,2023-02-06,129.28,39.83,Incoming
58362636,2023-02-07,-0.37999999999999545,129.66,Outgoing
58362636,2023-02-08,-120.69,120.31,Outgoing
58362636,2023-02-12,-216.53,95.84,Outgoing
58384131,2023-01-31,327.68,,-
58384131,2023-02-01,169.11,158.57,Outgoing
58384131,2023-02-05,241.21,72.1,Incoming
58384131,2023-02-09,388.33000000000004,147.12,Incoming
58384131,2023-02-09,458.80000000000007,70.47,Incoming
58385320,2023-01-31,693.52,,-
58385320,2023-02-05,890.53,197.01,Incoming
58385320,2023-02-05,1011.9399999999999,121.41,Incoming
58385320,2023-02-05,1101.1699999999998,89.23,Incoming
58385320,2023-02-06,517.4699999999998,583.7,Outgoing
58385320,2023-02-10,597.3399999999998,79.87,Incoming
58400012,2023-01-31,606.79,,-
58400012,2023-02-01,535.06,71.73,Outgoing
58400012,2023-02-11,475.9599999999999,59.1,Outgoing
58434725,2023-01-31,365.9,,-
58434725,2023-02-03,413.64,47.74,Incoming
58434725,2023-02-03,501.28999999999996,87.65,Incoming
58434725,2023-02-09,571.28,69.99,Incoming
58434725,2023-02-11,508.80999999999995,62.47,Outgoing
58434725,2023-02-14,417.0799999999999,91.73,Outgoing
58458443,2023-01-31,903.64,,-
58458443,2023-02-03,990.6899999999999,87.05,Incoming
58458443,2023-02-07,1171.32,180.63,Incoming
58489789,2023-01-31,460.5,,-
58489789,2023-02-02,581.22,120.72,Incoming
58489789,2023-02-02,541.35,39.87,Outgoing
58489789,2023-02-04,595.9200000000001,54.57,Incoming
58489789,2023-02-06,693.0100000000001,97.09,Incoming
58489789,2023-02-07,802.3300000000002,109.32,Incoming
58489789,2023-02-10,703.7000000000002,98.63,Outgoing
58489789,2023-02-14,812.1800000000002,108.48,Incoming
58491429,2023-01-31,937.47,,-
58491429,2023-02-05,1015.4200000000001,77.95,Incoming
58491429,2023-02-06,2502.32,1486.9,Incoming
58491429,2023-02-07,2606.06,103.74,Incoming
58491429,2023-02-10,2699.08,93.02,Incoming
58533748,2023-01-31,490.86,,-
58533748,2023-02-04,604.35,113.49,Incoming
58533748,2023-02-08,684.48,80.13,Incoming
58533748,2023-02-14,593.62,90.86,Outgoing
58533748,2023-02-14,733.44,139.82,Incoming
58533748,2023-02-14,1055.3400000000001,321.9,Incoming
58547184,2023-01-31,218.22,,-
58547184,2023-02-02,156.56,61.66,Outgoing
58547184,2023-02-02,-1430.04,1586.6,Outgoing
58547184,2023-02-04,-1415.4099999999999,14.63,Incoming
58547184,2023-02-05,-1499.2399999999998,83.83,Outgoing
58547184,2023-02-06,-1606.8499999999997,107.61,Outgoing
58547184,2023-02-11,-1464.4399999999996,142.41,Incoming
58547184,2023-02-11,-1394.5999999999997,69.84,Incoming
58558145,2023-01-31,495.35,,-
58558145,2023-02-10,609.59,114.24,Incoming
58558145,2023-02-11,700.97,91.38,Incoming
58558145,2023-02-13,609.1700000000001,91.8,Outgoing
58586275,2023-01-31,916.97,,-
58586275,2023-02-07,958.61,41.64,Incoming
58586275,2023-02-07,-20.68999999999994,979.3,Outgoing
58586275,2023-02-10,81.37000000000006,102.06,Incoming
58586275,2023-02-12,203.05000000000007,121.68,Incoming
58668564,2023-01-31,813.28,,-
58668564,2023-02-01,919.13,105.85,Incoming
58668564,2023-02-08,1009.22,90.09,Incoming
58668564,2023-02-11,-115.77999999999997,1125.0,Outgoing
58668564,2023-02-12,-6.819999999999979,108.96,Incoming
58668564,2023-02-14,-64.64999999999998,57.83,Outgoing
58683711,2023-01-31,12.76,,-
58683711,2023-02-01,128.16,115.4,Incoming
58683711,2023-02-05,86.61,41.55,Outgoing
58683711,2023-02-10,-39.879999999999995,126.49,Outgoing
58683711,2023-02-10,-128.41,88.53,Outgoing
58683711,2023-02-14,-128.77,0.36,Outgoing
58703801,2023-01-31,520.81,,-
58703801,2023-02-09,621.5899999999999,100.78,Incoming
58703801,2023-02-10,456.17999999999995,165.41,Outgoing
58703801,2023-02-12,623.0799999999999,166.9,Incoming
58703801,2023-02-13,569.15,53.93,Outgoing
58720727,2023-01-31,471.56,,-
58720727,2023-02-03,614.4200000000001,142.86,Incoming
58720727,2023-02-04,506.18000000000006,108.24,Outgoing
58720727,2023-02-05,568.5500000000001,62.37,Incoming
58720727,2023-02-08,660.6600000000001,92.11,Incoming
58720727,2023-02-11,803.33,142.67,Incoming
58720727,2023-02-11,853.2900000000001,49.96,Incoming
58720727,2023-02-12,966.8900000000001,113.6,Incoming
58720727,2023-02-13,1047.5300000000002,80.64,Incoming
58720727,2023-02-14,2698.4300000000003,1650.9,Incoming
58728550,2023-01-31,250.26,,-
58728550,2023-02-04,288.06,37.8,Incoming
58728550,2023-02-11,173.45,114.61,Outgoing
58785108,2023-01-31,473.41,,-
58785108,2023-02-01,411.54,61.87,Outgoing
58785108,2023-02-04,307.01,104.53,Outgoing
58785108,2023-02-04,371.44,64.43,Incoming
58785108,2023-02-07,1255.04,883.6,Incoming
58785108,2023-02-11,1287.08,32.04,Incoming
58785108,2023-02-13,1100.78,186.3,Outgoing
58810775,2023-01-31,747.44,,-
58810775,2023-02-01,809.44,62.0,Incoming
58810775,2023-02-05,829.61,20.17,Incoming
58810775,2023-02-05,714.64,114.97,Outgoing
58810775,2023-02-07,563.43,151.21,Outgoing
58810775,2023-02-13,661.02,97.59,Incoming
58811985,2023-01-31,616.7,,-
58811985,2023-02-08,-407.89999999999986,1024.6,Outgoing
58811985,2023-02-09,-563.6599999999999,155.76,Outgoing
58811985,2023-02-12,-436.6899999999998,126.97,Incoming
58811985,2023-02-14,-522.0599999999998,85.37,Outgoing
58822254,2023-01-31,79.7,,-
58822254,2023-02-02,1638.9,1559.2,Incoming
58822254,2023-02-03,2075.4,436.5,Incoming
58822254,2023-02-04,1945.8400000000001,129.56,Outgoing
58822254,2023-02-08,1903.41,42.43,Outgoing
58822254,2023-02-10,1774.3000000000002,129.11,Outgoing
58830897,2023-01-31,834.24,,-
58830897,2023-02-02,856.78,22.54,Incoming
58830897,2023-02-04,912.72,55.94,Incoming
58830897,2023-02-05,1023.64,110.92,Incoming
58830897,2023-02-06,1140.66,117.02,Incoming
58830897,2023-02-11,988.19,152.47,Outgoing
58830897,2023-02-12,1202.38,214.19,Incoming
58830897,2023-02-14,1064.46,137.92,Outgoing
58837121,2023-01-31,160.48,,-
58837121,2023-02-04,63.41999999999999,97.06,Outgoing
58837121,2023-02-05,226.73999999999998,163.32,Incoming
58837121,2023-02-07,151.70999999999998,75.03,Outgoing
58837121,2023-02-08,232.42999999999998,80.72,Incoming
58837121,2023-02-11,283.34,50.91,Incoming
58837121,2023-02-11,171.38,111.96,Outgoing
58837121,2023-02-14,68.19999999999999,103.18,Outgoing
58873428,2023-01-31,191.58,,-
58873428,2023-02-07,152.49,39.09,Outgoing
58874842,2023-01-31,347.73,,-
58874842,2023-02-01,400.82000000000005,53.09,Incoming
58874842,2023-02-07,583.9300000000001,183.11,Incoming
58874842,2023-02-08,477.56000000000006,106.37,Outgoing
58874842,2023-02-09,323.5200000000001,154.04,Outgoing
58874842,2023-02-10,265.8800000000001,57.64,Outgoing
58874842,2023-02-14,179.0200000000001,86.86,Outgoing
58897654,2023-01-31,210.05,,-
58897654,2023-02-04,96.08000000000001,113.97,Outgoing
58897654,2023-02-05,-97.11999999999998,193.2,Outgoing
58925998,2023-01-31,855.45,,-
58925998,2023-02-05,689.4200000000001,166.03,Outgoing
58925998,2023-02-09,633.3000000000001,56.12,Outgoing
58925998,2023-02-10,477.6300000000001,155.67,Outgoing
58925998,2023-02-11,376.7500000000001,100.88,Outgoing
58925998,2023-02-12,-884.8499999999998,1261.6,Outgoing
58930654,2023-01-31,661.48,,-
58930654,2023-02-03,525.05,136.43,Outgoing
58930654,2023-02-04,683.4599999999999,158.41,Incoming
58930654,2023-02-09,728.4599999999999,45.0,Incoming
58930654,2023-02-13,821.8499999999999,93.39,Incoming
58930654,2023-02-13,930.8899999999999,109.04,Incoming
58937028,2023-01-31,626.96,,-
58937028,2023-02-12,540.23,86.73,Outgoing
58995891,2023-01-31,12.92,,-
58995891,2023-02-03,131.68,118.76,Incoming
58995891,2023-02-08,181.99,50.31,Incoming
58995891,2023-02-09,56.750000000000014,125.24,Outgoing
58995891,2023-02-10,163.37,106.62,Incoming
59110895,2023-01-31,605.5,,-
59110895,2023-02-09,1865.5,1260.0,Incoming
59128512,2023-01-31,305.71,,-
59128512,2023-02-01,146.79,158.92,Outgoing
59128512,2023-02-03,52.50999999999999,94.28,Outgoing
59128512,2023-02-07,-1327.99,1380.5,Outgoing
59128512,2023-02-08,-1450.8,122.81,Outgoing
59128512,2023-02-09,-1560.08,109.28,Outgoing
59128512,2023-02-10,-1630.82,70.74,Outgoing
59128512,2023-02-13,-1502.82,128.0,Incoming
59128512,2023-02-13,-1570.1299999999999,67.31,Outgoing
59135815,2023-01-31,240.6,,-
59135815,2023-02-01,1040.6,800.0,Incoming
59135815,2023-02-04,604.0999999999999,436.5,Outgoing
59135815,2023-02-06,712.2399999999999,108.14,Incoming
59135815,2023-02-10,1914.7399999999998,1202.5,Incoming
59152169,2023-01-31,148.6,,-
59152169,2023-02-01,78.1,70.5,Outgoing
59152169,2023-02-05,135.28,57.18,Incoming
59152169,2023-02-05,10.760000000000005,124.52,Outgoing
59152169,2023-02-08,-82.07,92.83,Outgoing
59152169,2023-02-09,1077.93,1160.0,Incoming
59152169,2023-02-12,988.23,89.7,Outgoing
59167707,2023-01-31,904.43,,-
59167707,2023-02-01,1013.75,109.32,Incoming
59167707,2023-02-06,964.28,49.47,Outgoing
59167707,2023-02-06,1025.1299999999999,60.85,Incoming
59167707,2023-02-10,1120.2099999999998,95.08,Incoming
59198134,2023-01-31,122.62,,-
59198134,2023-02-06,-45.97,168.59,Outgoing
59198134,2023-02-09,58.31,104.28,Incoming
59198134,2023-02-13,193.76,135.45,Incoming
59198134,2023-02-13,1485.16,1291.4,Incoming
59201002,2023-01-31,780.85,,-
59201002,2023-02-01,580.86,199.99,Outgoing
59201002,2023-02-01,484.51,96.35,Outgoing
59201002,2023-02-04,528.56,44.05,Incoming
59201002,2023-02-08,692.51,163.95,Incoming
59201002,2023-02-12,1434.51,742.0,Incoming
59235925,2023-01-31,647.8,,-
59235925,2023-02-01,714.23,66.43,Incoming
59235925,2023-02-04,603.05,111.18,Outgoing
59235925,2023-02-06,518.9499999999999,84.1,Outgoing
59235925,2023-02-08,583.2199999999999,64.27,Incoming
59235925,2023-02-08,540.3,42.92,Outgoing
59235925,2023-02-09,641.8299999999999,101.53,Incoming
59235925,2023-02-11,489.8299999999999,152.0,Outgoing
59238438,2023-01-31,105.1,,-
59238438,2023-02-01,92.13,12.97,Outgoing
59238438,2023-02-07,141.89,49.76,Incoming
59238438,2023-02-09,56.56999999999999,85.32,Outgoing
59238438,2023-02-12,1855.77,1799.2,Incoming
59252971,2023-01-31,803.65,,-
59252971,2023-02-05,718.03,85.62,Outgoing
59252971,2023-02-07,2459.9300000000003,1741.9,Incoming
59252971,2023-02-13,2328.32,131.61,Outgoing
59252971,2023-02-14,2498.05,169.73,Incoming
59265775,2023-01-31,695.02,,-
59265775,2023-02-01,639.17,55.85,Outgoing
59265775,2023-02-04,557.23,81.94,Outgoing
59265775,2023-02-05,482.86,74.37,Outgoing
59265775,2023-02-11,414.53000000000003,68.33,Outgoing
59265775,2023-02-12,567.58,153.05,Incoming
59265775,2023-02-12,697.6400000000001,130.06,Incoming
59265775,2023-02-14,554.7800000000001,142.86,Outgoing
59379884,2023-01-31,139.54,,-
59379884,2023-02-05,58.359999999999985,81.18,Outgoing
59379884,2023-02-10,215.29999999999998,156.94,Incoming
59379884,2023-02-11,280.7,65.4,Incoming
59379884,2023-02-12,-283.7,564.4,Outgoing
59379884,2023-02-13,-198.79,84.91,Incoming
59405362,2023-01-31,503.89,,-
59405362,2023-02-01,426.99,76.9,Outgoing
59405362,2023-02-01,290.48,136.51,Outgoing
59405362,2023-02-05,435.27,144.79,Incoming
59405362,2023-02-08,631.17,195.9,Incoming
59405362,2023-02-09,-14.730000000000018,645.9,Outgoing
59405362,2023-02-10,52.20999999999998,66.94,Incoming
59405362,2023-02-11,8.769999999999982,43.44,Outgoing
59432049,2023-01-31,387.57,,-
59432049,2023-02-01,244.57999999999998,142.99,Outgoing
59432049,2023-02-04,-334.12000000000006,578.7,Outgoing
59432049,2023-02-05,-1455.6200000000001,1121.5,Outgoing
59432049,2023-02-06,-1585.5500000000002,129.93,Outgoing
59432049,2023-02-06,-1478.7800000000002,106.77,Incoming
59432049,2023-02-06,-1595.89,117.11,Outgoing
59432049,2023-02-08,-1470.1000000000001,125.79,Incoming
59432049,2023-02-08,-1536.7700000000002,66.67,Outgoing
59432049,2023-02-11,-1361.0800000000002,175.69,Incoming
59432049,2023-02-14,-1327.0100000000002,34.07,Incoming
59450573,2023-01-31,888.65,,-
59450573,2023-02-05,808.39,80.26,Outgoing
59450573,2023-02-09,856.35,47.96,Incoming
59450573,2023-02-10,942.62,86.27,Incoming
59455653,2023-01-31,4.64,,-
59455653,2023-02-04,-3.1000000000000005,7.74,Outgoing
59455653,2023-02-06,126.83000000000001,129.93,Incoming
59455653,2023-02-11,-21.48999999999998,148.32,Outgoing
59455653,2023-02-12,1240.21,1261.7,Incoming
59510370,2023-01-31,523.1,,-
59510370,2023-02-03,490.33000000000004,32.77,Outgoing
59510370,2023-02-04,587.52,97.19,Incoming
59510370,2023-02-06,574.75,12.77,Outgoing
59510370,2023-02-10,637.01,62.26,Incoming
59510370,2023-02-14,690.97,53.96,Incoming
59529922,2023-01-31,516.09,,-
59529922,2023-02-01,646.0,129.91,Incoming
59529922,2023-02-03,750.89,104.89,Incoming
59529922,2023-02-04,645.52,105.37,Outgoing
59529922,2023-02-06,540.9399999999999,104.58,Outgoing
59529922,2023-02-07,542.7099999999999,1.77,Incoming
59529922,2023-02-09,506.6499999999999,36.06,Outgoing
59529922,2023-02-10,628.5699999999999,121.92,Incoming
59529922,2023-02-10,784.79,156.22,Incoming
59529922,2023-02-13,887.0999999999999,102.31,Incoming
59529922,2023-02-14,797.43,89.67,Outgoing
59575867,2023-01-31,576.66,,-
59575867,2023-02-03,571.52,5.14,Outgoing
59575867,2023-02-10,730.72,159.2,Incoming
59575867,2023-02-13,627.28,103.44,Outgoing
59591324,2023-01-31,509.65,,-
59591324,2023-02-05,691.0699999999999,181.42,Incoming
59591324,2023-02-05,-115.13000000000011,806.2,Outgoing
59591324,2023-02-12,-169.1100000000001,53.98,Outgoing
59591324,2023-02-13,-304.56000000000006,135.45,Outgoing
59591324,2023-02-13,-461.45000000000005,156.89,Outgoing
59640238,2023-01-31,993.42,,-
59640238,2023-02-05,863.91,129.51,Outgoing
59640238,2023-02-08,1049.1299999999999,185.22,Incoming
59640238,2023-02-09,1176.36,127.23,Incoming
59640238,2023-02-11,1038.9299999999998,137.43,Outgoing
59653557,2023-01-31,649.61,,-
59653557,2023-02-04,756.07,106.46,Incoming
59653557,2023-02-06,793.97,37.9,Incoming
59653557,2023-02-06,2318.87,1524.9,Incoming
59653557,2023-02-08,2436.22,117.35,Incoming
59663741,2023-01-31,642.86,,-
59663741,2023-02-03,574.4300000000001,68.43,Outgoing
59663741,2023-02-05,461.33000000000004,113.1,Outgoing
59663741,2023-02-05,343.11,118.22,Outgoing
59663741,2023-02-06,245.75,97.36,Outgoing
59663741,2023-02-07,445.15999999999997,199.41,Incoming
59663741,2023-02-09,317.43999999999994,127.72,Outgoing
59663741,2023-02-10,1801.6399999999999,1484.2,Incoming
59663741,2023-02-10,1852.9099999999999,51.27,Incoming
59663741,2023-02-11,1938.8,85.89,Incoming
59663741,2023-02-14,1908.8,30.0,Outgoing
59684752,2023-01-31,14.43,,-
59684752,2023-02-01,133.88,119.45,Incoming
59684752,2023-02-05,241.91,108.03,Incoming
59684752,2023-02-05,401.37,159.46,Incoming
59684752,2023-02-06,555.6700000000001,154.3,Incoming
59684752,2023-02-06,583.6,27.93,Incoming
59684752,2023-02-08,676.44,92.84,Incoming
59684752,2023-02-08,568.4200000000001,108.02,Outgoing
59684752,2023-02-09,676.6500000000001,108.23,Incoming
59684752,2023-02-12,807.3300000000002,130.68,Incoming
59684752,2023-02-13,-1551.7699999999998,2359.1,Outgoing
59705091,2023-01-31,631.05,,-
59705091,2023-02-02,-460.1500000000001,1091.2,Outgoing
59705091,2023-02-04,-357.93000000000006,102.22,Incoming
59705091,2023-02-04,-311.00000000000006,46.93,Incoming
59705091,2023-02-07,-422.37000000000006,111.37,Outgoing
59705091,2023-02-08,-484.56000000000006,62.19,Outgoing
59705091,2023-02-08,-537.8800000000001,53.32,Outgoing
59705091,2023-02-11,1139.62,1677.5,Incoming
59705091,2023-02-13,1212.9299999999998,73.31,Incoming
59737910,2023-01-31,523.19,,-
59737910,2023-02-03,424.05000000000007,99.14,Outgoing
59737910,2023-02-09,291.47,132.58,Outgoing
59737910,2023-02-11,431.33000000000004,139.86,Incoming
59737910,2023-02-11,350.82000000000005,80.51,Outgoing
59855808,2023-01-31,172.54,,-
59855808,2023-02-02,329.95,157.41,Incoming
59855808,2023-02-05,229.71999999999997,100.23,Outgoing
59855808,2023-02-06,434.58,204.86,Incoming
59855808,2023-02-09,380.63,53.95,Outgoing
59855808,2023-02-10,1285.63,905.0,Incoming
59855808,2023-02-12,1344.0200000000002,58.39,Incoming
59855808,2023-02-13,-53.5799999999997,1397.6,Outgoing
59855808,2023-02-14,125.9900000000003,179.57,Incoming
59867000,2023-01-31,62.01,,-
59867000,2023-02-02,-54.88,116.89,Outgoing
59867000,2023-02-06,-165.42000000000002,110.54,Outgoing
59867000,2023-02-08,-41.10000000000002,124.32,Incoming
59867000,2023-02-08,-4.320000000000022,36.78,Incoming
59867000,2023-02-12,840.68,845.0,Incoming
59876714,2023-01-31,938.46,,-
59876714,2023-02-01,468.86,469.6,Outgoing
59876714,2023-02-02,336.02,132.84,Outgoing
59876714,2023-02-07,437.90999999999997,101.89,Incoming
59876714,2023-02-07,303.79999999999995,134.11,Outgoing
59876714,2023-02-11,186.38999999999996,117.41,Outgoing
59876714,2023-02-12,352.53999999999996,166.15,Incoming
59876714,2023-02-13,1888.24,1535.7,Incoming
59933973,2023-01-31,29.98,,-
59933973,2023-02-02,174.04,144.06,Incoming
59933973,2023-02-07,322.32,148.28,Incoming
59933973,2023-02-12,256.39,65.93,Outgoing
59961433,2023-01-31,267.05,,-
59961433,2023-02-01,444.68,177.63,Incoming
59961433,2023-02-01,397.35,47.33,Outgoing
59961433,2023-02-05,-509.75,907.1,Outgoing
59961433,2023-02-09,-432.65999999999997,77.09,Incoming
59961433,2023-02-14,-580.38,147.72,Outgoing
59980709,2023-01-31,781.42,,-
59980709,2023-02-01,681.8599999999999,99.56,Outgoing
59980709,2023-02-03,690.3499999999999,8.49,Incoming
59980709,2023-02-06,-504.5500000000002,1194.9,Outgoing
59984692,2023-01-31,818.03,,-
59984692,2023-02-03,1731.83,913.8,Incoming
59984692,2023-02-05,1907.51,175.68,Incoming
59984692,2023-02-05,2019.17,111.66,Incoming
59984692,2023-02-05,1985.21,33.96,Outgoing
59984692,2023-02-10,1865.29,119.92,Outgoing
59984692,2023-02-14,1858.0,7.29,Outgoing
59989722,2023-01-31,816.77,,-
59989722,2023-02-07,1670.37,853.6,Incoming
59989722,2023-02-09,1748.59,78.22,Incoming
59989722,2023-02-10,1076.59,672.0,Outgoing
60017511,2023-01-31,859.48,,-
60017511,2023-02-03,919.65,60.17,Incoming
60017511,2023-02-03,877.74,41.91,Outgoing
60017511,2023-02-04,-253.55999999999995,1131.3,Outgoing
60017511,2023-02-04,-122.44999999999993,131.11,Incoming
60017511,2023-02-05,-801.15,678.7,Outgoing
60017511,2023-02-11,-857.31,56.16,Outgoing
60017511,2023-02-11,-2220.91,1363.6,Outgoing
60017511,2023-02-13,-2290.16,69.25,Outgoing
60114464,2023-01-31,972.56,,-
60114464,2023-02-03,1016.31,43.75,Incoming
60114464,2023-02-09,1194.92,178.61,Incoming
60114464,2023-02-10,-80.48000000000002,1275.4,Outgoing
60114464,2023-02-10,-1720.88,1640.4,Outgoing
60114464,2023-02-10,-2909.1800000000003,1188.3,Outgoing
60114464,2023-02-11,-1131.3800000000003,1777.8,Incoming
60114464,2023-02-13,-977.7600000000003,153.62,Incoming
60138058,2023-01-31,686.46,,-
60138058,2023-02-03,573.0,113.46,Outgoing
60138058,2023-02-04,513.87,59.13,Outgoing
60138058,2023-02-07,363.88,149.99,Outgoing
60138058,2023-02-08,349.87,14.01,Outgoing
60138058,2023-02-09,459.98,110.11,Incoming
60138058,2023-02-09,414.98,45.0,Outgoing
60138058,2023-02-10,1941.68,1526.7,Incoming
60138058,2023-02-10,2039.46,97.78,Incoming
60184250,2023-01-31,70.89,,-
60184250,2023-02-03,217.27999999999997,146.39,Incoming
60184250,2023-02-04,111.20999999999998,106.07,Outgoing
60184250,2023-02-05,-1414.8899999999999,1526.1,Outgoing
60184250,2023-02-06,-1494.9599999999998,80.07,Outgoing
60184250,2023-02-09,-1421.85,73.11,Incoming
60184250,2023-02-11,-1378.4099999999999,43.44,Incoming
60184250,2023-02-14,-1263.87,114.54,Incoming
60189055,2023-01-31,814.54,,-
60189055,2023-02-02,743.02,71.52,Outgoing
60189055,2023-02-04,1372.02,629.0,Incoming
60189055,2023-02-05,1434.76,62.74,Incoming
60189055,2023-02-08,1298.7,136.06,Outgoing
60189055,2023-02-10,1137.98,160.72,Outgoing
60189055,2023-02-12,1008.53,129.45,Outgoing
60193174,2023-01-31,740.53,,-
60193174,2023-02-02,-586.97,1327.5,Outgoing
60193174,2023-02-04,-382.08000000000004,204.89,Incoming
60193174,2023-02-04,-273.87000000000006,108.21,Incoming
60193174,2023-02-05,-246.72000000000006,27.15,Incoming
60193174,2023-02-10,-315.63000000000005,68.91,Outgoing
60193174,2023-02-10,-417.35,101.72,Outgoing
60193174,2023-02-12,-290.3,127.05,Incoming
60193174,2023-02-13,-342.01,51.71,Outgoing
60202402,2023-01-31,783.7,,-
60202402,2023-02-03,801.98,18.28,Incoming
60202402,2023-02-05,1765.28,963.3,Incoming
60202402,2023-02-12,1682.37,82.91,Outgoing
60202402,2023-02-12,1771.85,89.48,Incoming
60202402,2023-02-12,1861.3999999999999,89.55,Incoming
60202402,2023-02-13,1072.0,789.4,Outgoing
60220702,2023-01-31,937.23,,-
60220702,2023-02-03,974.72,37.49,Incoming
60220702,2023-02-05,1077.68,102.96,Incoming
60220702,2023-02-07,979.07,98.61,Outgoing
60220702,2023-02-10,1055.55,76.48,Incoming
60220702,2023-02-12,1184.49,128.94,Incoming
60222199,2023-01-31,350.4,,-
60222199,2023-02-08,-187.5,537.9,Outgoing
60222199,2023-02-11,-270.99,83.49,Outgoing
60222199,2023-02-12,622.81,893.8,Incoming
60238192,2023-01-31,307.97,,-
60238192,2023-02-02,187.52000000000004,120.45,Outgoing
60238192,2023-02-03,282.57000000000005,95.05,Incoming
60238192,2023-02-05,345.06000000000006,62.49,Incoming
60238192,2023-02-12,142.84000000000006,202.22,Outgoing
60238192,2023-02-13,151.78000000000006,8.94,Incoming
60238192,2023-02-14,82.17000000000006,69.61,Outgoing
60238192,2023-02-14,24.05000000000006,58.12,Outgoing
60367416,2023-01-31,754.86,,-
60367416,2023-02-03,919.0,164.14,Incoming
60367416,2023-02-04,1015.78,96.78,Incoming
60367416,2023-02-05,860.8,154.98,Outgoing
60367416,2023-02-07,965.55,104.75,Incoming
60367416,2023-02-10,889.4,76.15,Outgoing
60367416,2023-02-10,884.98,4.42,Outgoing
60367416,2023-02-11,833.04,51.94,Outgoing
60367416,2023-02-11,667.63,165.41,Outgoing
60371134,2023-01-31,444.57,,-
60371134,2023-02-04,319.5,125.07,Outgoing
60371134,2023-02-07,225.61,93.89,Outgoing
60371134,2023-02-14,321.52,95.91,Incoming
60383549,2023-01-31,268.15,,-
60383549,2023-02-01,229.47999999999996,38.67,Outgoing
60383549,2023-02-06,87.93999999999997,141.54,Outgoing
60383549,2023-02-09,14.82999999999997,73.11,Outgoing
60383549,2023-02-14,-117.00000000000004,131.83,Outgoing
60417212,2023-01-31,653.31,,-
60417212,2023-02-01,722.7099999999999,69.4,Incoming
60417212,2023-02-01,1697.11,974.4,Incoming
60417212,2023-02-04,1815.07,117.96,Incoming
60417212,2023-02-05,1343.67,471.4,Outgoing
60417212,2023-02-07,1370.6000000000001,26.93,Incoming
60417212,2023-02-09,1380.2900000000002,9.69,Incoming
60417212,2023-02-10,1479.2500000000002,98.96,Incoming
60417212,2023-02-11,1374.3600000000001,104.89,Outgoing
60417212,2023-02-11,1240.19,134.17,Outgoing
60417212,2023-02-12,1157.6000000000001,82.59,Outgoing
60417212,2023-02-13,1303.5000000000002,145.9,Incoming
60417212,2023-02-14,1454.9700000000003,151.47,Incoming
60459342,2023-01-31,734.15,,-
60459342,2023-02-02,843.0,108.85,Incoming
60459342,2023-02-03,879.57,36.57,Incoming
60459342,2023-02-07,802.48,77.09,Outgoing
60459342,2023-02-07,699.05,103.43,Outgoing
60459342,2023-02-10,844.91,145.86,Incoming
60459342,2023-02-11,979.0799999999999,134.17,Incoming
60459342,2023-02-12,1113.1299999999999,134.05,Incoming
60459342,2023-02-13,1143.4399999999998,30.31,Incoming
60522190,2023-01-31,965.46,,-
60522190,2023-02-02,913.85,51.61,Outgoing
60522190,2023-02-08,-675.15,1589.0,Outgoing
60522190,2023-02-10,-613.9499999999999,61.2,Incoming
60659147,2023-01-31,323.85,,-
60659147,2023-02-01,463.95000000000005,140.1,Incoming
60659147,2023-02-03,600.87,136.92,Incoming
60659147,2023-02-06,502.0,98.87,Outgoing
60659147,2023-02-10,398.51,103.49,Outgoing
60659147,2023-02-11,497.86,99.35,Incoming
60659147,2023-02-13,569.99,72.13,Incoming
60659147,2023-02-13,555.67,14.32,Outgoing
60667043,2023-01-31,937.62,,-
60667043,2023-02-03,957.45,19.83,Incoming
60667043,2023-02-04,1123.21,165.76,Incoming
60667043,2023-02-04,1984.31,861.1,Incoming
60667043,2023-02-06,2293.0099999999998,308.7,Incoming
60667043,2023-02-09,2196.93,96.08,Outgoing
60667043,2023-02-09,2345.3199999999997,148.39,Incoming
60667043,2023-02-09,2256.5099999999998,88.81,Outgoing
60667043,2023-02-11,3455.5099999999998,1199.0,Incoming
60667043,2023-02-14,3332.6099999999997,122.9,Outgoing
60684197,2023-01-31,752.92,,-
60684197,2023-02-03,932.05,179.13,Incoming
60684197,2023-02-04,791.6199999999999,140.43,Outgoing
60684197,2023-02-06,714.6699999999998,76.95,Outgoing
60684197,2023-02-11,654.4499999999998,60.22,Outgoing
60684197,2023-02-12,696.0399999999998,41.59,Incoming
60707792,2023-01-31,220.35,,-
60707792,2023-02-01,97.83999999999999,122.51,Outgoing
60707792,2023-02-01,223.85,126.01,Incoming
60707792,2023-02-05,124.42999999999999,99.42,Outgoing
60707792,2023-02-06,279.24,154.81,Incoming
60707792,2023-02-14,335.48,56.24,Incoming
60707792,2023-02-14,495.21000000000004,159.73,Incoming
60711202,2023-01-31,869.92,,-
60711202,2023-02-03,1035.31,165.39,Incoming
60711202,2023-02-07,1296.1299999999999,260.82,Incoming
60711202,2023-02-08,1487.77,191.64,Incoming
60711202,2023-02-14,1394.11,93.66,Outgoing
60730902,2023-01-31,243.72,,-
60730902,2023-02-01,261.33,17.61,Incoming
60730902,2023-02-02,346.5,85.17,Incoming
60730902,2023-02-03,402.81,56.31,Incoming
60730902,2023-02-03,416.33,13.52,Incoming
60730902,2023-02-03,483.36,67.03,Incoming
60730902,2023-02-06,527.83,44.47,Incoming
60730902,2023-02-10,335.57000000000005,192.26,Outgoing
60730902,2023-02-10,423.90000000000003,88.33,Incoming
60730902,2023-02-12,518.97,95.07,Incoming
60751083,2023-01-31,115.23,,-
60751083,2023-02-04,245.14999999999998,129.92,Incoming
60751083,2023-02-05,115.43999999999997,129.71,Outgoing
60751083,2023-02-05,139.31999999999996,23.88,Incoming
60751083,2023-02-07,53.54999999999997,85.77,Outgoing
60751083,2023-02-08,-729.1500000000001,782.7,Outgoing
60751083,2023-02-09,-825.4300000000001,96.28,Outgoing
60751083,2023-02-10,-949.1500000000001,123.72,Outgoing
60755797,2023-01-31,207.78,,-
60755797,2023-02-03,372.34000000000003,164.56,Incoming
60755797,2023-02-07,279.27000000000004,93.07,Outgoing
60755797,2023-02-08,312.59000000000003,33.32,Incoming
60755797,2023-02-12,329.15000000000003,16.56,Incoming
60755797,2023-02-13,-1527.55,1856.7,Outgoing
60755797,2023-02-14,-1462.6799999999998,64.87,Incoming
60789634,2023-01-31,379.4,,-
60789634,2023-02-03,205.14999999999998,174.25,Outgoing
60789634,2023-02-05,139.89999999999998,65.25,Outgoing
60789634,2023-02-05,23.869999999999976,116.03,Outgoing
60789634,2023-02-09,-137.15000000000003,161.02,Outgoing
60789634,2023-02-12,-283.20000000000005,146.05,Outgoing
60789634,2023-02-12,-233.82000000000005,49.38,Incoming
60789634,2023-02-12,-93.00000000000006,140.82,Incoming
60789634,2023-02-13,-14.860000000000056,78.14,Incoming
60819695,2023-01-31,38.96,,-
60819695,2023-02-03,-53.77,92.73,Outgoing
60819695,2023-02-04,68.19999999999999,121.97,Incoming
60819695,2023-02-04,276.09,207.89,Incoming
60819695,2023-02-09,373.03,96.94,Incoming
60819695,2023-02-11,284.83,88.2,Outgoing
60819695,2023-02-14,173.63,111.2,Outgoing
60860851,2023-01-31,17.96,,-
60860851,2023-02-02,33.15,15.19,Incoming
60860851,2023-02-04,176.07,142.92,Incoming
60860851,2023-02-07,1548.57,1372.5,Incoming
60860851,2023-02-10,1701.49,152.92,Incoming
60860851,2023-02-10,1506.52,194.97,Outgoing
60860851,2023-02-10,1620.84,114.32,Incoming
60866500,2023-01-31,523.13,,-
60866500,2023-02-03,600.27,77.14,Incoming
60866500,2023-02-05,716.3,116.03,Incoming
60866500,2023-02-06,647.99,68.31,Outgoing
60866500,2023-02-09,773.73,125.74,Incoming
60866500,2023-02-11,853.1600000000001,79.43,Incoming
60866500,2023-02-11,696.6700000000001,156.49,Outgoing
60916657,2023-01-31,893.41,,-
60916657,2023-02-03,775.9,117.51,Outgoing
60916657,2023-02-05,852.47,76.57,Incoming
60916657,2023-02-06,908.5600000000001,56.09,Incoming
60916657,2023-02-11,837.32,71.24,Outgoing
60916657,2023-02-12,786.3800000000001,50.94,Outgoing
60930856,2023-01-31,445.07,,-
60930856,2023-02-03,491.92,46.85,Incoming
60930856,2023-02-04,623.61,131.69,Incoming
60930856,2023-02-07,676.59,52.98,Incoming
60930856,2023-02-12,608.33,68.26,Outgoing
60930856,2023-02-12,484.83000000000004,123.5,Outgoing
60930856,2023-02-14,419.96000000000004,64.87,Outgoing
60955647,2023-01-31,546.28,,-
60955647,2023-02-11,511.76,34.52,Outgoing
60955647,2023-02-14,385.3,126.46,Outgoing
60966485,2023-01-31,774.41,,-
60966485,2023-02-01,890.41,116.0,Incoming
60966485,2023-02-01,827.13,63.28,Outgoing
60966485,2023-02-04,639.94,187.19,Outgoing
60966485,2023-02-05,791.23,151.29,Incoming
60966485,2023-02-06,984.47,193.24,Incoming
60966485,2023-02-07,1041.31,56.84,Incoming
60966485,2023-02-10,1196.6999999999998,155.39,Incoming
60966485,2023-02-12,1138.8099999999997,57.89,Outgoing
60966485,2023-02-14,988.8599999999997,149.95,Outgoing
60996794,2023-01-31,27.98,,-
60996794,2023-02-04,-35.480000000000004,63.46,Outgoing
60996794,2023-02-08,867.8199999999999,903.3,Incoming
60996794,2023-02-11,934.4399999999999,66.62,Incoming
60996794,2023-02-13,2459.64,1525.2,Incoming
61087394,2023-01-31,112.81,,-
61087394,2023-02-01,-8.879999999999995,121.69,Outgoing
61087394,2023-02-07,-165.28,156.4,Outgoing
61087394,2023-02-07,-126.99000000000001,38.29,Incoming
61087394,2023-02-08,1494.01,1621.0,Incoming
61087394,2023-02-12,1546.47,52.46,Incoming
61087394,2023-02-13,1648.05,101.58,Incoming
61087394,2023-02-13,1753.22,105.17,Incoming
61087394,2023-02-14,3632.7200000000003,1879.5,Incoming
61101757,2023-01-31,992.2,,-
61152319,2023-01-31,471.31,,-
61152319,2023-02-01,546.76,75.45,Incoming
61152319,2023-02-04,629.01,82.25,Incoming
61152319,2023-02-07,568.0,61.01,Outgoing
61152319,2023-02-08,510.07,57.93,Outgoing
61152319,2023-02-13,589.88,79.81,Incoming
61178950,2023-01-31,104.88,,-
61178950,2023-02-04,25.25999999999999,79.62,Outgoing
61178950,2023-02-09,120.99999999999999,95.74,Incoming
61178950,2023-02-10,-29.39,150.39,Outgoing
61178950,2023-02-13,993.61,1023.0,Incoming
61178950,2023-02-14,1679.1100000000001,685.5,Incoming
61181609,2023-01-31,44.55,,-
61181609,2023-02-01,190.82999999999998,146.28,Incoming
61181609,2023-02-03,512.4300000000001,321.6,Incoming
61181609,2023-02-04,626.97,114.54,Incoming
61181609,2023-02-09,707.6,80.63,Incoming
61181609,2023-02-11,814.22,106.62,Incoming
61181609,2023-02-12,923.21,108.99,Incoming
61181609,2023-02-14,1013.11,89.9,Incoming
61279456,2023-01-31,814.3,,-
61279456,2023-02-02,907.6099999999999,93.31,Incoming
61279456,2023-02-04,774.56,133.05,Outgoing
61279456,2023-02-04,847.53,72.97,Incoming
61279456,2023-02-06,869.98,22.45,Incoming
61279456,2023-02-09,1050.8,180.82,Incoming
61279456,2023-02-11,1144.92,94.12,Incoming
61279456,2023-02-12,1201.0,56.08,Incoming
61279456,2023-02-12,1282.44,81.44,Incoming
61279456,2023-02-12,1148.26,134.18,Outgoing
61279456,2023-02-13,2554.96,1406.7,Incoming
61279456,2023-02-13,2671.63,116.67,Incoming
61419726,2023-01-31,932.41,,-
61419726,2023-02-02,755.77,176.64,Outgoing
61419726,2023-02-03,624.03,131.74,Outgoing
61419726,2023-02-07,729.56,105.53,Incoming
61419726,2023-02-09,815.3699999999999,85.81,Incoming
61419726,2023-02-09,965.0099999999999,149.64,Incoming
61419726,2023-02-10,1178.81,213.8,Incoming
61423373,2023-01-31,87.17,,-
61423373,2023-02-09,498.47,411.3,Incoming
61423373,2023-02-10,1154.27,655.8,Incoming
61423373,2023-02-11,1040.75,113.52,Outgoing
61450849,2023-01-31,890.19,,-
61450849,2023-02-01,1536.39,646.2,Incoming
61450849,2023-02-02,1542.8600000000001,6.47,Incoming
61450849,2023-02-04,1663.9,121.04,Incoming
61450849,2023-02-06,1797.02,133.12,Incoming
61450849,2023-02-07,1851.65,54.63,Incoming
61450849,2023-02-08,1756.69,94.96,Outgoing
61450849,2023-02-08,1688.0900000000001,68.6,Outgoing
61450849,2023-02-08,1729.65,41.56,Incoming
61493381,2023-01-31,569.94,,-
61493381,2023-02-01,582.9100000000001,12.97,Incoming
61493381,2023-02-05,637.44,54.53,Incoming
61493381,2023-02-06,750.9100000000001,113.47,Incoming
61493381,2023-02-08,954.2400000000001,203.33,Incoming
61493381,2023-02-09,1031.8200000000002,77.58,Incoming
61493381,2023-02-12,1214.4500000000003,182.63,Incoming
61493381,2023-02-14,1295.9500000000003,81.5,Incoming
61512912,2023-01-31,328.0,,-
61512912,2023-02-08,466.88,138.88,Incoming
61512912,2023-02-11,505.33,38.45,Incoming
61512912,2023-02-11,670.74,165.41,Incoming
61555609,2023-01-31,505.76,,-
61555609,2023-02-02,656.3299999999999,150.57,Incoming
61555609,2023-02-03,746.4499999999999,90.12,Incoming
61555609,2023-02-09,669.1199999999999,77.33,Outgoing
61555609,2023-02-13,-834.0800000000002,1503.2,Outgoing
61578713,2023-01-31,209.89,,-
61578713,2023-02-05,121.33999999999999,88.55,Outgoing
61578713,2023-02-05,86.57999999999998,34.76,Outgoing
61578713,2023-02-07,193.06,106.48,Incoming
61578713,2023-02-07,274.7,81.64,Incoming
61578713,2023-02-09,386.75,112.05,Incoming
61578713,2023-02-10,482.37,95.62,Incoming
61582769,2023-01-31,325.47,,-
61582769,2023-02-02,238.41000000000003,87.06,Outgoing
61582769,2023-02-08,168.85000000000002,69.56,Outgoing
61582769,2023-02-11,293.17,124.32,Incoming
61582769,2023-02-13,416.81,123.64,Incoming
61582769,2023-02-14,248.97,167.84,Outgoing
61593392,2023-01-31,621.21,,-
61593392,2023-02-10,713.3000000000001,92.09,Incoming
61593392,2023-02-11,755.19,41.89,Incoming
61634340,2023-01-31,83.85,,-
61634340,2023-02-01,232.48999999999998,148.64,Incoming
61634340,2023-02-03,292.82,60.33,Incoming
61634340,2023-02-04,531.78,238.96,Incoming
61634340,2023-02-07,640.91,109.13,Incoming
61634340,2023-02-12,734.91,94.0,Incoming
61634340,2023-02-13,805.16,70.25,Incoming
61642813,2023-01-31,760.74,,-
61642813,2023-02-02,582.86,177.88,Outgoing
61642813,2023-02-04,656.53,73.67,Incoming
61642813,2023-02-10,435.30999999999995,221.22,Outgoing
61642813,2023-02-13,503.97999999999996,68.67,Incoming
61642813,2023-02-13,422.59,81.39,Outgoing
61644310,2023-01-31,709.97,,-
61644310,2023-02-04,782.39,72.42,Incoming
61644310,2023-02-05,872.11,89.72,Incoming
61644310,2023-02-06,982.82,110.71,Incoming
61644310,2023-02-08,1089.19,106.37,Incoming
61644310,2023-02-13,1001.61,87.58,Outgoing
61644310,2023-02-13,865.21,136.4,Outgoing
61649729,2023-01-31,848.76,,-
61649729,2023-02-03,875.04,26.28,Incoming
61649729,2023-02-07,718.76,156.28,Outgoing
61649729,2023-02-10,569.23,149.53,Outgoing
61661386,2023-01-31,524.42,,-
61661386,2023-02-07,650.38,125.96,Incoming
61661386,2023-02-11,776.43,126.05,Incoming
61676204,2023-01-31,88.85,,-
61676204,2023-02-04,-45.370000000000005,134.22,Outgoing
61676204,2023-02-04,30.28,75.65,Incoming
61676204,2023-02-04,-59.81,90.09,Outgoing
61676204,2023-02-06,-16.46,43.35,Incoming
61676204,2023-02-07,-8.89,7.57,Incoming
61676204,2023-02-09,-57.95,49.06,Outgoing
61676204,2023-02-13,-147.25,89.3,Outgoing
61682186,2023-01-31,959.96,,-
61682186,2023-02-02,805.11,154.85,Outgoing
61682186,2023-02-10,831.54,26.43,Incoming
61682186,2023-02-10,930.8199999999999,99.28,Incoming
61682186,2023-02-11,271.31999999999994,659.5,Outgoing
61682186,2023-02-12,332.91999999999996,61.6,Incoming
61682186,2023-02-12,352.9,19.98,Incoming
61682186,2023-02-13,-779.6,1132.5,Outgoing
61687835,2023-01-31,739.0,,-
61687835,2023-02-03,841.16,102.16,Incoming
61687835,2023-02-03,693.56,147.6,Outgoing
61687835,2023-02-06,1254.86,561.3,Incoming
61687835,2023-02-06,1418.76,163.9,Incoming
61687835,2023-02-08,1409.57,9.19,Outgoing
61687835,2023-02-08,1353.4399999999998,56.13,Outgoing
61687835,2023-02-09,701.4399999999998,652.0,Outgoing
61687835,2023-02-10,913.5399999999998,212.1,Incoming
61687835,2023-02-11,747.7699999999999,165.77,Outgoing
61687835,2023-02-11,605.4799999999999,142.29,Outgoing
61687835,2023-02-12,542.8499999999999,62.63,Outgoing
61720005,2023-01-31,687.35,,-
61720005,2023-02-02,736.98,49.63,Incoming
61720005,2023-02-03,812.26,75.28,Incoming
61720005,2023-02-05,812.75,0.49,Incoming
61720005,2023-02-05,740.42,72.33,Outgoing
61720005,2023-02-08,847.89,107.47,Incoming
61720005,2023-02-09,742.03,105.86,Outgoing
61720005,2023-02-10,946.74,204.71,Incoming
61720005,2023-02-12,997.39,50.65,Incoming
61720005,2023-02-13,1035.65,38.26,Incoming
61724951,2023-01-31,656.25,,-
61724951,2023-02-03,622.85,33.4,Outgoing
61724951,2023-02-07,722.58,99.73,Incoming
61724951,2023-02-08,792.33,69.75,Incoming
61724951,2023-02-09,726.5600000000001,65.77,Outgoing
61724951,2023-02-09,586.7,139.86,Outgoing
61724951,2023-02-10,479.30000000000007,107.4,Outgoing
61724951,2023-02-12,271.70000000000005,207.6,Outgoing
61724951,2023-02-13,1399.0,1127.3,Incoming
61781801,2023-01-31,699.78,,-
61781801,2023-02-03,628.51,71.27,Outgoing
61781801,2023-02-07,713.48,84.97,Incoming
61781801,2023-02-07,531.21,182.27,Outgoing
61781801,2023-02-08,-520.19,1051.4,Outgoing
61781801,2023-02-08,-1948.19,1428.0,Outgoing
61781801,2023-02-09,-1997.8700000000001,49.68,Outgoing
61781801,2023-02-14,-2079.37,81.5,Outgoing
61847987,2023-01-31,874.22,,-
61847987,2023-02-04,798.57,75.65,Outgoing
61847987,2023-02-06,885.47,86.9,Incoming
61847987,2023-02-08,2903.17,2017.7,Incoming
61847987,2023-02-11,2992.35,89.18,Incoming
61847987,2023-02-14,2924.5,67.85,Outgoing
61860337,2023-01-31,892.77,,-
61860337,2023-02-05,990.14,97.37,Incoming
61860337,2023-02-06,925.47,64.67,Outgoing
61860337,2023-02-07,1058.45,132.98,Incoming
61860337,2023-02-09,2737.65,1679.2,Incoming
61860337,2023-02-11,2630.1600000000003,107.49,Outgoing
61860337,2023-02-12,2732.8900000000003,102.73,Incoming
61884944,2023-01-31,123.93,,-
61884944,2023-02-03,27.510000000000005,96.42,Outgoing
61884944,2023-02-03,-128.69,156.2,Outgoing
61884944,2023-02-04,-318.02,189.33,Outgoing
61884944,2023-02-05,679.38,997.4,Incoming
61884944,2023-02-08,485.49,193.89,Outgoing
61884944,2023-02-10,591.78,106.29,Incoming
61884944,2023-02-12,-394.12,985.9,Outgoing
61884944,2023-02-14,-525.48,131.36,Outgoing
61941956,2023-01-31,137.19,,-
61941956,2023-02-03,185.67,48.48,Incoming
61941956,2023-02-04,250.14999999999998,64.48,Incoming
61941956,2023-02-09,197.42,52.73,Outgoing
61941956,2023-02-09,378.42999999999995,181.01,Incoming
61979134,2023-01-31,574.77,,-
61979134,2023-02-03,681.2,106.43,Incoming
61979134,2023-02-03,696.32,15.12,Incoming
61979134,2023-02-04,797.71,101.39,Incoming
61979134,2023-02-09,654.44,143.27,Outgoing
61999896,2023-01-31,788.63,,-
61999896,2023-02-05,-686.7700000000001,1475.4,Outgoing
61999896,2023-02-05,-793.4800000000001,106.71,Outgoing
61999896,2023-02-06,-729.9900000000001,63.49,Incoming
61999896,2023-02-06,-606.2200000000001,123.77,Incoming
61999896,2023-02-06,-1345.52,739.3,Outgoing
61999896,2023-02-08,-1396.56,51.04,Outgoing
61999896,2023-02-11,-1529.32,132.76,Outgoing
61999896,2023-02-11,-2039.52,510.2,Outgoing
61999896,2023-02-13,-2177.1,137.58,Outgoing
62077439,2023-01-31,333.47,,-
62077439,2023-02-01,-11.829999999999984,345.3,Outgoing
62077439,2023-02-05,154.20000000000002,166.03,Incoming
62077439,2023-02-06,251.02,96.82,Incoming
62077439,2023-02-07,140.23000000000002,110.79,Outgoing
62077439,2023-02-08,263.53000000000003,123.3,Incoming
62077439,2023-02-09,385.48,121.95,Incoming
62077439,2023-02-10,1344.08,958.6,Incoming
62077439,2023-02-12,852.4799999999999,491.6,Outgoing
62141083,2023-01-31,17.63,,-
62141083,2023-02-02,-86.4,104.03,Outgoing
62141083,2023-02-05,-254.61,168.21,Outgoing
62141083,2023-02-07,-349.54,94.93,Outgoing
62141083,2023-02-11,-302.89000000000004,46.65,Incoming
62141083,2023-02-13,-189.48000000000005,113.41,Incoming
62147353,2023-01-31,783.96,,-
62147353,2023-02-04,849.09,65.13,Incoming
62147353,2023-02-10,794.36,54.73,Outgoing
62147353,2023-02-12,826.11,31.75,Incoming
62147353,2023-02-12,716.46,109.65,Outgoing
62147353,2023-02-14,861.3100000000001,144.85,Incoming
62158499,2023-01-31,581.72,,-
62158499,2023-02-02,492.26000000000005,89.46,Outgoing
62158499,2023-02-04,402.31000000000006,89.95,Outgoing
62158499,2023-02-05,1224.1100000000001,821.8,Incoming
62158499,2023-02-08,1060.16,163.95,Outgoing
62158499,2023-02-11,1181.63,121.47,Incoming
62158499,2023-02-13,1077.0700000000002,104.56,Outgoing
62158499,2023-02-13,1978.5700000000002,901.5,Incoming
62158499,2023-02-13,1996.4900000000002,17.92,Incoming
62191488,2023-01-31,652.76,,-
62191488,2023-02-01,731.96,79.2,Incoming
62191488,2023-02-01,616.11,115.85,Outgoing
62191488,2023-02-03,500.49,115.62,Outgoing
62191488,2023-02-08,485.97,14.52,Outgoing
62191488,2023-02-09,373.21000000000004,112.76,Outgoing
62191488,2023-02-09,377.59000000000003,4.38,Incoming
62213525,2023-01-31,45.68,,-
62213525,2023-02-01,-902.5200000000001,948.2,Outgoing
62213525,2023-02-04,800.18,1702.7,Incoming
62213525,2023-02-04,943.1899999999999,143.01,Incoming
62213525,2023-02-07,606.99,336.2,Outgoing
62213525,2023-02-07,746.95,139.96,Incoming
62213525,2023-02-10,861.5400000000001,114.59,Incoming
62213525,2023-02-10,770.6800000000001,90.86,Outgoing
62222306,2023-01-31,304.45,,-
62222306,2023-02-02,412.90999999999997,108.46,Incoming
62222306,2023-02-03,473.38,60.47,Incoming
62222306,2023-02-03,563.31,89.93,Incoming
62222306,2023-02-04,2202.51,1639.2,Incoming
62222306,2023-02-10,2212.26,9.75,Incoming
62227017,2023-01-31,177.72,,-
62227017,2023-02-02,49.41,128.31,Outgoing
62227017,2023-02-09,162.34,112.93,Incoming
62227017,2023-02-13,40.18000000000001,122.16,Outgoing
62251465,2023-01-31,304.55,,-
62251465,2023-02-01,400.9,96.35,Incoming
62251465,2023-02-02,385.46,15.44,Outgoing
62251465,2023-02-06,197.87999999999997,187.58,Outgoing
62251465,2023-02-07,159.97999999999996,37.9,Outgoing
62251465,2023-02-07,355.53,195.55,Incoming
62251465,2023-02-11,228.27999999999997,127.25,Outgoing
62256127,2023-01-31,784.39,,-
62256127,2023-02-05,935.66,151.27,Incoming
62256127,2023-02-07,801.1099999999999,134.55,Outgoing
62256127,2023-02-09,938.55,137.44,Incoming
62256127,2023-02-11,1039.49,100.94,Incoming
62256127,2023-02-11,2403.09,1363.6,Incoming
62256127,2023-02-12,3894.79,1491.7,Incoming
62276269,2023-01-31,575.1,,-
62276269,2023-02-02,717.36,142.26,Incoming
62276269,2023-02-04,844.19,126.83,Incoming
62276269,2023-02-08,793.48,50.71,Outgoing
62289297,2023-01-31,802.44,,-
62289297,2023-02-11,960.0400000000001,157.6,Incoming
62320219,2023-01-31,178.4,,-
62320219,2023-02-05,36.890000000000015,141.51,Outgoing
62320219,2023-02-05,86.84000000000002,49.95,Incoming
62320219,2023-02-05,-25.609999999999985,112.45,Outgoing
62320219,2023-02-08,-72.97999999999999,47.37,Outgoing
62332278,2023-01-31,970.66,,-
62332278,2023-02-01,850.92,119.74,Outgoing
62332278,2023-02-07,882.98,32.06,Incoming
62332278,2023-02-07,966.6600000000001,83.68,Incoming
62332278,2023-02-10,1111.79,145.13,Incoming
62332278,2023-02-12,945.64,166.15,Outgoing
62332278,2023-02-12,887.01,58.63,Outgoing
62332278,2023-02-13,705.47,181.54,Outgoing
62362650,2023-01-31,650.79,,-
62362650,2023-02-01,1117.49,466.7,Incoming
62362650,2023-02-01,987.66,129.83,Outgoing
62362650,2023-02-05,924.86,62.8,Outgoing
62362650,2023-02-05,806.08,118.78,Outgoing
62362650,2023-02-06,939.3800000000001,133.3,Incoming
62362650,2023-02-08,747.8800000000001,191.5,Outgoing
62362650,2023-02-08,832.8900000000001,85.01,Incoming
62362650,2023-02-08,694.71,138.18,Outgoing
62362650,2023-02-08,532.08,162.63,Outgoing
62362650,2023-02-11,646.85,114.77,Incoming
62362650,2023-02-11,579.79,67.06,Outgoing
62362650,2023-02-13,499.15,80.64,Outgoing
62412215,2023-01-31,766.15,,-
62412215,2023-02-02,855.61,89.46,Incoming
62412215,2023-02-03,944.94,89.33,Incoming
62412215,2023-02-06,-66.55999999999995,1011.5,Outgoing
62412215,2023-02-06,-163.37999999999994,96.82,Outgoing
62412215,2023-02-07,-65.42999999999994,97.95,Incoming
62412215,2023-02-12,-1344.33,1278.9,Outgoing
62414886,2023-01-31,489.04,,-
62414886,2023-02-02,596.5500000000001,107.51,Incoming
62414886,2023-02-06,668.9000000000001,72.35,Incoming
62414886,2023-02-06,732.2600000000001,63.36,Incoming
62414886,2023-02-09,782.5400000000001,50.28,Incoming
62414886,2023-02-09,871.97,89.43,Incoming
62414886,2023-02-11,946.33,74.36,Incoming
62414886,2023-02-11,1106.1000000000001,159.77,Incoming
62414886,2023-02-12,1233.0300000000002,126.93,Incoming
62414886,2023-02-13,2022.4300000000003,789.4,Incoming
62414886,2023-02-13,2155.36,132.93,Incoming
62470872,2023-01-31,436.81,,-
62470872,2023-02-03,518.09,81.28,Incoming
62470872,2023-02-06,439.15000000000003,78.94,Outgoing
62470872,2023-02-11,379.06000000000006,60.09,Outgoing
62470872,2023-02-13,277.97,101.09,Outgoing
62470872,2023-02-14,418.77000000000004,140.8,Incoming
62477219,2023-01-31,715.67,,-
62477219,2023-02-08,815.17,99.5,Incoming
62511159,2023-01-31,347.79,,-
62511159,2023-02-08,470.91,123.12,Incoming
62511159,2023-02-09,437.23,33.68,Outgoing
62511159,2023-02-10,432.03000000000003,5.2,Outgoing
62567104,2023-01-31,53.95,,-
62567104,2023-02-01,178.68,124.73,Incoming
62567104,2023-02-04,331.15999999999997,152.48,Incoming
62567104,2023-02-08,521.53,190.37,Incoming
62567104,2023-02-14,408.05999999999995,113.47,Outgoing
62580854,2023-01-31,421.59,,-
62580854,2023-02-05,307.35999999999996,114.23,Outgoing
62580854,2023-02-07,507.3299999999999,199.97,Incoming
62584374,2023-01-31,334.08,,-
62584374,2023-02-01,203.96999999999997,130.11,Outgoing
62584374,2023-02-05,305.2,101.23,Incoming
62584374,2023-02-06,274.82,30.38,Outgoing
62584374,2023-02-12,793.3199999999999,518.5,Incoming
62584374,2023-02-14,919.4899999999999,126.17,Incoming
62671957,2023-01-31,168.03,,-
62671957,2023-02-01,71.52,96.51,Outgoing
62671957,2023-02-07,198.26,126.74,Incoming
62671957,2023-02-07,96.89999999999999,101.36,Outgoing
62671957,2023-02-08,-22.260000000000005,119.16,Outgoing
62671957,2023-02-09,-80.85000000000001,58.59,Outgoing
62671957,2023-02-11,-1535.75,1454.9,Outgoing
62671957,2023-02-12,-1632.35,96.6,Outgoing
62671957,2023-02-12,-1580.6899999999998,51.66,Incoming
62716405,2023-01-31,531.19,,-
62716405,2023-02-02,446.6,84.59,Outgoing
62716405,2023-02-03,348.36,98.24,Outgoing
62716405,2023-02-06,333.14,15.22,Outgoing
62716405,2023-02-14,264.63,68.51,Outgoing
62746004,2023-01-31,638.36,,-
62746004,2023-02-10,541.27,97.09,Outgoing
62746004,2023-02-11,427.46999999999997,113.8,Outgoing
62756075,2023-01-31,896.87,,-
62756075,2023-02-03,460.37,436.5,Outgoing
62756075,2023-02-03,449.84000000000003,10.53,Outgoing
62756075,2023-02-05,511.68000000000006,61.84,Incoming
62756075,2023-02-06,523.6200000000001,11.94,Incoming
62756075,2023-02-08,508.78000000000014,14.84,Outgoing
62756075,2023-02-10,863.9800000000001,355.2,Incoming
62756075,2023-02-12,667.0000000000001,196.98,Outgoing
62756075,2023-02-13,524.0100000000001,142.99,Outgoing
62780588,2023-01-31,828.86,,-
62780588,2023-02-03,1363.46,534.6,Incoming
62780588,2023-02-04,1290.93,72.53,Outgoing
62780588,2023-02-06,1228.8500000000001,62.08,Outgoing
62780588,2023-02-08,1187.2800000000002,41.57,Outgoing
62780588,2023-02-08,1080.6600000000003,106.62,Outgoing
62780588,2023-02-10,970.7700000000003,109.89,Outgoing
62780588,2023-02-11,307.6700000000003,663.1,Outgoing
62780588,2023-02-12,541.5800000000003,233.91,Incoming
62862427,2023-01-31,545.14,,-
62862427,2023-02-01,721.55,176.41,Incoming
62862427,2023-02-05,702.28,19.27,Outgoing
62862427,2023-02-06,772.8299999999999,70.55,Incoming
62862427,2023-02-06,-297.07000000000016,1069.9,Outgoing
62862427,2023-02-10,-373.5500000000002,76.48,Outgoing
62862427,2023-02-11,-271.95000000000016,101.6,Incoming
62862427,2023-02-11,-361.50000000000017,89.55,Outgoing
62862427,2023-02-13,-2117.5,1756.0,Outgoing
62862427,2023-02-14,-2041.01,76.49,Incoming
63014981,2023-01-31,222.98,,-
63014981,2023-02-05,265.23,42.25,Incoming
63014981,2023-02-09,291.55,26.32,Incoming
63014981,2023-02-09,424.03,132.48,Incoming
63057168,2023-01-31,159.71,,-
63057168,2023-02-02,55.21000000000001,104.5,Outgoing
63057168,2023-02-09,71.33000000000001,16.12,Incoming
63057168,2023-02-10,163.82,92.49,Incoming
63057168,2023-02-10,21.039999999999992,142.78,Outgoing
63102647,2023-01-31,665.14,,-
63102647,2023-02-01,587.3299999999999,77.81,Outgoing
63102647,2023-02-04,510.88999999999993,76.44,Outgoing
63102647,2023-02-04,620.65,109.76,Incoming
63102647,2023-02-07,541.65,79.0,Outgoing
63102647,2023-02-07,561.72,20.07,Incoming
63102647,2023-02-07,529.6600000000001,32.06,Outgoing
63102647,2023-02-07,416.6500000000001,113.01,Outgoing
63102647,2023-02-09,540.7500000000001,124.1,Incoming
63102647,2023-02-09,482.04000000000013,58.71,Outgoing
63102647,2023-02-11,634.0400000000002,152.0,Incoming
63102647,2023-02-11,475.69000000000017,158.35,Outgoing
63232279,2023-01-31,931.78,,-
63232279,2023-02-01,813.51,118.27,Outgoing
63232279,2023-02-02,972.73,159.22,Incoming
63232279,2023-02-02,842.9,129.83,Outgoing
63232279,2023-02-03,3128.5,2285.6,Incoming
63232279,2023-02-03,2488.1,640.4,Outgoing
63232279,2023-02-07,2634.6,146.5,Incoming
63232279,2023-02-08,2577.77,56.83,Outgoing
63232279,2023-02-09,2702.82,125.05,Incoming
63232279,2023-02-11,2577.27,125.55,Outgoing
63232279,2023-02-11,2613.63,36.36,Incoming
63265361,2023-01-31,935.22,,-
63265361,2023-02-02,1819.52,884.3,Incoming
63265361,2023-02-03,1722.75,96.77,Outgoing
63265361,2023-02-05,773.15,949.6,Outgoing
63265361,2023-02-07,908.87,135.72,Incoming
63265361,2023-02-08,1041.8600000000001,132.99,Incoming
63265361,2023-02-10,1011.9400000000002,29.92,Outgoing
63265361,2023-02-12,875.0100000000002,136.93,Outgoing
63280767,2023-01-31,836.58,,-
63280767,2023-02-02,777.9300000000001,58.65,Outgoing
63280767,2023-02-03,734.1800000000001,43.75,Outgoing
63280767,2023-02-05,893.97,159.79,Incoming
63280767,2023-02-07,1746.5700000000002,852.6,Incoming
63280767,2023-02-10,1666.7000000000003,79.87,Outgoing
63280767,2023-02-14,1600.1400000000003,66.56,Outgoing
63298193,2023-01-31,259.55,,-
63298193,2023-02-08,-1114.55,1374.1,Outgoing
63298193,2023-02-08,-2475.45,1360.9,Outgoing
63298193,2023-02-11,-2520.47,45.02,Outgoing
63298193,2023-02-12,-3631.87,1111.4,Outgoing
63301094,2023-01-31,532.03,,-
63301094,2023-02-03,691.26,159.23,Incoming
63301094,2023-02-04,665.4399999999999,25.82,Outgoing
63301094,2023-02-06,-539.0600000000001,1204.5,Outgoing
63301094,2023-02-07,-445.1500000000001,93.91,Incoming
63301094,2023-02-10,-439.9500000000001,5.2,Incoming
63301094,2023-02-10,-556.4800000000001,116.53,Outgoing
63301094,2023-02-11,-426.1500000000001,130.33,Incoming
63381038,2023-01-31,541.91,,-
63381038,2023-02-08,472.84999999999997,69.06,Outgoing
63381038,2023-02-13,320.91999999999996,151.93,Outgoing
63405199,2023-01-31,18.35,,-
63405199,2023-02-07,-83.91,102.26,Outgoing
63405199,2023-02-07,145.38,229.29,Incoming
63405199,2023-02-07,323.58,178.2,Incoming
63405199,2023-02-09,97.03999999999999,226.54,Outgoing
63405199,2023-02-11,21.939999999999998,75.1,Outgoing
63405199,2023-02-14,40.56,18.62,Incoming
63405199,2023-02-14,111.68,71.12,Incoming
63412767,2023-01-31,715.41,,-
63412767,2023-02-03,868.41,153.0,Incoming
63412767,2023-02-03,955.77,87.36,Incoming
63412767,2023-02-03,974.39,18.62,Incoming
63412767,2023-02-05,1028.2,53.81,Incoming
63412767,2023-02-05,965.6400000000001,62.56,Outgoing
63412767,2023-02-05,1111.8500000000001,146.21,Incoming
63412767,2023-02-09,983.3500000000001,128.5,Outgoing
63412767,2023-02-11,929.0600000000002,54.29,Outgoing
63412767,2023-02-13,1028.4300000000003,99.37,Incoming
63486424,2023-01-31,531.83,,-
63486424,2023-02-04,532.0600000000001,0.23,Incoming
63486424,2023-02-05,364.2900000000001,167.77,Outgoing
63486424,2023-02-07,271.49000000000007,92.8,Outgoing
63486424,2023-02-10,326.6600000000001,55.17,Incoming
63486424,2023-02-12,1551.26,1224.6,Incoming
63534397,2023-01-31,451.25,,-
63534397,2023-02-03,1041.35,590.1,Incoming
63534397,2023-02-06,931.7599999999999,109.59,Outgoing
63534397,2023-02-07,844.7299999999999,87.03,Outgoing
63534397,2023-02-11,1718.6299999999999,873.9,Incoming
63556863,2023-01-31,634.4,,-
63556863,2023-02-01,634.9,0.5,Incoming
63556863,2023-02-02,737.15,102.25,Incoming
63556863,2023-02-03,606.24,130.91,Outgoing
63556863,2023-02-05,731.41,125.17,Incoming
63556863,2023-02-06,-392.68999999999994,1124.1,Outgoing
63556863,2023-02-06,-287.8399999999999,104.85,Incoming
63556863,2023-02-08,-1415.24,1127.4,Outgoing
63556863,2023-02-09,-1498.62,83.38,Outgoing
63556863,2023-02-09,-1558.78,60.16,Outgoing
63556863,2023-02-11,-1345.02,213.76,Incoming
63569270,2023-01-31,949.8,,-
63569270,2023-02-07,1070.3,120.5,Incoming
63569270,2023-02-10,1040.28,30.02,Outgoing
63569270,2023-02-11,2271.58,1231.3,Incoming
63635633,2023-01-31,202.35,,-
63635633,2023-02-07,78.99,123.36,Outgoing
63635633,2023-02-09,-30.52000000000001,109.51,Outgoing
63635633,2023-02-10,29.889999999999986,60.41,Incoming
63635633,2023-02-13,104.39999999999999,74.51,Incoming
63714888,2023-01-31,632.75,,-
63714888,2023-02-01,555.2,77.55,Outgoing
63714888,2023-02-04,1078.8000000000002,523.6,Incoming
63714888,2023-02-04,1188.2300000000002,109.43,Incoming
63714888,2023-02-11,1014.0400000000002,174.19,Outgoing
63714888,2023-02-12,2157.7400000000002,1143.7,Incoming
63714888,2023-02-12,2365.55,207.81,Incoming
63714888,2023-02-13,2320.98,44.57,Outgoing
63714888,2023-02-14,2401.37,80.39,Incoming
63746530,2023-01-31,874.63,,-
63746530,2023-02-05,-112.07000000000005,986.7,Outgoing
63746530,2023-02-06,-54.82000000000005,57.25,Incoming
63746530,2023-02-07,-819.5200000000001,764.7,Outgoing
63746530,2023-02-09,-702.71,116.81,Incoming
63746530,2023-02-09,-2408.31,1705.6,Outgoing
63746530,2023-02-12,-2502.39,94.08,Outgoing
63746530,2023-02-12,-2351.1,151.29,Incoming
63746530,2023-02-14,-2501.43,150.33,Outgoing
63845700,2023-01-31,856.95,,-
63845700,2023-02-02,1041.39,184.44,Incoming
63845700,2023-02-04,1209.68,168.29,Incoming
63845700,2023-02-06,1268.8400000000001,59.16,Incoming
63845700,2023-02-09,-337.75999999999976,1606.6,Outgoing
63845700,2023-02-11,-463.8099999999998,126.05,Outgoing
63845700,2023-02-12,-539.3699999999998,75.56,Outgoing
63863096,2023-01-31,819.23,,-
63863096,2023-02-05,967.32,148.09,Incoming
63863096,2023-02-08,799.5500000000001,167.77,Outgoing
63863096,2023-02-08,871.72,72.17,Incoming
63959769,2023-01-31,938.58,,-
63959769,2023-02-03,826.12,112.46,Outgoing
63959769,2023-02-08,973.9300000000001,147.81,Incoming
63959769,2023-02-09,925.33,48.6,Outgoing
63959769,2023-02-10,870.5500000000001,54.78,Outgoing
63959769,2023-02-12,1412.45,541.9,Incoming
63977699,2023-01-31,140.44,,-
63977699,2023-02-08,296.97,156.53,Incoming
63977699,2023-02-10,357.11,60.14,Incoming
63977699,2023-02-11,267.08000000000004,90.03,Outgoing
63977699,2023-02-11,59.200000000000045,207.88,Outgoing
64034275,2023-01-31,609.61,,-
64034275,2023-02-01,681.5,71.89,Incoming
64034275,2023-02-01,639.23,42.27,Outgoing
64034275,2023-02-01,694.32,55.09,Incoming
64034275,2023-02-10,778.7900000000001,84.47,Incoming
64034275,2023-02-11,643.3100000000001,135.48,Outgoing
64034275,2023-02-11,543.3800000000001,99.93,Outgoing
64034275,2023-02-12,473.9400000000001,69.44,Outgoing
64034275,2023-02-12,407.59000000000015,66.35,Outgoing
64065043,2023-01-31,245.44,,-
64065043,2023-02-06,166.97,78.47,Outgoing
64065043,2023-02-06,99.52,67.45,Outgoing
64065043,2023-02-10,3.8999999999999915,95.62,Outgoing
64065043,2023-02-13,-1615.8999999999999,1619.8,Outgoing
64065043,2023-02-13,-1663.7199999999998,47.82,Outgoing
64093529,2023-01-31,748.57,,-
64093529,2023-02-02,617.4200000000001,131.15,Outgoing
64093529,2023-02-03,465.69000000000005,151.73,Outgoing
64093529,2023-02-08,310.07000000000005,155.62,Outgoing
64093529,2023-02-10,216.78000000000003,93.29,Outgoing
64108699,2023-01-31,71.97,,-
64108699,2023-02-02,262.84000000000003,190.87,Incoming
64108699,2023-02-02,313.67,50.83,Incoming
64108699,2023-02-07,430.41,116.74,Incoming
64108699,2023-02-08,310.3,120.11,Outgoing
64108699,2023-02-08,393.8,83.5,Incoming
64108699,2023-02-09,427.97,34.17,Incoming
64108699,2023-02-10,316.29,111.68,Outgoing
64108699,2023-02-10,518.98,202.69,Incoming
64108699,2023-02-14,277.27,241.71,Outgoing
64123632,2023-01-31,358.39,,-
64123632,2023-02-03,226.51999999999998,131.87,Outgoing
64123632,2023-02-06,172.46999999999997,54.05,Outgoing
64123632,2023-02-07,148.12999999999997,24.34,Outgoing
64123632,2023-02-07,-845.77,993.9,Outgoing
64123632,2023-02-10,-652.61,193.16,Incoming
64123632,2023-02-12,-738.0,85.39,Outgoing
64160490,2023-01-31,222.89,,-
64160490,2023-02-02,107.76999999999998,115.12,Outgoing
64160490,2023-02-03,-38.56000000000003,146.33,Outgoing
64160490,2023-02-03,190.02999999999997,228.59,Incoming
64160490,2023-02-05,252.90999999999997,62.88,Incoming
64160490,2023-02-09,327.78,74.87,Incoming
64160490,2023-02-10,315.88,11.9,Outgoing
64160490,2023-02-12,296.92,18.96,Outgoing
64160490,2023-02-13,430.45000000000005,133.53,Incoming
64160490,2023-02-13,593.37,162.92,Incoming
64160490,2023-02-14,419.49,173.88,Outgoing
64160490,2023-02-14,542.39,122.9,Incoming
64160490,2023-02-14,456.89,85.5,Outgoing
64167315,2023-01-31,145.11,,-
64167315,2023-02-05,75.92000000000002,69.19,Outgoing
64167315,2023-02-06,-23.34999999999998,99.27,Outgoing
64167315,2023-02-13,-83.03999999999998,59.69,Outgoing
64167315,2023-02-14,82.51000000000003,165.55,Incoming
64168292,2023-01-31,297.09,,-
64168292,2023-02-03,426.45,129.36,Incoming
64168292,2023-02-03,314.61,111.84,Outgoing
64168292,2023-02-04,213.12,101.49,Outgoing
64168292,2023-02-06,272.7,59.58,Incoming
64168292,2023-02-08,437.04999999999995,164.35,Incoming
64168292,2023-02-08,304.43999999999994,132.61,Outgoing
64168292,2023-02-10,279.2699999999999,25.17,Outgoing
64168292,2023-02-10,462.13999999999993,182.87,Incoming
64168292,2023-02-13,292.16999999999996,169.97,Outgoing
64168292,2023-02-14,-1031.5300000000002,1323.7,Outgoing
64177019,2023-01-31,298.31,,-
64177019,2023-02-04,375.25,76.94,Incoming
64177019,2023-02-05,393.13,17.88,Incoming
64177019,2023-02-06,482.40999999999997,89.28,Incoming
64177019,2023-02-09,380.88,101.53,Outgoing
64177019,2023-02-10,482.46,101.58,Incoming
64177019,2023-02-10,366.4,116.06,Outgoing
64226824,2023-01-31,794.79,,-
64226824,2023-02-05,907.48,112.69,Incoming
64226824,2023-02-11,1012.37,104.89,Incoming
64228624,2023-01-31,508.14,,-
64228624,2023-02-02,659.02,150.88,Incoming
64228624,2023-02-04,532.8399999999999,126.18,Outgoing
64228624,2023-02-05,421.8699999999999,110.97,Outgoing
64228624,2023-02-09,507.7499999999999,85.88,Incoming
64228624,2023-02-10,618.1599999999999,110.41,Incoming
64228624,2023-02-10,524.4199999999998,93.74,Outgoing
64228624,2023-02-12,-629.4800000000002,1153.9,Outgoing
64237458,2023-01-31,255.48,,-
64237458,2023-02-01,331.1,75.62,Incoming
64237458,2023-02-02,386.18,55.08,Incoming
64237458,2023-02-05,283.01,103.17,Outgoing
64237458,2023-02-05,-1012.49,1295.5,Outgoing
64237458,2023-02-06,-833.6700000000001,178.82,Incoming
64237458,2023-02-06,-889.0300000000001,55.36,Outgoing
64237458,2023-02-09,-730.2600000000001,158.77,Incoming
64237458,2023-02-10,-790.0700000000002,59.81,Outgoing
64237458,2023-02-10,-118.07000000000016,672.0,Incoming
64237458,2023-02-11,-120.27000000000017,2.2,Outgoing
64237458,2023-02-12,-253.78000000000014,133.51,Outgoing
64237458,2023-02-12,-184.38000000000014,69.4,Incoming
64237458,2023-02-14,-290.3600000000001,105.98,Outgoing
64299012,2023-01-31,509.56,,-
64299012,2023-02-01,380.73,128.83,Outgoing
64299012,2023-02-05,290.14,90.59,Outgoing
64299012,2023-02-06,337.66999999999996,47.53,Incoming
64299012,2023-02-08,208.29999999999995,129.37,Outgoing
64299012,2023-02-10,229.22999999999996,20.93,Incoming
64299012,2023-02-12,343.99999999999994,114.77,Incoming
64299012,2023-02-14,2964.1,2620.1,Incoming
64299012,2023-02-14,2817.39,146.71,Outgoing
64300289,2023-01-31,472.59,,-
64300289,2023-02-02,590.8199999999999,118.23,Incoming
64300289,2023-02-05,561.77,29.05,Outgoing
64300289,2023-02-06,640.38,78.61,Incoming
64300289,2023-02-09,472.35,168.03,Outgoing
64300289,2023-02-10,581.2,108.85,Incoming
64300289,2023-02-12,647.75,66.55,Incoming
64300289,2023-02-12,721.69,73.94,Incoming
64303157,2023-01-31,698.38,,-
64303157,2023-02-01,707.7,9.32,Incoming
64303157,2023-02-06,835.82,128.12,Incoming
64303157,2023-02-07,739.2700000000001,96.55,Outgoing
64303157,2023-02-08,-998.13,1737.4,Outgoing
64305805,2023-01-31,181.46,,-
64305805,2023-02-01,54.82000000000001,126.64,Outgoing
64305805,2023-02-04,1704.02,1649.2,Incoming
64305805,2023-02-05,1804.59,100.57,Incoming
64305805,2023-02-07,1957.8899999999999,153.3,Incoming
64305805,2023-02-11,1854.9799999999998,102.91,Outgoing
64305805,2023-02-13,1928.9499999999998,73.97,Incoming
64331821,2023-01-31,519.62,,-
64331821,2023-02-05,664.7,145.08,Incoming
64331821,2023-02-07,647.98,16.72,Outgoing
64331821,2023-02-09,-249.01999999999998,897.0,Outgoing
64331821,2023-02-11,-144.63,104.39,Incoming
64331821,2023-02-11,3.6899999999999977,148.32,Incoming
64331821,2023-02-14,-476.21,479.9,Outgoing
64402841,2023-01-31,751.76,,-
64402841,2023-02-01,812.84,61.08,Incoming
64402841,2023-02-05,703.14,109.7,Outgoing
64402841,2023-02-07,836.23,133.09,Incoming
64402841,2023-02-11,742.65,93.58,Outgoing
64402841,2023-02-12,2153.75,1411.1,Incoming
64402841,2023-02-13,2101.56,52.19,Outgoing
64411319,2023-01-31,619.06,,-
64411319,2023-02-06,490.93999999999994,128.12,Outgoing
64411319,2023-02-08,619.2199999999999,128.28,Incoming
64411319,2023-02-10,677.9699999999999,58.75,Incoming
64411319,2023-02-11,581.4999999999999,96.47,Outgoing
64411319,2023-02-11,456.9399999999999,124.56,Outgoing
64460080,2023-01-31,313.37,,-
64460080,2023-02-01,399.36,85.99,Incoming
64460080,2023-02-02,460.45000000000005,61.09,Incoming
64460080,2023-02-03,579.47,119.02,Incoming
64460080,2023-02-03,735.88,156.41,Incoming
64460080,2023-02-10,544.3199999999999,191.56,Outgoing
64462046,2023-01-31,847.04,,-
64462046,2023-02-07,2239.74,1392.7,Incoming
64462046,2023-02-10,2955.24,715.5,Incoming
64462046,2023-02-10,2871.45,83.79,Outgoing
64486954,2023-01-31,378.0,,-
64486954,2023-02-05,320.82,57.18,Outgoing
64486954,2023-02-05,2006.22,1685.4,Incoming
64486954,2023-02-08,2123.63,117.41,Incoming
64486954,2023-02-11,3578.53,1454.9,Incoming
64526097,2023-01-31,491.42,,-
64526097,2023-02-02,429.45000000000005,61.97,Outgoing
64526097,2023-02-03,288.94000000000005,140.51,Outgoing
64526097,2023-02-04,241.98000000000005,46.96,Outgoing
64526097,2023-02-10,309.5400000000001,67.56,Incoming
64526097,2023-02-11,170.55000000000007,138.99,Outgoing
64526097,2023-02-12,141.98000000000008,28.57,Outgoing
64526097,2023-02-13,-15.429999999999922,157.41,Outgoing
64533535,2023-01-31,535.88,,-
64533535,2023-02-03,644.38,108.5,Incoming
64533535,2023-02-07,806.61,162.23,Incoming
64533535,2023-02-09,832.87,26.26,Incoming
64533535,2023-02-11,773.71,59.16,Outgoing
64533535,2023-02-13,695.76,77.95,Outgoing
64571970,2023-01-31,693.34,,-
64571970,2023-02-04,-116.05999999999995,809.4,Outgoing
64571970,2023-02-07,19.08000000000004,135.14,Incoming
64571970,2023-02-07,76.67000000000004,57.59,Incoming
64571970,2023-02-07,225.48000000000005,148.81,Incoming
64571970,2023-02-08,297.2900000000001,71.81,Incoming
64571970,2023-02-09,315.6500000000001,18.36,Incoming
64590882,2023-01-31,344.01,,-
64590882,2023-02-03,1849.11,1505.1,Incoming
64590882,2023-02-05,1777.9399999999998,71.17,Outgoing
64590882,2023-02-05,1922.7099999999998,144.77,Incoming
64590882,2023-02-07,1776.5399999999997,146.17,Outgoing
64590882,2023-02-14,1916.6099999999997,140.07,Incoming
64590882,2023-02-14,1841.5999999999997,75.01,Outgoing
64590882,2023-02-14,1895.5999999999997,54.0,Incoming
64610632,2023-01-31,869.95,,-
64610632,2023-02-04,905.34,35.39,Incoming
64610632,2023-02-05,46.940000000000055,858.4,Outgoing
64610632,2023-02-07,193.98000000000005,147.04,Incoming
64610632,2023-02-09,147.69000000000005,46.29,Outgoing
64610632,2023-02-13,331.12000000000006,183.43,Incoming
64610632,2023-02-13,530.69,199.57,Incoming
64683004,2023-01-31,348.86,,-
64683004,2023-02-01,-265.24,614.1,Outgoing
64683004,2023-02-04,-568.64,303.4,Outgoing
64683004,2023-02-04,-572.12,3.48,Outgoing
64683004,2023-02-05,-389.03,183.09,Incoming
64683004,2023-02-08,-282.04999999999995,106.98,Incoming
64683004,2023-02-08,-2299.75,2017.7,Outgoing
64683004,2023-02-09,-3957.75,1658.0,Outgoing
64683004,2023-02-11,-4059.5,101.75,Outgoing
64683004,2023-02-13,-3870.88,188.62,Incoming
64683004,2023-02-14,-4018.73,147.85,Outgoing
64683004,2023-02-14,-4126.44,107.71,Outgoing
64683004,2023-02-14,-4100.419999999999,26.02,Incoming
64716185,2023-01-31,391.53,,-
64716185,2023-02-02,311.22999999999996,80.3,Outgoing
64716185,2023-02-06,365.43999999999994,54.21,Incoming
64716185,2023-02-07,-890.4600000000002,1255.9,Outgoing
64716185,2023-02-08,-800.5800000000002,89.88,Incoming
64716185,2023-02-13,-647.1800000000002,153.4,Incoming
64716185,2023-02-14,-654.4400000000002,7.26,Outgoing
64769583,2023-01-31,598.67,,-
64769583,2023-02-02,714.65,115.98,Incoming
64769583,2023-02-04,-991.15,1705.8,Outgoing
64769583,2023-02-07,-1106.98,115.83,Outgoing
64769583,2023-02-12,-977.14,129.84,Incoming
64893719,2023-01-31,689.59,,-
64893719,2023-02-03,624.74,64.85,Outgoing
64893719,2023-02-04,716.62,91.88,Incoming
64893719,2023-02-07,589.88,126.74,Outgoing
64893719,2023-02-08,548.3199999999999,41.56,Outgoing
64893719,2023-02-10,632.2099999999999,83.89,Incoming
64893719,2023-02-10,752.04,119.83,Incoming
64901797,2023-01-31,672.29,,-
64901797,2023-02-06,599.18,73.11,Outgoing
64901797,2023-02-07,694.1099999999999,94.93,Incoming
64901797,2023-02-10,848.4999999999999,154.39,Incoming
64901797,2023-02-14,778.0999999999999,70.4,Outgoing
64953936,2023-01-31,311.46,,-
64953936,2023-02-05,84.64999999999998,226.81,Outgoing
64953936,2023-02-08,118.76999999999998,34.12,Incoming
64953936,2023-02-11,-29.630000000000024,148.4,Outgoing
64953936,2023-02-13,681.27,710.9,Incoming
64958880,2023-01-31,840.8,,-
64958880,2023-02-01,775.91,64.89,Outgoing
64958880,2023-02-04,830.25,54.34,Incoming
64958880,2023-02-04,742.69,87.56,Outgoing
64958880,2023-02-07,898.97,156.28,Incoming
64958880,2023-02-09,756.36,142.61,Outgoing
64958880,2023-02-10,705.82,50.54,Outgoing
64979248,2023-01-31,202.63,,-
64979248,2023-02-02,371.29999999999995,168.67,Incoming
64979248,2023-02-05,324.42999999999995,46.87,Outgoing
64979248,2023-02-10,309.11999999999995,15.31,Outgoing
64979248,2023-02-12,-312.88000000000005,622.0,Outgoing
64979248,2023-02-13,-449.55000000000007,136.67,Outgoing
64979248,2023-02-14,-405.1500000000001,44.4,Incoming
64990799,2023-01-31,480.33,,-
64990799,2023-02-02,582.73,102.4,Incoming
64990799,2023-02-03,645.71,62.98,Incoming
64990799,2023-02-10,712.9100000000001,67.2,Incoming
64990799,2023-02-12,765.07,52.16,Incoming
64990799,2023-02-12,1731.77,966.7,Incoming
64990799,2023-02-12,1458.97,272.8,Outgoing
65009032,2023-01-31,984.64,,-
65009032,2023-02-03,764.5,220.14,Outgoing
65009032,2023-02-04,892.71,128.21,Incoming
65009032,2023-02-06,1033.38,140.67,Incoming
65009032,2023-02-09,937.6400000000001,95.74,Outgoing
65009032,2023-02-09,794.3600000000001,143.28,Outgoing
65009032,2023-02-10,694.6200000000001,99.74,Outgoing
65009032,2023-02-10,601.2500000000001,93.37,Outgoing
65009032,2023-02-14,503.6600000000001,97.59,Outgoing
65033625,2023-01-31,186.26,,-
65033625,2023-02-01,105.38,80.88,Outgoing
65033625,2023-02-01,-12.02000000000001,117.4,Outgoing
65033625,2023-02-05,-116.91000000000001,104.89,Outgoing
65033625,2023-02-06,-8.950000000000017,107.96,Incoming
65052411,2023-01-31,877.5,,-
65052411,2023-02-05,957.72,80.22,Incoming
65052411,2023-02-06,780.09,177.63,Outgoing
65052411,2023-02-10,731.5500000000001,48.54,Outgoing
65052411,2023-02-11,572.21,159.34,Outgoing
65052411,2023-02-12,109.11000000000001,463.1,Outgoing
65052411,2023-02-14,-60.619999999999976,169.73,Outgoing
65097827,2023-01-31,526.75,,-
65097827,2023-02-02,660.09,133.34,Incoming
65097827,2023-02-03,725.0,64.91,Incoming
65097827,2023-02-04,752.43,27.43,Incoming
65097827,2023-02-05,643.1899999999999,109.24,Outgoing
65097827,2023-02-06,-95.0100000000001,738.2,Outgoing
65097827,2023-02-09,-197.1500000000001,102.14,Outgoing
65097827,2023-02-09,-290.3300000000001,93.18,Outgoing
65125795,2023-01-31,632.35,,-
65125795,2023-02-02,617.16,15.19,Outgoing
65125795,2023-02-08,579.03,38.13,Outgoing
65125795,2023-02-14,645.3199999999999,66.29,Incoming
65143384,2023-01-31,227.08,,-
65143384,2023-02-04,109.29,117.79,Outgoing
65143384,2023-02-04,100.44000000000001,8.85,Outgoing
65143384,2023-02-06,223.34000000000003,122.9,Incoming
65143384,2023-02-07,342.79,119.45,Incoming
65143384,2023-02-07,452.68,109.89,Incoming
65143384,2023-02-07,1968.98,1516.3,Incoming
65143384,2023-02-09,1829.62,139.36,Outgoing
65143384,2023-02-11,1896.83,67.21,Incoming
65143384,2023-02-12,1942.6,45.77,Incoming
65159654,2023-01-31,761.19,,-
65159654,2023-02-05,909.6300000000001,148.44,Incoming
65159654,2023-02-08,1033.0600000000002,123.43,Incoming
65159654,2023-02-10,919.7000000000002,113.36,Outgoing
65159654,2023-02-12,1141.42,221.72,Incoming
65159654,2023-02-14,1806.72,665.3,Incoming
65159654,2023-02-14,1769.51,37.21,Outgoing
65199307,2023-01-31,68.09,,-
65199307,2023-02-01,-93.75999999999999,161.85,Outgoing
65199307,2023-02-01,-236.67,142.91,Outgoing
65199307,2023-02-02,-1334.27,1097.6,Outgoing
65199307,2023-02-06,-1423.74,89.47,Outgoing
65199307,2023-02-10,-1365.29,58.45,Incoming
65199307,2023-02-12,-1461.69,96.4,Outgoing
65199307,2023-02-13,-1525.16,63.47,Outgoing
65200379,2023-01-31,4.27,,-
65200379,2023-02-03,-32.879999999999995,37.15,Outgoing
65200379,2023-02-04,35.56,68.44,Incoming
65200379,2023-02-05,-31.11,66.67,Outgoing
65200379,2023-02-06,70.29,101.4,Incoming
65200379,2023-02-08,186.87,116.58,Incoming
65200379,2023-02-10,-6.25,193.12,Outgoing
65200379,2023-02-10,77.27,83.52,Incoming
65200379,2023-02-10,-81.11,158.38,Outgoing
65200379,2023-02-11,90.44000000000001,171.55,Incoming
65200379,2023-02-12,156.79000000000002,66.35,Incoming
65200379,2023-02-12,1839.19,1682.4,Incoming
65220738,2023-01-31,873.56,,-
65220738,2023-02-01,963.3599999999999,89.8,Incoming
65220738,2023-02-03,2084.96,1121.6,Incoming
65220738,2023-02-04,1925.98,158.98,Outgoing
65220738,2023-02-05,3459.48,1533.5,Incoming
65220738,2023-02-06,2826.48,633.0,Outgoing
65220738,2023-02-11,3489.58,663.1,Incoming
65225040,2023-01-31,826.42,,-
65225040,2023-02-05,928.5999999999999,102.18,Incoming
65225040,2023-02-06,782.3799999999999,146.22,Outgoing
65225040,2023-02-06,676.3799999999999,106.0,Outgoing
65225040,2023-02-09,488.07999999999987,188.3,Outgoing
65225040,2023-02-10,543.1599999999999,55.08,Incoming
65280102,2023-01-31,2.17,,-
65280102,2023-02-06,7.52,5.35,Incoming
65280102,2023-02-06,-124.08,131.6,Outgoing
65280102,2023-02-11,10.010000000000005,134.09,Incoming
65280102,2023-02-11,-193.65999999999997,203.67,Outgoing
65280102,2023-02-14,-319.83,126.17,Outgoing
65280102,2023-02-14,-1020.9300000000001,701.1,Outgoing
65321237,2023-01-31,425.42,,-
65321237,2023-02-03,-190.97999999999996,616.4,Outgoing
65321237,2023-02-04,-155.29999999999995,35.68,Incoming
65321237,2023-02-05,-303.73999999999995,148.44,Outgoing
65321237,2023-02-08,-411.15999999999997,107.42,Outgoing
65321237,2023-02-11,-1705.06,1293.9,Outgoing
65321237,2023-02-12,-1805.6699999999998,100.61,Outgoing
65380590,2023-01-31,683.96,,-
65380590,2023-02-02,715.9200000000001,31.96,Incoming
65380590,2023-02-05,645.48,70.44,Outgoing
65380590,2023-02-07,572.22,73.26,Outgoing
65380590,2023-02-12,695.6,123.38,Incoming
65380590,2023-02-14,677.0600000000001,18.54,Outgoing
65429379,2023-01-31,232.83,,-
65429379,2023-02-01,154.61,78.22,Outgoing
65429379,2023-02-01,100.11000000000001,54.5,Outgoing
65429379,2023-02-07,255.84,155.73,Incoming
65429379,2023-02-09,231.72,24.12,Outgoing
65429379,2023-02-09,365.15,133.43,Incoming
65429379,2023-02-09,246.94,118.21,Outgoing
65429379,2023-02-10,186.8,60.14,Outgoing
65429379,2023-02-13,53.27000000000001,133.53,Outgoing
65534206,2023-01-31,274.89,,-
65534206,2023-02-01,211.94,62.95,Outgoing
65534206,2023-02-01,384.95,173.01,Incoming
65534206,2023-02-04,349.15,35.8,Outgoing
65534206,2023-02-09,473.71,124.56,Incoming
65534206,2023-02-13,432.76,40.95,Outgoing
65534206,2023-02-14,299.33,133.43,Outgoing
65579734,2023-01-31,928.08,,-
65579734,2023-02-07,830.82,97.26,Outgoing
65579734,2023-02-10,667.52,163.3,Outgoing
65579734,2023-02-10,533.1899999999999,134.33,Outgoing
65579734,2023-02-10,656.3799999999999,123.19,Incoming
65579734,2023-02-11,526.1099999999999,130.27,Outgoing
65579734,2023-02-12,682.2399999999999,156.13,Incoming
65579734,2023-02-13,798.1399999999999,115.9,Incoming
65579734,2023-02-13,-287.46000000000004,1085.6,Outgoing
65583532,2023-01-31,542.09,,-
65583532,2023-02-03,622.63,80.54,Incoming
65583532,2023-02-04,565.22,57.41,Outgoing
65583532,2023-02-05,355.77000000000004,209.45,Outgoing
65583532,2023-02-09,247.93000000000004,107.84,Outgoing
65583532,2023-02-09,444.40000000000003,196.47,Incoming
65589565,2023-01-31,321.99,,-
65589565,2023-02-07,415.92,93.93,Incoming
65589565,2023-02-07,500.75,84.83,Incoming
65589565,2023-02-12,2261.85,1761.1,Incoming
65596186,2023-01-31,254.28,,-
65596186,2023-02-03,155.61,98.67,Outgoing
65596186,2023-02-04,267.35,111.74,Incoming
65596186,2023-02-06,389.07000000000005,121.72,Incoming
65596186,2023-02-14,426.2900000000001,37.22,Incoming
65603779,2023-01-31,652.83,,-
65603779,2023-02-01,774.2900000000001,121.46,Incoming
65603779,2023-02-02,-370.80999999999983,1145.1,Outgoing
65603779,2023-02-02,228.49000000000012,599.3,Incoming
65603779,2023-02-02,336.98000000000013,108.49,Incoming
65603779,2023-02-14,135.15000000000012,201.83,Outgoing
65606472,2023-01-31,405.1,,-
65606472,2023-02-12,471.01,65.91,Incoming
65606472,2023-02-14,613.5799999999999,142.57,Incoming
65606472,2023-02-14,916.4799999999999,302.9,Incoming
65721172,2023-01-31,221.49,,-
65721172,2023-02-04,377.28,155.79,Incoming
65721172,2023-02-05,443.95,66.67,Incoming
65721172,2023-02-05,634.72,190.77,Incoming
65721172,2023-02-07,692.03,57.31,Incoming
65721172,2023-02-09,846.0699999999999,154.04,Incoming
65721172,2023-02-13,885.2199999999999,39.15,Incoming
65724980,2023-01-31,307.93,,-
65724980,2023-02-01,241.5,66.43,Outgoing
65724980,2023-02-06,396.51,155.01,Incoming
65724980,2023-02-06,529.71,133.2,Incoming
65724980,2023-02-06,-608.69,1138.4,Outgoing
65724980,2023-02-07,-474.1,134.59,Incoming
65724980,2023-02-08,-316.82000000000005,157.28,Incoming
65724980,2023-02-12,-315.53000000000003,1.29,Incoming
65754176,2023-01-31,716.55,,-
65754176,2023-02-01,542.3599999999999,174.19,Outgoing
65754176,2023-02-03,760.5099999999999,218.15,Incoming
65754176,2023-02-09,1805.6099999999997,1045.1,Incoming
65754176,2023-02-10,1912.3799999999997,106.77,Incoming
65754176,2023-02-12,1731.9199999999996,180.46,Outgoing
65754176,2023-02-13,1837.8699999999997,105.95,Incoming
65782923,2023-01-31,193.43,,-
65782923,2023-02-05,75.41000000000001,118.02,Outgoing
65782923,2023-02-06,114.02000000000001,38.61,Incoming
65782923,2023-02-10,262.11,148.09,Incoming
65782923,2023-02-11,191.72000000000003,70.39,Outgoing
65782923,2023-02-14,279.6,87.88,Incoming
65804470,2023-01-31,454.38,,-
65804470,2023-02-02,583.8299999999999,129.45,Incoming
65804470,2023-02-03,362.9999999999999,220.83,Outgoing
65804470,2023-02-08,245.6499999999999,117.35,Outgoing
65804470,2023-02-11,336.0099999999999,90.36,Incoming
65804470,2023-02-11,168.98999999999987,167.02,Outgoing
65804470,2023-02-13,106.85999999999987,62.13,Outgoing
65804470,2023-02-14,45.51999999999987,61.34,Outgoing
65815967,2023-01-31,0.43,,-
65815967,2023-02-03,-84.27,84.7,Outgoing
65815967,2023-02-07,65.72000000000001,149.99,Incoming
65815967,2023-02-07,22.440000000000012,43.28,Outgoing
65815967,2023-02-09,-41.54999999999999,63.99,Outgoing
65815967,2023-02-09,-151.69,110.14,Outgoing
65926576,2023-01-31,73.48,,-
65926576,2023-02-02,-23.989999999999995,97.47,Outgoing
65926576,2023-02-10,-106.22,82.23,Outgoing
65926576,2023-02-12,-264.78999999999996,158.57,Outgoing
65926576,2023-02-13,-375.18999999999994,110.4,Outgoing
65926576,2023-02-14,-231.58999999999995,143.6,Incoming
65988118,2023-01-31,647.81,,-
65988118,2023-02-02,590.9699999999999,56.84,Outgoing
65988118,2023-02-08,604.9799999999999,14.01,Incoming
65988118,2023-02-10,549.8499999999999,55.13,Outgoing
65988118,2023-02-10,667.4099999999999,117.56,Incoming
65988118,2023-02-11,558.8199999999998,108.59,Outgoing
65988118,2023-02-12,401.3599999999998,157.46,Outgoing
66008535,2023-01-31,398.99,,-
66008535,2023-02-01,335.88,63.11,Outgoing
66008535,2023-02-08,230.12,105.76,Outgoing
66022888,2023-01-31,757.14,,-
66022888,2023-02-01,699.77,57.37,Outgoing
66022888,2023-02-02,723.8199999999999,24.05,Incoming
66022888,2023-02-03,815.1899999999999,91.37,Incoming
66022888,2023-02-03,865.5699999999999,50.38,Incoming
66022888,2023-02-03,767.1899999999999,98.38,Outgoing
66022888,2023-02-07,640.8699999999999,126.32,Outgoing
66022888,2023-02-08,799.9199999999998,159.05,Incoming
66022888,2023-02-09,735.9699999999998,63.95,Outgoing
66022888,2023-02-14,654.7599999999998,81.21,Outgoing
66044567,2023-01-31,596.13,,-
66044567,2023-02-02,412.29999999999995,183.83,Outgoing
66044567,2023-02-03,400.93999999999994,11.36,Outgoing
66044567,2023-02-05,241.34999999999994,159.59,Outgoing
66044567,2023-02-12,146.20999999999992,95.14,Outgoing
66152145,2023-01-31,83.45,,-
66152145,2023-02-02,-67.42999999999999,150.88,Outgoing
66152145,2023-02-03,548.97,616.4,Incoming
66152145,2023-02-03,493.34000000000003,55.63,Outgoing
66152145,2023-02-05,576.74,83.4,Incoming
66152145,2023-02-07,2337.54,1760.8,Incoming
66152145,2023-02-08,2277.57,59.97,Outgoing
66152145,2023-02-09,2350.9900000000002,73.42,Incoming
66152145,2023-02-14,1665.4900000000002,685.5,Outgoing
66152145,2023-02-14,1557.9800000000002,107.51,Outgoing
66168472,2023-01-31,29.89,,-
66168472,2023-02-03,226.83999999999997,196.95,Incoming
66168472,2023-02-03,5.729999999999961,221.11,Outgoing
66168472,2023-02-03,84.97999999999996,79.25,Incoming
66168472,2023-02-05,-13.090000000000032,98.07,Outgoing
66168472,2023-02-09,-109.29000000000003,96.2,Outgoing
66168472,2023-02-09,-129.47000000000003,20.18,Outgoing
66168472,2023-02-12,-41.270000000000024,88.2,Incoming
66175264,2023-01-31,765.91,,-
66175264,2023-02-06,642.5999999999999,123.31,Outgoing
66175264,2023-02-09,567.7299999999999,74.87,Outgoing
66175264,2023-02-10,-566.87,1134.6,Outgoing
66175264,2023-02-12,-634.1800000000001,67.31,Outgoing
66175264,2023-02-13,-472.97,161.21,Incoming
66175264,2023-02-14,-590.6500000000001,117.68,Outgoing
66187843,2023-01-31,535.34,,-
66187843,2023-02-01,647.51,112.17,Incoming
66187843,2023-02-03,484.39,163.12,Outgoing
66239954,2023-01-31,181.14,,-
66239954,2023-02-02,87.25999999999999,93.88,Outgoing
66239954,2023-02-03,-180.44,267.7,Outgoing
66239954,2023-02-05,-263.84000000000003,83.4,Outgoing
66239954,2023-02-07,-123.74000000000004,140.1,Incoming
66239954,2023-02-12,-75.07000000000004,48.67,Incoming
66239954,2023-02-12,-17.650000000000034,57.42,Incoming
66239954,2023-02-14,-98.04000000000003,80.39,Outgoing
66239954,2023-02-14,1380.16,1478.2,Incoming
66239954,2023-02-14,1249.3200000000002,130.84,Outgoing
66257438,2023-01-31,818.57,,-
66257438,2023-02-01,740.1700000000001,78.4,Outgoing
66257438,2023-02-04,655.58,84.59,Outgoing
66257438,2023-02-05,684.0400000000001,28.46,Incoming
66257438,2023-02-07,690.07,6.03,Incoming
66257438,2023-02-09,618.95,71.12,Outgoing
66257438,2023-02-12,726.95,108.0,Incoming
66257438,2023-02-12,-1072.25,1799.2,Outgoing
66283493,2023-01-31,612.88,,-
66283493,2023-02-06,563.67,49.21,Outgoing
66283493,2023-02-07,-806.93,1370.6,Outgoing
66332583,2023-01-31,241.29,,-
66332583,2023-02-05,426.15,184.86,Incoming
66332583,2023-02-06,510.03999999999996,83.89,Incoming
66332583,2023-02-07,358.34,151.7,Outgoing
66332583,2023-02-09,479.46999999999997,121.13,Incoming
66332583,2023-02-12,677.8599999999999,198.39,Incoming
66332583,2023-02-12,806.6699999999998,128.81,Incoming
66341438,2023-01-31,685.06,,-
66341438,2023-02-05,2310.66,1625.6,Incoming
66341438,2023-02-06,2197.0299999999997,113.63,Outgoing
66341438,2023-02-13,2278.4199999999996,81.39,Incoming
66341438,2023-02-13,3291.8199999999997,1013.4,Incoming
66390683,2023-01-31,52.77,,-
66390683,2023-02-01,157.24,104.47,Incoming
66390683,2023-02-03,260.53000000000003,103.29,Incoming
66390683,2023-02-05,176.54000000000002,83.99,Outgoing
66390683,2023-02-05,341.96000000000004,165.42,Incoming
66390683,2023-02-09,251.17000000000002,90.79,Outgoing
66390683,2023-02-11,328.79,77.62,Incoming
66390683,2023-02-13,486.34000000000003,157.55,Incoming
66390683,2023-02-14,420.84000000000003,65.5,Outgoing
66390683,2023-02-14,554.03,133.19,Incoming
66390683,2023-02-14,700.74,146.71,Incoming
66416254,2023-01-31,166.4,,-
66416254,2023-02-03,229.69,63.29,Incoming
66416254,2023-02-03,267.83,38.14,Incoming
66416254,2023-02-03,136.29,131.54,Outgoing
66416254,2023-02-03,295.71,159.42,Incoming
66416254,2023-02-04,389.66999999999996,93.96,Incoming
66416254,2023-02-05,549.01,159.34,Incoming
66416254,2023-02-05,-263.59000000000003,812.6,Outgoing
66416254,2023-02-06,-1358.9900000000002,1095.4,Outgoing
66416254,2023-02-10,-1533.7600000000002,174.77,Outgoing
66416254,2023-02-10,-1464.9800000000002,68.78,Incoming
66416254,2023-02-11,-1607.6500000000003,142.67,Outgoing
66416254,2023-02-12,-1518.0100000000002,89.64,Incoming
66416254,2023-02-13,-2355.4100000000003,837.4,Outgoing
66445304,2023-01-31,153.78,,-
66445304,2023-02-01,-20.22,174.0,Outgoing
66445304,2023-02-05,88.7,108.92,Incoming
66445304,2023-02-05,-96.08,184.78,Outgoing
66445304,2023-02-08,-1.789999999999992,94.29,Incoming
66449974,2023-01-31,795.59,,-
66449974,2023-02-05,730.28,65.31,Outgoing
66449974,2023-02-11,627.37,102.91,Outgoing
66449974,2023-02-12,707.81,80.44,Incoming
66449974,2023-02-12,1972.9099999999999,1265.1,Incoming
66504443,2023-01-31,618.97,,-
66504443,2023-02-02,836.48,217.51,Incoming
66504443,2023-02-05,881.95,45.47,Incoming
66504443,2023-02-12,1009.5500000000001,127.6,Incoming
66521788,2023-01-31,201.43,,-
66521788,2023-02-01,328.84000000000003,127.41,Incoming
66521788,2023-02-05,238.18000000000004,90.66,Outgoing
66521788,2023-02-05,311.96000000000004,73.78,Incoming
66521788,2023-02-13,379.27000000000004,67.31,Incoming
66556141,2023-01-31,688.37,,-
66556141,2023-02-05,722.33,33.96,Incoming
66556141,2023-02-07,676.5,45.83,Outgoing
66556141,2023-02-10,469.53,206.97,Outgoing
66556141,2023-02-13,566.04,96.51,Incoming
66586860,2023-01-31,938.51,,-
66586860,2023-02-01,-134.19000000000005,1072.7,Outgoing
66586860,2023-02-06,9.229999999999933,143.42,Incoming
66586860,2023-02-07,115.32999999999993,106.1,Incoming
66586860,2023-02-08,260.9899999999999,145.66,Incoming
66586860,2023-02-10,144.6599999999999,116.33,Outgoing
66586860,2023-02-11,231.4299999999999,86.77,Incoming
66586860,2023-02-11,380.1699999999999,148.74,Incoming
66586860,2023-02-12,2144.57,1764.4,Incoming
66586860,2023-02-13,2200.98,56.41,Incoming
66601462,2023-01-31,361.46,,-
66601462,2023-02-11,299.28,62.18,Outgoing
66601462,2023-02-13,415.14,115.86,Incoming
66624477,2023-01-31,521.98,,-
66624477,2023-02-10,1793.48,1271.5,Incoming
66624477,2023-02-13,1864.06,70.58,Incoming
66667727,2023-01-31,431.31,,-
66667727,2023-02-01,285.53999999999996,145.77,Outgoing
66667727,2023-02-04,486.68999999999994,201.15,Incoming
66667727,2023-02-04,339.86999999999995,146.82,Outgoing
66667727,2023-02-05,444.44999999999993,104.58,Incoming
66667727,2023-02-06,550.76,106.31,Incoming
66681692,2023-01-31,712.12,,-
66681692,2023-02-03,67.82000000000005,644.3,Outgoing
66681692,2023-02-03,169.83000000000004,102.01,Incoming
66681692,2023-02-09,-1076.5700000000002,1246.4,Outgoing
66681692,2023-02-11,-1176.17,99.6,Outgoing
66681692,2023-02-14,-1025.75,150.42,Incoming
66700123,2023-01-31,175.15,,-
66700123,2023-02-01,281.61,106.46,Incoming
66700123,2023-02-02,1461.81,1180.2,Incoming
66700123,2023-02-08,1501.6599999999999,39.85,Incoming
66700123,2023-02-11,1376.35,125.31,Outgoing
66700123,2023-02-12,1439.03,62.68,Incoming
66704269,2023-01-31,915.51,,-
66704269,2023-02-03,805.13,110.38,Outgoing
66704269,2023-02-04,740.21,64.92,Outgoing
66704269,2023-02-04,615.49,124.72,Outgoing
66704269,2023-02-05,456.15,159.34,Outgoing
66704269,2023-02-07,466.46,10.31,Incoming
66704269,2023-02-08,623.5,157.04,Incoming
66704269,2023-02-11,528.91,94.59,Outgoing
66704269,2023-02-12,653.4599999999999,124.55,Incoming
66704269,2023-02-14,565.91,87.55,Outgoing
66704269,2023-02-14,-92.29000000000008,658.2,Outgoing
66706067,2023-01-31,1.98,,-
66706067,2023-02-02,235.34,233.36,Incoming
66706067,2023-02-04,124.21000000000001,111.13,Outgoing
66706067,2023-02-07,304.49,180.28,Incoming
66706067,2023-02-08,317.44,12.95,Incoming
66706067,2023-02-08,1324.34,1006.9,Incoming
66706067,2023-02-10,1464.9099999999999,140.57,Incoming
66706067,2023-02-10,262.40999999999985,1202.5,Outgoing
66706067,2023-02-10,165.53999999999985,96.87,Outgoing
66706067,2023-02-11,218.27999999999986,52.74,Incoming
66706067,2023-02-12,51.37999999999985,166.9,Outgoing
66729131,2023-01-31,100.8,,-
66729131,2023-02-04,125.11,24.31,Incoming
66729131,2023-02-04,272.0,146.89,Incoming
66729131,2023-02-04,367.6,95.6,Incoming
66729131,2023-02-05,280.53000000000003,87.07,Outgoing
66896515,2023-01-31,842.82,,-
66896515,2023-02-04,307.0200000000001,535.8,Outgoing
66896515,2023-02-05,497.0300000000001,190.01,Incoming
66896515,2023-02-05,405.30000000000007,91.73,Outgoing
66896515,2023-02-05,509.50000000000006,104.2,Incoming
66896515,2023-02-09,407.97,101.53,Outgoing
66896515,2023-02-11,185.92000000000002,222.05,Outgoing
66896515,2023-02-11,285.52,99.6,Incoming
66914990,2023-01-31,764.75,,-
66914990,2023-02-01,863.08,98.33,Incoming
66914990,2023-02-05,725.1,137.98,Outgoing
66914990,2023-02-09,850.21,125.11,Incoming
66914990,2023-02-13,1079.42,229.21,Incoming
66914990,2023-02-14,1014.23,65.19,Outgoing
66914990,2023-02-14,1147.9,133.67,Incoming
66930564,2023-01-31,398.03,,-
66930564,2023-02-02,481.75,83.72,Incoming
66930564,2023-02-05,656.71,174.96,Incoming
66930564,2023-02-06,540.9000000000001,115.81,Outgoing
66930564,2023-02-11,637.8000000000001,96.9,Incoming
66930564,2023-02-13,523.2600000000001,114.54,Outgoing
66954664,2023-01-31,620.1,,-
66954664,2023-02-04,570.58,49.52,Outgoing
66954664,2023-02-04,628.07,57.49,Incoming
66954664,2023-02-05,830.1800000000001,202.11,Incoming
66954664,2023-02-08,893.07,62.89,Incoming
66954664,2023-02-12,1046.8200000000002,153.75,Incoming
66954664,2023-02-13,1095.39,48.57,Incoming
66954664,2023-02-14,1876.89,781.5,Incoming
67029298,2023-01-31,255.53,,-
67029298,2023-02-01,316.11,60.58,Incoming
67029298,2023-02-02,406.18,90.07,Incoming
67029298,2023-02-02,377.88,28.3,Outgoing
67029298,2023-02-02,309.76,68.12,Outgoing
67029298,2023-02-02,-476.84000000000003,786.6,Outgoing
67029298,2023-02-07,-498.45000000000005,21.61,Outgoing
67029298,2023-02-08,-390.62000000000006,107.83,Incoming
67029298,2023-02-14,-297.2700000000001,93.35,Incoming
67056187,2023-01-31,392.51,,-
67056187,2023-02-02,493.9,101.39,Incoming
67056187,2023-02-08,586.76,92.86,Incoming
67056187,2023-02-09,750.75,163.99,Incoming
67056187,2023-02-11,2120.95,1370.2,Incoming
67056187,2023-02-14,2168.7799999999997,47.83,Incoming
67056187,2023-02-14,2275.12,106.34,Incoming
67090449,2023-01-31,724.35,,-
67090449,2023-02-04,755.4200000000001,31.07,Incoming
67090449,2023-02-07,839.8800000000001,84.46,Incoming
67090449,2023-02-07,1628.18,788.3,Incoming
67090449,2023-02-09,1771.46,143.28,Incoming
67090449,2023-02-10,1667.91,103.55,Outgoing
67090449,2023-02-10,1727.5700000000002,59.66,Incoming
67090449,2023-02-11,1664.67,62.9,Outgoing
67090449,2023-02-14,1591.73,72.94,Outgoing
67090449,2023-02-14,2737.63,1145.9,Incoming
67102224,2023-01-31,852.71,,-
67102224,2023-02-01,749.03,103.68,Outgoing
67102224,2023-02-03,856.3299999999999,107.3,Incoming
67104073,2023-01-31,476.04,,-
67104073,2023-02-03,429.5,46.54,Outgoing
67104073,2023-02-07,614.45,184.95,Incoming
67104073,2023-02-13,684.1800000000001,69.73,Incoming
67147649,2023-01-31,3.28,,-
67147649,2023-02-02,-1496.6200000000001,1499.9,Outgoing
67147649,2023-02-03,-1374.8500000000001,121.77,Incoming
67147649,2023-02-05,-1481.2800000000002,106.43,Outgoing
67147649,2023-02-08,-1508.5100000000002,27.23,Outgoing
67147649,2023-02-10,-1581.1200000000001,72.61,Outgoing
67147649,2023-02-14,-1679.46,98.34,Outgoing
67153119,2023-01-31,454.81,,-
67153119,2023-02-01,554.26,99.45,Incoming
67153119,2023-02-01,436.65999999999997,117.6,Outgoing
67153119,2023-02-02,245.78999999999996,190.87,Outgoing
67153119,2023-02-03,237.29999999999995,8.49,Outgoing
67153119,2023-02-08,290.54999999999995,53.25,Incoming
67153119,2023-02-12,198.92999999999995,91.62,Outgoing
67153119,2023-02-14,370.61999999999995,171.69,Incoming
67157564,2023-01-31,562.42,,-
67157564,2023-02-01,-590.58,1153.0,Outgoing
67157564,2023-02-02,-665.4000000000001,74.82,Outgoing
67157564,2023-02-03,-754.4300000000001,89.03,Outgoing
67157564,2023-02-04,-594.3100000000001,160.12,Incoming
67157564,2023-02-08,-472.12000000000006,122.19,Incoming
67157564,2023-02-10,-399.94000000000005,72.18,Incoming
67157564,2023-02-10,-341.20000000000005,58.74,Incoming
67157564,2023-02-12,-413.13000000000005,71.93,Outgoing
67190209,2023-01-31,567.61,,-
67190209,2023-02-01,493.21000000000004,74.4,Outgoing
67270354,2023-01-31,805.28,,-
67270354,2023-02-04,935.65,130.37,Incoming
67270354,2023-02-05,1075.56,139.91,Incoming
67270354,2023-02-10,-49.340000000000146,1124.9,Outgoing
67270354,2023-02-12,18.729999999999848,68.07,Incoming
67283010,2023-01-31,872.4,,-
67283010,2023-02-02,799.8199999999999,72.58,Outgoing
67283010,2023-02-04,672.8399999999999,126.98,Outgoing
67283010,2023-02-05,529.1099999999999,143.73,Outgoing
67283010,2023-02-08,537.05,7.94,Incoming
67283010,2023-02-11,612.17,75.12,Incoming
67392638,2023-01-31,519.61,,-
67392638,2023-02-04,-385.78999999999996,905.4,Outgoing
67392638,2023-02-05,-569.8499999999999,184.06,Outgoing
67392638,2023-02-05,-474.4999999999999,95.35,Incoming
67392638,2023-02-06,-380.7499999999999,93.75,Incoming
67400117,2023-01-31,769.45,,-
67400117,2023-02-02,883.8900000000001,114.44,Incoming
67400117,2023-02-03,725.1700000000001,158.72,Outgoing
67400117,2023-02-10,855.49,130.32,Incoming
67400117,2023-02-10,733.79,121.7,Outgoing
67400117,2023-02-14,1391.99,658.2,Incoming
67434874,2023-01-31,399.94,,-
67434874,2023-02-02,291.45,108.49,Outgoing
67434874,2023-02-03,196.88,94.57,Outgoing
67434874,2023-02-04,124.05,72.83,Outgoing
67434874,2023-02-05,43.39,80.66,Outgoing
67434874,2023-02-07,167.06,123.67,Incoming
67434874,2023-02-09,56.95,110.11,Outgoing
67434874,2023-02-11,145.15,88.2,Incoming
67434874,2023-02-12,231.05,85.9,Incoming
67464890,2023-01-31,81.27,,-
67464890,2023-02-13,646.87,565.6,Incoming
67464890,2023-02-14,761.59,114.72,Incoming
67466632,2023-01-31,350.06,,-
67466632,2023-02-01,223.31,126.75,Outgoing
67466632,2023-02-05,1541.01,1317.7,Incoming
67466632,2023-02-06,1492.58,48.43,Outgoing
67466632,2023-02-06,1313.48,179.1,Outgoing
67466632,2023-02-09,1169.3400000000001,144.14,Outgoing
67466632,2023-02-11,1086.3300000000002,83.01,Outgoing
67466632,2023-02-11,1282.8200000000002,196.49,Incoming
67466632,2023-02-13,1349.3200000000002,66.5,Incoming
67466632,2023-02-14,1496.7000000000003,147.38,Incoming
67489489,2023-01-31,219.39,,-
67489489,2023-02-01,338.01,118.62,Incoming
67489489,2023-02-04,249.7,88.31,Outgoing
67489489,2023-02-04,181.6,68.1,Outgoing
67489489,2023-02-06,69.58,112.02,Outgoing
67489489,2023-02-06,-22.28,91.86,Outgoing
67489489,2023-02-09,-14.84,7.44,Incoming
67489489,2023-02-09,249.76000000000002,264.6,Incoming
67489489,2023-02-14,164.38000000000002,85.38,Outgoing
67490657,2023-01-31,588.58,,-
67490657,2023-02-04,747.1400000000001,158.56,Incoming
67490657,2023-02-05,766.0300000000001,18.89,Incoming
67490657,2023-02-06,912.9900000000001,146.96,Incoming
67490657,2023-02-08,853.5900000000001,59.4,Outgoing
67490657,2023-02-10,729.8300000000002,123.76,Outgoing
67490657,2023-02-11,1684.23,954.4,Incoming
67490657,2023-02-12,2534.33,850.1,Incoming
67490657,2023-02-14,2434.45,99.88,Outgoing
67502738,2023-01-31,185.72,,-
67502738,2023-02-08,15.219999999999999,170.5,Outgoing
67502738,2023-02-10,120.15,104.93,Incoming
67502738,2023-02-12,204.98000000000002,84.83,Incoming
67532228,2023-01-31,805.91,,-
67532228,2023-02-03,-130.39,936.3,Outgoing
67532228,2023-02-04,32.76000000000002,163.15,Incoming
67532228,2023-02-05,172.10000000000002,139.34,Incoming
67532228,2023-02-05,54.300000000000026,117.8,Outgoing
67532228,2023-02-07,-98.96999999999998,153.27,Outgoing
67532228,2023-02-10,-6.839999999999989,92.13,Incoming
67541253,2023-01-31,985.49,,-
67541253,2023-02-02,1540.99,555.5,Incoming
67541253,2023-02-05,1459.79,81.2,Outgoing
67541253,2023-02-09,1498.5,38.71,Incoming
67541253,2023-02-10,1359.15,139.35,Outgoing
67561762,2023-01-31,469.23,,-
67561762,2023-02-01,298.88,170.35,Outgoing
67561762,2023-02-04,490.88,192.0,Incoming
67561762,2023-02-07,543.43,52.55,Incoming
67561762,2023-02-09,684.04,140.61,Incoming
67561762,2023-02-11,1820.34,1136.3,Incoming
67561762,2023-02-14,1705.6599999999999,114.68,Outgoing
67571676,2023-01-31,491.88,,-
67571676,2023-02-09,499.84,7.96,Incoming
67571676,2023-02-09,348.62,151.22,Outgoing
67571676,2023-02-10,360.52,11.9,Incoming
67571676,2023-02-14,445.66999999999996,85.15,Incoming
67635951,2023-01-31,692.02,,-
67635951,2023-02-01,524.56,167.46,Outgoing
67635951,2023-02-01,446.94999999999993,77.61,Outgoing
67635951,2023-02-04,556.4,109.45,Incoming
67635951,2023-02-04,730.95,174.55,Incoming
67635951,2023-02-04,597.34,133.61,Outgoing
67635951,2023-02-08,423.1,174.24,Outgoing
67635951,2023-02-08,512.19,89.09,Incoming
67635951,2023-02-08,770.7900000000001,258.6,Incoming
67674594,2023-01-31,126.16,,-
67674594,2023-02-01,65.0,61.16,Outgoing
67674594,2023-02-07,234.03,169.03,Incoming
67674594,2023-02-08,80.11000000000001,153.92,Outgoing
67674594,2023-02-08,215.56,135.45,Incoming
67674594,2023-02-09,272.09000000000003,56.53,Incoming
67674594,2023-02-11,120.44000000000003,151.65,Outgoing
67674594,2023-02-12,196.59000000000003,76.15,Incoming
67679622,2023-01-31,631.03,,-
67679622,2023-02-01,488.65999999999997,142.37,Outgoing
67679622,2023-02-08,582.4,93.74,Incoming
67679622,2023-02-08,636.51,54.11,Incoming
67679622,2023-02-09,-176.49,813.0,Outgoing
67679622,2023-02-10,14.399999999999977,190.89,Incoming
67679622,2023-02-10,126.07999999999998,111.68,Incoming
67679622,2023-02-12,289.90999999999997,163.83,Incoming
67716893,2023-01-31,250.99,,-
67716893,2023-02-02,157.83,93.16,Outgoing
67716893,2023-02-05,88.67000000000002,69.16,Outgoing
67716893,2023-02-07,1588.67,1500.0,Incoming
67716893,2023-02-07,1715.1200000000001,126.45,Incoming
67716893,2023-02-08,1725.3000000000002,10.18,Incoming
67716893,2023-02-08,1798.9800000000002,73.68,Incoming
67716893,2023-02-09,1632.2800000000002,166.7,Outgoing
67805276,2023-01-31,431.12,,-
67805276,2023-02-08,342.27,88.85,Outgoing
67805276,2023-02-09,263.21999999999997,79.05,Outgoing
67805276,2023-02-09,446.02,182.8,Incoming
67805276,2023-02-10,342.96,103.06,Outgoing
67805276,2023-02-11,238.14,104.82,Outgoing
67805276,2023-02-14,248.70999999999998,10.57,Incoming
67837998,2023-01-31,246.4,,-
67837998,2023-02-02,92.34,154.06,Outgoing
67837998,2023-02-04,179.9,87.56,Incoming
67837998,2023-02-05,116.2,63.7,Outgoing
67837998,2023-02-10,-566.0,682.2,Outgoing
67862200,2023-01-31,944.49,,-
67862200,2023-02-04,1066.44,121.95,Incoming
67862200,2023-02-06,1073.51,7.07,Incoming
67862200,2023-02-09,-58.08999999999992,1131.6,Outgoing
67862200,2023-02-11,-1713.3899999999999,1655.3,Outgoing
67862200,2023-02-12,-852.5899999999999,860.8,Incoming
67902154,2023-01-31,669.79,,-
67902154,2023-02-01,1216.09,546.3,Incoming
67902154,2023-02-01,1302.3,86.21,Incoming
67902154,2023-02-01,1236.69,65.61,Outgoing
67902154,2023-02-03,1239.93,3.24,Incoming
67902154,2023-02-03,1298.74,58.81,Incoming
67902154,2023-02-04,1171.91,126.83,Outgoing
67902154,2023-02-06,1257.8100000000002,85.9,Incoming
67902154,2023-02-06,1069.5400000000002,188.27,Outgoing
67902154,2023-02-08,950.9600000000002,118.58,Outgoing
67902154,2023-02-12,792.8500000000001,158.11,Outgoing
67902154,2023-02-14,884.3800000000001,91.53,Incoming
67902154,2023-02-14,1985.0800000000002,1100.7,Incoming
67909830,2023-01-31,589.68,,-
67909830,2023-02-03,420.85999999999996,168.82,Outgoing
67909830,2023-02-03,539.81,118.95,Incoming
67909830,2023-02-06,697.75,157.94,Incoming
67909830,2023-02-07,611.23,86.52,Outgoing
67909830,2023-02-11,440.51,170.72,Outgoing
67911201,2023-01-31,762.17,,-
67911201,2023-02-01,696.91,65.26,Outgoing
67911201,2023-02-04,817.0999999999999,120.19,Incoming
67911201,2023-02-09,2375.8,1558.7,Incoming
67911201,2023-02-10,2205.7200000000003,170.08,Outgoing
67911201,2023-02-11,2258.2000000000003,52.48,Incoming
67911201,2023-02-11,2365.26,107.06,Incoming
67911677,2023-01-31,725.9,,-
67911677,2023-02-04,576.7,149.2,Outgoing
67911677,2023-02-09,649.75,73.05,Incoming
67938929,2023-01-31,868.04,,-
67938929,2023-02-01,993.42,125.38,Incoming
67938929,2023-02-03,882.99,110.43,Outgoing
67938929,2023-02-03,944.91,61.92,Incoming
67938929,2023-02-06,822.01,122.9,Outgoing
67938929,2023-02-09,957.48,135.47,Incoming
67938929,2023-02-09,798.98,158.5,Outgoing
67938929,2023-02-10,708.2,90.78,Outgoing
67938929,2023-02-10,728.25,20.05,Incoming
67938929,2023-02-10,669.51,58.74,Outgoing
67938929,2023-02-11,743.13,73.62,Incoming
67938929,2023-02-13,621.83,121.3,Outgoing
67961706,2023-01-31,569.5,,-
67961706,2023-02-05,473.65999999999997,95.84,Outgoing
67961706,2023-02-09,290.85999999999996,182.8,Outgoing
67961706,2023-02-11,-541.6400000000001,832.5,Outgoing
67961706,2023-02-12,-443.4400000000001,98.2,Incoming
67961706,2023-02-14,-547.8900000000001,104.45,Outgoing
67987326,2023-01-31,161.67,,-
67987326,2023-02-01,312.85,151.18,Incoming
67987326,2023-02-06,137.49,175.36,Outgoing
67987326,2023-02-07,276.12,138.63,Incoming
67987326,2023-02-10,192.17000000000002,83.95,Outgoing
67987326,2023-02-12,-31.96999999999997,224.14,Outgoing
68051701,2023-01-31,911.6,,-
68051701,2023-02-03,1686.4,774.8,Incoming
68051701,2023-02-03,1884.04,197.64,Incoming
68051701,2023-02-04,1918.26,34.22,Incoming
68051701,2023-02-11,1828.76,89.5,Outgoing
68051701,2023-02-12,1700.48,128.28,Outgoing
68051701,2023-02-13,1885.4,184.92,Incoming
68104946,2023-01-31,925.71,,-
68104946,2023-02-08,816.4200000000001,109.29,Outgoing
68153614,2023-01-31,927.95,,-
68153614,2023-02-02,809.73,118.22,Outgoing
68153614,2023-02-10,979.8100000000001,170.08,Incoming
68153614,2023-02-11,1639.31,659.5,Incoming
68153614,2023-02-13,1739.09,99.78,Incoming
68189902,2023-01-31,448.56,,-
68189902,2023-02-02,510.26,61.7,Incoming
68189902,2023-02-05,663.85,153.59,Incoming
68189902,2023-02-05,538.8000000000001,125.05,Outgoing
68189902,2023-02-06,393.3800000000001,145.42,Outgoing
68189902,2023-02-07,291.5900000000001,101.79,Outgoing
68198696,2023-01-31,979.46,,-
68198696,2023-02-05,952.1,27.36,Outgoing
68198696,2023-02-07,792.13,159.97,Outgoing
68198696,2023-02-08,888.58,96.45,Incoming
68198696,2023-02-09,832.5600000000001,56.02,Outgoing
68198696,2023-02-09,869.7,37.14,Incoming
68198696,2023-02-09,929.86,60.16,Incoming
68198696,2023-02-11,946.45,16.59,Incoming
68198696,2023-02-12,-202.54999999999995,1149.0,Outgoing
68239576,2023-01-31,64.42,,-
68239576,2023-02-01,-57.41,121.83,Outgoing
68239576,2023-02-01,-152.38,94.97,Outgoing
68239576,2023-02-01,-174.2,21.82,Outgoing
68239576,2023-02-05,-274.53,100.33,Outgoing
68239576,2023-02-09,-359.57,85.04,Outgoing
68239576,2023-02-09,-230.38,129.19,Incoming
68262083,2023-01-31,899.79,,-
68262083,2023-02-04,1041.5,141.71,Incoming
68262083,2023-02-11,1098.61,57.11,Incoming
68262083,2023-02-14,978.3,120.31,Outgoing
68275028,2023-01-31,918.44,,-
68275028,2023-02-01,1039.3600000000001,120.92,Incoming
68275028,2023-02-03,932.6900000000002,106.67,Outgoing
68275028,2023-02-04,968.2100000000002,35.52,Incoming
68275028,2023-02-07,775.9100000000001,192.3,Outgoing
68275028,2023-02-07,-226.58999999999992,1002.5,Outgoing
68275028,2023-02-09,-119.36999999999992,107.22,Incoming
68294036,2023-01-31,184.64,,-
68294036,2023-02-02,65.08999999999999,119.55,Outgoing
68294036,2023-02-06,115.92999999999999,50.84,Incoming
68294036,2023-02-06,48.519999999999996,67.41,Outgoing
68294036,2023-02-08,211.01,162.49,Incoming
68294036,2023-02-08,368.53,157.52,Incoming
68294036,2023-02-09,-42.77000000000004,411.3,Outgoing
68294036,2023-02-10,-208.40000000000003,165.63,Outgoing
68294645,2023-01-31,306.18,,-
68294645,2023-02-01,272.67,33.51,Outgoing
68294645,2023-02-02,188.95000000000002,83.72,Outgoing
68294645,2023-02-06,62.41000000000001,126.54,Outgoing
68294645,2023-02-12,134.87,72.46,Incoming
68311266,2023-01-31,87.08,,-
68311266,2023-02-01,326.8,239.72,Incoming
68311266,2023-02-03,196.06,130.74,Outgoing
68311266,2023-02-05,56.150000000000006,139.91,Outgoing
68311266,2023-02-06,-1196.9499999999998,1253.1,Outgoing
68311266,2023-02-10,-1311.6899999999998,114.74,Outgoing
68311266,2023-02-12,-1214.8199999999997,96.87,Incoming
68311266,2023-02-14,-1323.2999999999997,108.48,Outgoing
68311266,2023-02-14,-1350.9799999999998,27.68,Outgoing
68315462,2023-01-31,769.16,,-
68315462,2023-02-01,616.87,152.29,Outgoing
68315462,2023-02-02,498.32,118.55,Outgoing
68315462,2023-02-03,300.03,198.29,Outgoing
68315462,2023-02-05,319.29999999999995,19.27,Incoming
68315462,2023-02-05,329.61999999999995,10.32,Incoming
68315462,2023-02-09,-1080.48,1410.1,Outgoing
68315462,2023-02-10,-1185.34,104.86,Outgoing
68315462,2023-02-10,-1248.9199999999998,63.58,Outgoing
68315462,2023-02-10,-1174.6299999999999,74.29,Incoming
68315462,2023-02-13,-1133.9799999999998,40.65,Incoming
68346907,2023-01-31,752.88,,-
68346907,2023-02-01,1597.48,844.6,Incoming
68346907,2023-02-05,1523.27,74.21,Outgoing
68346907,2023-02-06,1623.36,100.09,Incoming
68346907,2023-02-07,1753.2199999999998,129.86,Incoming
68346907,2023-02-08,1709.3299999999997,43.89,Outgoing
68346907,2023-02-09,1788.2299999999998,78.9,Incoming
68346907,2023-02-12,2629.93,841.7,Incoming
68346907,2023-02-13,2537.29,92.64,Outgoing
68393439,2023-01-31,783.05,,-
68393439,2023-02-01,645.3,137.75,Outgoing
68393439,2023-02-02,820.04,174.74,Incoming
68393439,2023-02-05,715.62,104.42,Outgoing
68393439,2023-02-09,600.56,115.06,Outgoing
68393439,2023-02-10,731.1299999999999,130.57,Incoming
68393439,2023-02-12,798.7899999999998,67.66,Incoming
68393439,2023-02-12,758.7199999999998,40.07,Outgoing
68393439,2023-02-13,831.3699999999998,72.65,Incoming
68393439,2023-02-13,956.9799999999998,125.61,Incoming
68393439,2023-02-13,1109.8099999999997,152.83,Incoming
68423238,2023-01-31,972.94,,-
68423238,2023-02-05,892.72,80.22,Outgoing
68423238,2023-02-11,1000.12,107.4,Incoming
68423238,2023-02-12,915.72,84.4,Outgoing
68423238,2023-02-12,787.32,128.4,Outgoing
68423238,2023-02-13,612.0,175.32,Outgoing
68483071,2023-01-31,25.88,,-
68483071,2023-02-04,2148.58,2122.7,Incoming
68483071,2023-02-05,3729.38,1580.8,Incoming
68483071,2023-02-07,3562.51,166.87,Outgoing
68484031,2023-01-31,853.99,,-
68484031,2023-02-02,801.13,52.86,Outgoing
68484031,2023-02-05,782.24,18.89,Outgoing
68484031,2023-02-05,2245.84,1463.6,Incoming
68484031,2023-02-11,573.1400000000001,1672.7,Outgoing
68484031,2023-02-11,600.0100000000001,26.87,Incoming
68552857,2023-01-31,309.92,,-
68552857,2023-02-02,153.88000000000002,156.04,Outgoing
68552857,2023-02-02,260.48,106.6,Incoming
68552857,2023-02-08,329.08000000000004,68.6,Incoming
68552994,2023-01-31,516.25,,-
68552994,2023-02-01,579.2,62.95,Incoming
68552994,2023-02-08,2187.6000000000004,1608.4,Incoming
68552994,2023-02-09,2276.4100000000003,88.81,Incoming
68552994,2023-02-14,1494.9100000000003,781.5,Outgoing
68558850,2023-01-31,281.5,,-
68558850,2023-02-01,200.69,80.81,Outgoing
68558850,2023-02-04,-1194.61,1395.3,Outgoing
68558850,2023-02-06,-1011.6499999999999,182.96,Incoming
68558850,2023-02-07,-899.6999999999998,111.95,Incoming
68558850,2023-02-10,-828.9599999999998,70.74,Incoming
68558850,2023-02-12,-759.1099999999998,69.85,Incoming
68579203,2023-01-31,149.39,,-
68680764,2023-01-31,200.27,,-
68680764,2023-02-03,-686.33,886.6,Outgoing
68680764,2023-02-09,-605.11,81.22,Incoming
68683403,2023-01-31,674.5,,-
68683403,2023-02-05,611.18,63.32,Outgoing
68683403,2023-02-13,75.27999999999997,535.9,Outgoing
68689742,2023-01-31,45.41,,-
68689742,2023-02-07,-76.26,121.67,Outgoing
68689742,2023-02-07,-132.68,56.42,Outgoing
68689742,2023-02-14,-9.320000000000007,123.36,Incoming
68708795,2023-01-31,399.11,,-
68708795,2023-02-03,501.96000000000004,102.85,Incoming
68708795,2023-02-04,756.96,255.0,Incoming
68708795,2023-02-04,897.3900000000001,140.43,Incoming
68708795,2023-02-05,1007.1500000000001,109.76,Incoming
68708795,2023-02-07,1122.5500000000002,115.4,Incoming
68708795,2023-02-08,1256.7800000000002,134.23,Incoming
68708795,2023-02-09,1305.8400000000001,49.06,Incoming
68708795,2023-02-10,1444.64,138.8,Incoming
68708795,2023-02-14,2741.84,1297.2,Incoming
68721707,2023-01-31,900.45,,-
68721707,2023-02-03,786.6700000000001,113.78,Outgoing
68721707,2023-02-09,716.6800000000001,69.99,Outgoing
68721707,2023-02-10,830.24,113.56,Incoming
68775529,2023-01-31,531.87,,-
68775529,2023-02-03,-734.83,1266.7,Outgoing
68775529,2023-02-07,-621.0400000000001,113.79,Incoming
68775529,2023-02-08,-573.0300000000001,48.01,Incoming
68775529,2023-02-09,-697.1300000000001,124.1,Outgoing
68775529,2023-02-09,-1209.43,512.3,Outgoing
68775529,2023-02-10,-1338.76,129.33,Outgoing
68775529,2023-02-11,-1399.17,60.41,Outgoing
68775529,2023-02-12,-1577.54,178.37,Outgoing
68786878,2023-01-31,512.06,,-
68786878,2023-02-03,467.80999999999995,44.25,Outgoing
68786878,2023-02-12,388.68999999999994,79.12,Outgoing
68786878,2023-02-12,322.41999999999996,66.27,Outgoing
68786878,2023-02-14,381.09999999999997,58.68,Incoming
68793483,2023-01-31,581.36,,-
68793483,2023-02-02,1564.6599999999999,983.3,Incoming
68793483,2023-02-03,1444.7099999999998,119.95,Outgoing
68793483,2023-02-03,1259.6899999999998,185.02,Outgoing
68793483,2023-02-08,1370.1699999999998,110.48,Incoming
68793483,2023-02-08,1301.86,68.31,Outgoing
68793483,2023-02-09,1161.37,140.49,Outgoing
68793483,2023-02-09,1284.6499999999999,123.28,Incoming
68793483,2023-02-10,1168.11,116.54,Outgoing
68793483,2023-02-11,1794.71,626.6,Incoming
68793483,2023-02-13,1695.58,99.13,Outgoing
68793483,2023-02-14,1827.4099999999999,131.83,Incoming
68793483,2023-02-14,1887.2199999999998,59.81,Incoming
68793483,2023-02-14,1756.7799999999997,130.44,Outgoing
68798691,2023-01-31,819.33,,-
68798691,2023-02-01,931.85,112.52,Incoming
68798691,2023-02-04,939.59,7.74,Incoming
68798691,2023-02-05,1064.42,124.83,Incoming
68798691,2023-02-07,1011.2800000000001,53.14,Outgoing
68798691,2023-02-07,887.83,123.45,Outgoing
68798691,2023-02-11,923.9000000000001,36.07,Incoming
68798691,2023-02-11,957.5400000000001,33.64,Incoming
68798691,2023-02-12,1104.99,147.45,Incoming
68798691,2023-02-14,1057.15,47.84,Outgoing
68798691,2023-02-14,1113.8100000000002,56.66,Incoming
68798691,2023-02-14,1042.4,71.41,Outgoing
68800062,2023-01-31,749.65,,-
68800062,2023-02-04,1418.4499999999998,668.8,Incoming
68800062,2023-02-04,1252.6899999999998,165.76,Outgoing
68800062,2023-02-05,1103.2799999999997,149.41,Outgoing
68800062,2023-02-05,1379.6799999999998,276.4,Incoming
68800062,2023-02-06,1452.7899999999997,73.11,Incoming
68800062,2023-02-08,1569.1599999999999,116.37,Incoming
68800062,2023-02-08,1404.81,164.35,Outgoing
68800062,2023-02-09,1295.73,109.08,Outgoing
68800062,2023-02-09,1195.3700000000001,100.36,Outgoing
68800062,2023-02-13,1071.88,123.49,Outgoing
68836810,2023-01-31,171.96,,-
68836810,2023-02-02,300.26,128.3,Incoming
68836810,2023-02-04,211.14999999999998,89.11,Outgoing
68891568,2023-01-31,844.06,,-
68891568,2023-02-02,902.4599999999999,58.4,Incoming
68891568,2023-02-03,780.6399999999999,121.82,Outgoing
68891568,2023-02-09,792.8699999999999,12.23,Incoming
68891568,2023-02-13,823.2799999999999,30.41,Incoming
68891568,2023-02-13,900.5099999999999,77.23,Incoming
68891568,2023-02-13,862.3799999999999,38.13,Outgoing
68928221,2023-01-31,502.06,,-
68928221,2023-02-02,265.27,236.79,Outgoing
68928221,2023-02-02,347.38,82.11,Incoming
68928221,2023-02-04,451.90999999999997,104.53,Incoming
68928221,2023-02-06,280.60999999999996,171.3,Outgoing
68928221,2023-02-08,173.62999999999994,106.98,Outgoing
68928221,2023-02-09,127.54999999999994,46.08,Outgoing
68928221,2023-02-11,197.93999999999994,70.39,Incoming
68928221,2023-02-12,97.94999999999995,99.99,Outgoing
68928221,2023-02-14,-52.820000000000064,150.77,Outgoing
68928221,2023-02-14,-115.82000000000006,63.0,Outgoing
68962066,2023-01-31,304.46,,-
68962066,2023-02-02,-395.04,699.5,Outgoing
68962066,2023-02-03,-333.13,61.91,Incoming
68962066,2023-02-06,108.26999999999998,441.4,Incoming
68962066,2023-02-06,-89.34000000000003,197.61,Outgoing
68962066,2023-02-07,-230.39000000000004,141.05,Outgoing
68962066,2023-02-08,-450.73,220.34,Outgoing
68962066,2023-02-09,-346.89,103.84,Incoming
68962066,2023-02-09,-221.64999999999998,125.24,Incoming
68962066,2023-02-12,-176.42,45.23,Incoming
68962066,2023-02-12,-140.39999999999998,36.02,Incoming
68962066,2023-02-14,-64.41999999999997,75.98,Incoming
68973836,2023-01-31,634.67,,-
68973836,2023-02-01,518.0999999999999,116.57,Outgoing
68973836,2023-02-03,-437.30000000000007,955.4,Outgoing
68973836,2023-02-04,-280.0400000000001,157.26,Incoming
68973836,2023-02-05,-362.37000000000006,82.33,Outgoing
68973836,2023-02-05,-477.49000000000007,115.12,Outgoing
68973836,2023-02-10,-415.4800000000001,62.01,Incoming
68973836,2023-02-11,-1688.58,1273.1,Outgoing
68973836,2023-02-13,-1615.77,72.81,Incoming
69008969,2023-01-31,716.37,,-
69008969,2023-02-02,844.4,128.03,Incoming
69008969,2023-02-03,1001.55,157.15,Incoming
69008969,2023-02-07,1090.05,88.5,Incoming
69008969,2023-02-09,1031.36,58.69,Outgoing
69008969,2023-02-10,1174.98,143.62,Incoming
69008969,2023-02-11,1235.39,60.41,Incoming
69008969,2023-02-14,1167.69,67.7,Outgoing
69090518,2023-01-31,473.87,,-
69090518,2023-02-04,598.61,124.74,Incoming
69090518,2023-02-05,658.08,59.47,Incoming
69090518,2023-02-07,530.63,127.45,Outgoing
69090518,2023-02-09,431.52,99.11,Outgoing
69090518,2023-02-10,411.46999999999997,20.05,Outgoing
69090518,2023-02-13,568.74,157.27,Incoming
69118170,2023-01-31,109.35,,-
69118170,2023-02-01,-42.06,151.41,Outgoing
69118170,2023-02-02,14.239999999999995,56.3,Incoming
69118170,2023-02-06,1175.64,1161.4,Incoming
69118170,2023-02-07,1089.13,86.51,Outgoing
69118170,2023-02-08,978.69,110.44,Outgoing
69118170,2023-02-10,1158.69,180.0,Incoming
69118170,2023-02-11,1288.96,130.27,Incoming
69118170,2023-02-14,849.1600000000001,439.8,Outgoing
69153577,2023-01-31,402.52,,-
69153577,2023-02-05,514.97,112.45,Incoming
69153577,2023-02-07,378.88,136.09,Outgoing
69302678,2023-01-31,568.08,,-
69302678,2023-02-05,505.59000000000003,62.49,Outgoing
69302678,2023-02-10,418.81000000000006,86.78,Outgoing
69302678,2023-02-11,205.05000000000007,213.76,Outgoing
69302678,2023-02-12,73.02000000000007,132.03,Outgoing
69302678,2023-02-13,10.300000000000068,62.72,Outgoing
69306093,2023-01-31,189.46,,-
69306093,2023-02-05,28.0,161.46,Outgoing
69306093,2023-02-12,48.96,20.96,Incoming
69307050,2023-01-31,623.84,,-
69307050,2023-02-02,685.97,62.13,Incoming
69307050,2023-02-02,772.28,86.31,Incoming
69307050,2023-02-09,711.91,60.37,Outgoing
69307050,2023-02-09,662.63,49.28,Outgoing
69307050,2023-02-11,588.97,73.66,Outgoing
69307050,2023-02-12,485.23,103.74,Outgoing
69307050,2023-02-14,362.35,122.88,Outgoing
69315008,2023-01-31,923.08,,-
69315008,2023-02-01,-129.51999999999987,1052.6,Outgoing
69315008,2023-02-01,-56.72999999999986,72.79,Incoming
69315008,2023-02-02,-237.12999999999988,180.4,Outgoing
69315008,2023-02-05,-338.57999999999987,101.45,Outgoing
69315008,2023-02-07,-252.81999999999988,85.76,Incoming
69315008,2023-02-09,-61.999999999999886,190.82,Incoming
69315008,2023-02-12,-201.7499999999999,139.75,Outgoing
69344396,2023-01-31,304.19,,-
69344396,2023-02-02,-886.71,1190.9,Outgoing
69344396,2023-02-03,-984.13,97.42,Outgoing
69344396,2023-02-05,-845.23,138.9,Incoming
69344396,2023-02-06,-1685.53,840.3,Outgoing
69344396,2023-02-10,-1772.6,87.07,Outgoing
69344396,2023-02-11,-1932.8899999999999,160.29,Outgoing
69344396,2023-02-11,-2011.1799999999998,78.29,Outgoing
69344396,2023-02-12,-2129.95,118.77,Outgoing
69344396,2023-02-12,-2085.0699999999997,44.88,Incoming
69344396,2023-02-12,-2295.43,210.36,Outgoing
69344396,2023-02-14,-2393.54,98.11,Outgoing
69362270,2023-01-31,410.6,,-
69362270,2023-02-02,589.6,179.0,Incoming
69362270,2023-02-05,606.85,17.25,Incoming
69362270,2023-02-10,580.3000000000001,26.55,Outgoing
69362270,2023-02-11,446.5200000000001,133.78,Outgoing
69362270,2023-02-14,572.9800000000001,126.46,Incoming
69446767,2023-01-31,672.47,,-
69446767,2023-02-02,589.03,83.44,Outgoing
69446767,2023-02-06,566.5799999999999,22.45,Outgoing
69446767,2023-02-07,464.75999999999993,101.82,Outgoing
69446767,2023-02-09,356.8999999999999,107.86,Outgoing
69446767,2023-02-10,494.2399999999999,137.34,Incoming
69446767,2023-02-11,608.0399999999998,113.8,Incoming
69446767,2023-02-14,749.5199999999999,141.48,Incoming
69447534,2023-01-31,68.02,,-
69447534,2023-02-01,173.38,105.36,Incoming
69447534,2023-02-03,295.2,121.82,Incoming
69447534,2023-02-11,363.53,68.33,Incoming
69447534,2023-02-12,262.13,101.4,Outgoing
69447534,2023-02-13,300.17,38.04,Incoming
69468071,2023-01-31,652.9,,-
69468071,2023-02-04,734.06,81.16,Incoming
69468071,2023-02-05,622.14,111.92,Outgoing
69468071,2023-02-06,-1169.7600000000002,1791.9,Outgoing
69468071,2023-02-06,-1102.3100000000002,67.45,Incoming
69468071,2023-02-06,-1239.65,137.34,Outgoing
69468071,2023-02-07,-1309.0400000000002,69.39,Outgoing
69468071,2023-02-08,-1475.64,166.6,Outgoing
69468071,2023-02-09,-1438.93,36.71,Incoming
69468071,2023-02-12,-1422.25,16.68,Incoming
69468071,2023-02-13,-1520.4,98.15,Outgoing
69492532,2023-01-31,581.23,,-
69492532,2023-02-04,700.48,119.25,Incoming
69492532,2023-02-11,784.7,84.22,Incoming
69492532,2023-02-12,984.74,200.04,Incoming
69533742,2023-01-31,812.2,,-
69533742,2023-02-01,824.4100000000001,12.21,Incoming
69533742,2023-02-01,920.9200000000001,96.51,Incoming
69533742,2023-02-01,-476.48,1397.4,Outgoing
69533742,2023-02-03,-300.93,175.55,Incoming
69533742,2023-02-04,-218.37,82.56,Incoming
69533742,2023-02-05,-331.1,112.73,Outgoing
69533742,2023-02-06,-460.61,129.51,Outgoing
69533742,2023-02-07,-362.19,98.42,Incoming
69533742,2023-02-11,-297.03999999999996,65.15,Incoming
69533742,2023-02-11,-221.89999999999998,75.14,Incoming
69540137,2023-01-31,351.36,,-
69540137,2023-02-02,242.08,109.28,Outgoing
69540137,2023-02-06,190.37,51.71,Outgoing
69540137,2023-02-06,-283.33,473.7,Outgoing
69540137,2023-02-07,-456.88,173.55,Outgoing
69540137,2023-02-07,-598.87,141.99,Outgoing
69540137,2023-02-11,-630.91,32.04,Outgoing
69540137,2023-02-14,-1945.6100000000001,1314.7,Outgoing
69556322,2023-01-31,785.03,,-
69556322,2023-02-01,682.12,102.91,Outgoing
69556322,2023-02-02,657.25,24.87,Outgoing
69556322,2023-02-03,590.58,66.67,Outgoing
69556322,2023-02-03,478.43000000000006,112.15,Outgoing
69556322,2023-02-06,410.43000000000006,68.0,Outgoing
69556322,2023-02-12,535.9100000000001,125.48,Incoming
69556322,2023-02-13,598.2700000000001,62.36,Incoming
69556322,2023-02-14,-879.93,1478.2,Outgoing
69556322,2023-02-14,-2025.83,1145.9,Outgoing
69561077,2023-01-31,318.31,,-
69561077,2023-02-01,192.93,125.38,Outgoing
69561077,2023-02-03,169.43,23.5,Outgoing
69561077,2023-02-04,131.63,37.8,Outgoing
69561077,2023-02-05,-1785.4699999999998,1917.1,Outgoing
69561077,2023-02-08,-1618.12,167.35,Incoming
69561077,2023-02-09,-1562.1,56.02,Incoming
69561077,2023-02-10,-1637.9299999999998,75.83,Outgoing
69561077,2023-02-11,-1533.11,104.82,Incoming
69561077,2023-02-11,-1665.6699999999998,132.56,Outgoing
69561077,2023-02-12,-1809.58,143.91,Outgoing
69588947,2023-01-31,732.72,,-
69588947,2023-02-08,799.32,66.6,Incoming
69588947,2023-02-09,896.87,97.55,Incoming
69588947,2023-02-09,1011.32,114.45,Incoming
69588947,2023-02-10,1020.1700000000001,8.85,Incoming
69617552,2023-01-31,853.9,,-
69617552,2023-02-03,943.13,89.23,Incoming
69617552,2023-02-06,1039.92,96.79,Incoming
69617552,2023-02-08,1101.3200000000002,61.4,Incoming
69617552,2023-02-09,992.7500000000002,108.57,Outgoing
69617552,2023-02-14,1181.0500000000002,188.3,Incoming
69647833,2023-01-31,765.74,,-
69647833,2023-02-01,681.3,84.44,Outgoing
69647833,2023-02-03,626.89,54.41,Outgoing
69647833,2023-02-06,786.97,160.08,Incoming
69647833,2023-02-07,616.32,170.65,Outgoing
69647833,2023-02-07,753.2900000000001,136.97,Incoming
69647833,2023-02-13,860.45,107.16,Incoming
69647833,2023-02-13,745.01,115.44,Outgoing
69648759,2023-01-31,693.39,,-
69648759,2023-02-01,612.47,80.92,Outgoing
69648759,2023-02-10,768.14,155.67,Incoming
69648759,2023-02-13,2271.34,1503.2,Incoming
69648759,2023-02-14,2397.3700000000003,126.03,Incoming
69648759,2023-02-14,2234.03,163.34,Outgoing
69664627,2023-01-31,897.76,,-
69664627,2023-02-01,1028.54,130.78,Incoming
69664627,2023-02-07,809.76,218.78,Outgoing
69664627,2023-02-10,781.51,28.25,Outgoing
69664627,2023-02-12,-701.3900000000001,1482.9,Outgoing
69664627,2023-02-13,-537.4000000000001,163.99,Incoming
69665438,2023-01-31,417.78,,-
69665438,2023-02-01,576.3499999999999,158.57,Incoming
69665438,2023-02-01,675.9099999999999,99.56,Incoming
69665438,2023-02-05,751.8499999999999,75.94,Incoming
69683385,2023-01-31,519.63,,-
69683385,2023-02-04,465.26,54.37,Outgoing
69683385,2023-02-07,568.16,102.9,Incoming
69730266,2023-01-31,732.61,,-
69730266,2023-02-04,827.98,95.37,Incoming
69730266,2023-02-07,933.64,105.66,Incoming
69730266,2023-02-09,830.95,102.69,Outgoing
69730266,2023-02-12,910.7,79.75,Incoming
69796371,2023-01-31,649.23,,-
69796371,2023-02-02,743.8,94.57,Incoming
69796371,2023-02-03,683.63,60.17,Outgoing
69796371,2023-02-04,-728.87,1412.5,Outgoing
69796371,2023-02-05,-838.63,109.76,Outgoing
69796371,2023-02-06,-1020.91,182.28,Outgoing
69796371,2023-02-11,-1187.21,166.3,Outgoing
69796371,2023-02-14,-3189.91,2002.7,Outgoing
69806946,2023-01-31,971.49,,-
69806946,2023-02-07,883.6700000000001,87.82,Outgoing
69806946,2023-02-08,1066.72,183.05,Incoming
69939682,2023-01-31,854.18,,-
69939682,2023-02-01,759.27,94.91,Outgoing
69939682,2023-02-01,879.4,120.13,Incoming
69939682,2023-02-08,885.13,5.73,Incoming
69939682,2023-02-09,1028.9,143.77,Incoming
69939682,2023-02-11,1243.8000000000002,214.9,Incoming
70010970,2023-01-31,114.23,,-
70010970,2023-02-06,242.93,128.7,Incoming
70010970,2023-02-08,311.95,69.02,Incoming
70010970,2023-02-11,493.63,181.68,Incoming
70013367,2023-01-31,38.86,,-
70013367,2023-02-04,109.62,70.76,Incoming
70013367,2023-02-06,-550.68,660.3,Outgoing
70013367,2023-02-06,-689.51,138.83,Outgoing
70013367,2023-02-09,-829.86,140.35,Outgoing
70013367,2023-02-13,-733.8,96.06,Incoming
70034563,2023-01-31,723.18,,-
70034563,2023-02-01,573.3799999999999,149.8,Outgoing
70034563,2023-02-02,695.7999999999998,122.42,Incoming
70034563,2023-02-04,599.7099999999998,96.09,Outgoing
70034563,2023-02-05,737.6899999999998,137.98,Incoming
70034563,2023-02-13,919.8299999999998,182.14,Incoming
70049609,2023-01-31,226.63,,-
70049609,2023-02-07,136.89999999999998,89.73,Outgoing
70049609,2023-02-07,61.76999999999998,75.13,Outgoing
70049609,2023-02-10,171.65999999999997,109.89,Incoming
70049609,2023-02-10,255.82999999999998,84.17,Incoming
70049609,2023-02-13,154.17,101.66,Outgoing
70049609,2023-02-14,50.27999999999999,103.89,Outgoing
70123664,2023-01-31,483.12,,-
70123664,2023-02-01,605.63,122.51,Incoming
70123664,2023-02-02,732.91,127.28,Incoming
70123664,2023-02-03,847.49,114.58,Incoming
70123664,2023-02-04,823.1800000000001,24.31,Outgoing
70123664,2023-02-08,1032.19,209.01,Incoming
70129567,2023-01-31,886.92,,-
70129567,2023-02-01,834.5999999999999,52.32,Outgoing
70129567,2023-02-03,933.2699999999999,98.67,Incoming
70129567,2023-02-04,1066.32,133.05,Incoming
70129567,2023-02-06,965.7299999999999,100.59,Outgoing
70129567,2023-02-08,1114.9899999999998,149.26,Incoming
70129567,2023-02-09,939.5999999999998,175.39,Outgoing
70129567,2023-02-10,986.8199999999998,47.22,Incoming
70129567,2023-02-10,921.5299999999999,65.29,Outgoing
70129567,2023-02-11,706.6299999999999,214.9,Outgoing
70129567,2023-02-11,832.2799999999999,125.65,Incoming
70129567,2023-02-12,797.1099999999999,35.17,Outgoing
70163139,2023-01-31,674.14,,-
70163139,2023-02-01,588.2,85.94,Outgoing
70163139,2023-02-05,472.0400000000001,116.16,Outgoing
70163139,2023-02-06,503.9500000000001,31.91,Incoming
70163139,2023-02-07,382.30000000000007,121.65,Outgoing
70163139,2023-02-11,326.9700000000001,55.33,Outgoing
70163139,2023-02-11,168.39000000000007,158.58,Outgoing
70163139,2023-02-11,67.53000000000007,100.86,Outgoing
70163139,2023-02-12,-102.86999999999993,170.4,Outgoing
70163139,2023-02-12,-167.09999999999994,64.23,Outgoing
70163139,2023-02-14,-215.48999999999995,48.39,Outgoing
70185446,2023-01-31,863.26,,-
70185446,2023-02-08,671.62,191.64,Outgoing
70185446,2023-02-09,574.33,97.29,Outgoing
70185446,2023-02-11,477.41,96.92,Outgoing
70214700,2023-01-31,152.79,,-
70214700,2023-02-01,1408.09,1255.3,Incoming
70214700,2023-02-02,1492.6799999999998,84.59,Incoming
70214700,2023-02-06,2990.9799999999996,1498.3,Incoming
70214700,2023-02-07,3080.1299999999997,89.15,Incoming
70214700,2023-02-12,2953.1299999999997,127.0,Outgoing
70214700,2023-02-14,2920.0399999999995,33.09,Outgoing
70214700,2023-02-14,3022.5699999999997,102.53,Incoming
70217229,2023-01-31,705.69,,-
70217229,2023-02-02,538.47,167.22,Outgoing
70217229,2023-02-02,347.57000000000005,190.9,Outgoing
70217229,2023-02-03,475.15000000000003,127.58,Incoming
70217229,2023-02-06,415.63000000000005,59.52,Outgoing
70217229,2023-02-12,286.02000000000004,129.61,Outgoing
70217229,2023-02-12,777.6200000000001,491.6,Incoming
70217229,2023-02-14,824.2300000000001,46.61,Incoming
70221848,2023-01-31,550.83,,-
70221848,2023-02-01,480.9200000000001,69.91,Outgoing
70221848,2023-02-03,305.37000000000006,175.55,Outgoing
70221848,2023-02-05,282.24000000000007,23.13,Outgoing
70221848,2023-02-08,132.98000000000008,149.26,Outgoing
70231750,2023-01-31,749.6,,-
70231750,2023-02-02,562.4100000000001,187.19,Outgoing
70231750,2023-02-03,2690.8100000000004,2128.4,Incoming
70231750,2023-02-04,2838.8700000000003,148.06,Incoming
70231750,2023-02-04,4457.070000000001,1618.2,Incoming
70231750,2023-02-09,4344.6900000000005,112.38,Outgoing
70231750,2023-02-10,4536.77,192.08,Incoming
70231750,2023-02-11,4436.7300000000005,100.04,Outgoing
70331285,2023-01-31,537.34,,-
70331285,2023-02-08,611.73,74.39,Incoming
70331285,2023-02-09,490.6,121.13,Outgoing
70331285,2023-02-10,434.01,56.59,Outgoing
70331285,2023-02-14,539.12,105.11,Incoming
70351135,2023-01-31,169.6,,-
70351135,2023-02-01,165.71,3.89,Outgoing
70351135,2023-02-05,36.99000000000001,128.72,Outgoing
70351135,2023-02-13,204.51000000000002,167.52,Incoming
70375931,2023-01-31,980.21,,-
70375931,2023-02-05,887.32,92.89,Outgoing
70375931,2023-02-07,1040.28,152.96,Incoming
70375931,2023-02-11,953.12,87.16,Outgoing
70375931,2023-02-13,793.66,159.46,Outgoing
70384410,2023-01-31,718.99,,-
70384410,2023-02-04,596.79,122.2,Outgoing
70384410,2023-02-04,726.43,129.64,Incoming
70384410,2023-02-09,-243.2700000000001,969.7,Outgoing
70384410,2023-02-11,-187.8900000000001,55.38,Incoming
70384410,2023-02-13,-341.2900000000001,153.4,Outgoing
70385129,2023-01-31,252.45,,-
70385129,2023-02-01,130.99,121.46,Outgoing
70385129,2023-02-08,105.62,25.37,Outgoing
70385129,2023-02-10,-29.370000000000005,134.99,Outgoing
70409852,2023-01-31,662.8,,-
70409852,2023-02-04,744.15,81.35,Incoming
70409852,2023-02-06,607.01,137.14,Outgoing
70409852,2023-02-09,674.34,67.33,Incoming
70409852,2023-02-10,648.9300000000001,25.41,Outgoing
70409852,2023-02-11,546.7700000000001,102.16,Outgoing
70469258,2023-01-31,868.53,,-
70469258,2023-02-04,939.92,71.39,Incoming
70469258,2023-02-05,-1172.88,2112.8,Outgoing
70469258,2023-02-08,-1253.0400000000002,80.16,Outgoing
70469258,2023-02-09,-1081.3300000000002,171.71,Incoming
70469258,2023-02-10,494.26999999999975,1575.6,Incoming
70469258,2023-02-14,541.3799999999998,47.11,Incoming
70505401,2023-01-31,138.85,,-
70505401,2023-02-04,252.82999999999998,113.98,Incoming
70505401,2023-02-04,138.84999999999997,113.98,Outgoing
70505401,2023-02-11,15.039999999999964,123.81,Outgoing
70505401,2023-02-11,73.39999999999996,58.36,Incoming
70505401,2023-02-14,957.9,884.5,Incoming
70554021,2023-01-31,44.26,,-
70554021,2023-02-05,-85.23000000000002,129.49,Outgoing
70554021,2023-02-06,31.419999999999987,116.65,Incoming
70554021,2023-02-10,1219.72,1188.3,Incoming
70554021,2023-02-11,1093.63,126.09,Outgoing
70554021,2023-02-11,1015.3800000000001,78.25,Outgoing
70554021,2023-02-12,951.69,63.69,Outgoing
70567557,2023-01-31,984.3,,-
70567557,2023-02-07,942.66,41.64,Outgoing
70567557,2023-02-08,757.4399999999999,185.22,Outgoing
70567557,2023-02-08,845.17,87.73,Incoming
70567557,2023-02-13,715.8499999999999,129.32,Outgoing
70567557,2023-02-14,602.0699999999999,113.78,Outgoing
70571486,2023-01-31,573.26,,-
70571486,2023-02-01,625.43,52.17,Incoming
70571486,2023-02-07,1264.73,639.3,Incoming
70571486,2023-02-10,1304.18,39.45,Incoming
70571486,2023-02-11,1188.93,115.25,Outgoing
70571486,2023-02-12,1141.68,47.25,Outgoing
70624878,2023-01-31,328.5,,-
70624878,2023-02-01,487.01,158.51,Incoming
70624878,2023-02-03,-338.78999999999996,825.8,Outgoing
70624878,2023-02-05,-529.56,190.77,Outgoing
70624878,2023-02-08,-435.2199999999999,94.34,Incoming
70624878,2023-02-08,-626.0999999999999,190.88,Outgoing
70624878,2023-02-08,425.20000000000005,1051.3,Incoming
70643766,2023-01-31,143.86,,-
70643766,2023-02-03,335.94000000000005,192.08,Incoming
70643766,2023-02-07,476.08000000000004,140.14,Incoming
70652524,2023-01-31,342.86,,-
70652524,2023-02-05,266.63,76.23,Outgoing
70652524,2023-02-05,185.45,81.18,Outgoing
70652524,2023-02-07,124.07999999999998,61.37,Outgoing
70652524,2023-02-11,34.09999999999998,89.98,Outgoing
70652524,2023-02-12,-70.36000000000001,104.46,Outgoing
70665892,2023-01-31,856.22,,-
70665892,2023-02-01,1021.88,165.66,Incoming
70665892,2023-02-04,976.85,45.03,Outgoing
70665892,2023-02-08,862.9300000000001,113.92,Outgoing
70665892,2023-02-09,-502.77,1365.7,Outgoing
70665892,2023-02-11,-459.65,43.12,Incoming
70665892,2023-02-12,-705.3499999999999,245.7,Outgoing
70719064,2023-01-31,752.97,,-
70719064,2023-02-02,951.4200000000001,198.45,Incoming
70719064,2023-02-02,-854.0799999999999,1805.5,Outgoing
70719064,2023-02-04,-690.1199999999999,163.96,Incoming
70719064,2023-02-06,-1655.32,965.2,Outgoing
70719064,2023-02-08,-1800.72,145.4,Outgoing
70719064,2023-02-11,-1840.94,40.22,Outgoing
70749706,2023-01-31,963.82,,-
70749706,2023-02-01,1083.7,119.88,Incoming
70749706,2023-02-04,1205.93,122.23,Incoming
70749706,2023-02-07,1343.44,137.51,Incoming
70749706,2023-02-09,1493.67,150.23,Incoming
70749706,2023-02-10,1434.92,58.75,Outgoing
70749706,2023-02-12,1526.8500000000001,91.93,Incoming
70905083,2023-01-31,623.65,,-
70905083,2023-02-02,503.76,119.89,Outgoing
70905083,2023-02-02,372.23,131.53,Outgoing
70905083,2023-02-03,238.82000000000002,133.41,Outgoing
70905083,2023-02-07,135.47000000000003,103.35,Outgoing
70920653,2023-01-31,577.7,,-
70920653,2023-02-02,666.5,88.8,Incoming
70920653,2023-02-04,764.31,97.81,Incoming
70920653,2023-02-10,640.54,123.77,Outgoing
70925461,2023-01-31,260.33,,-
70925461,2023-02-01,327.16999999999996,66.84,Incoming
70925461,2023-02-03,229.66999999999996,97.5,Outgoing
70925461,2023-02-06,356.49999999999994,126.83,Incoming
70925461,2023-02-06,310.3399999999999,46.16,Outgoing
70925461,2023-02-06,175.6599999999999,134.68,Outgoing
70925461,2023-02-07,330.06999999999994,154.41,Incoming
70925461,2023-02-08,433.9599999999999,103.89,Incoming
70925461,2023-02-08,311.9799999999999,121.98,Outgoing
70925461,2023-02-09,110.3599999999999,201.62,Outgoing
70925461,2023-02-09,398.1599999999999,287.8,Incoming
70925461,2023-02-12,498.4099999999999,100.25,Incoming
70925461,2023-02-12,1405.51,907.1,Incoming
70954264,2023-01-31,331.51,,-
70954264,2023-02-01,474.41999999999996,142.91,Incoming
70954264,2023-02-02,555.62,81.2,Incoming
70954264,2023-02-08,591.4300000000001,35.81,Incoming
70954264,2023-02-10,477.62000000000006,113.81,Outgoing
70954264,2023-02-10,567.94,90.32,Incoming
70954264,2023-02-10,632.4000000000001,64.46,Incoming
70954264,2023-02-12,709.0000000000001,76.6,Incoming
70954264,2023-02-12,791.9100000000001,82.91,Incoming
70954264,2023-02-13,893.3900000000001,101.48,Incoming
70989002,2023-01-31,220.06,,-
70989002,2023-02-03,354.43,134.37,Incoming
70989002,2023-02-04,219.95000000000002,134.48,Outgoing
70989002,2023-02-04,331.14,111.19,Incoming
70989002,2023-02-05,32.839999999999975,298.3,Outgoing
70989002,2023-02-05,-69.34000000000003,102.18,Outgoing
70989002,2023-02-06,-185.99000000000004,116.65,Outgoing
70989002,2023-02-12,-98.26000000000003,87.73,Incoming
70989002,2023-02-13,-254.3,156.04,Outgoing
71014167,2023-01-31,654.16,,-
71014167,2023-02-01,596.11,58.05,Outgoing
71014167,2023-02-02,523.39,72.72,Outgoing
71014167,2023-02-04,641.76,118.37,Incoming
71014167,2023-02-06,688.09,46.33,Incoming
71014167,2023-02-07,565.5600000000001,122.53,Outgoing
71014167,2023-02-12,650.3100000000001,84.75,Incoming
71014167,2023-02-14,569.33,80.98,Outgoing
71045135,2023-01-31,98.76,,-
71045135,2023-02-11,142.23000000000002,43.47,Incoming
71045135,2023-02-11,1131.53,989.3,Incoming
71045135,2023-02-12,1076.61,54.92,Outgoing
71045135,2023-02-14,1210.32,133.71,Incoming
71051904,2023-01-31,48.92,,-
71051904,2023-02-02,142.76,93.84,Incoming
71051904,2023-02-06,40.66,102.1,Outgoing
71051904,2023-02-08,-76.7,117.36,Outgoing
71051904,2023-02-13,-74.44,2.26,Incoming
71082437,2023-01-31,717.98,,-
71082437,2023-02-04,606.79,111.19,Outgoing
71082437,2023-02-06,658.3199999999999,51.53,Incoming
71082437,2023-02-11,780.7399999999999,122.42,Incoming
71082437,2023-02-11,669.6299999999999,111.11,Outgoing
71082437,2023-02-12,573.0299999999999,96.6,Outgoing
71082437,2023-02-13,649.1399999999999,76.11,Incoming
71135606,2023-01-31,728.32,,-
71135606,2023-02-02,832.82,104.5,Incoming
71135606,2023-02-02,932.26,99.44,Incoming
71135606,2023-02-04,979.42,47.16,Incoming
71135606,2023-02-08,1044.48,65.06,Incoming
71135606,2023-02-09,885.4300000000001,159.05,Outgoing
71135606,2023-02-09,818.6,66.83,Outgoing
71135606,2023-02-12,845.19,26.59,Incoming
71135606,2023-02-12,962.0200000000001,116.83,Incoming
71135606,2023-02-13,888.8300000000002,73.19,Outgoing
71137421,2023-01-31,65.44,,-
71137421,2023-02-01,4.359999999999999,61.08,Outgoing
71137421,2023-02-02,-104.93,109.29,Outgoing
71137421,2023-02-02,-77.49000000000001,27.44,Incoming
71137421,2023-02-07,2.499999999999986,79.99,Incoming
71137421,2023-02-07,-51.280000000000015,53.78,Outgoing
71137421,2023-02-07,897.9200000000001,949.2,Incoming
71137421,2023-02-08,707.8000000000001,190.12,Outgoing
71137421,2023-02-14,831.49,123.69,Incoming
71161073,2023-01-31,861.98,,-
71161073,2023-02-01,961.5,99.52,Incoming
71161073,2023-02-02,1055.7,94.2,Incoming
71161073,2023-02-09,864.4100000000001,191.29,Outgoing
71183710,2023-01-31,989.68,,-
71183710,2023-02-02,1067.22,77.54,Incoming
71183710,2023-02-03,1061.91,5.31,Outgoing
71183710,2023-02-03,1127.71,65.8,Incoming
71183710,2023-02-04,1271.66,143.95,Incoming
71183710,2023-02-06,1339.66,68.0,Incoming
71183710,2023-02-07,1426.18,86.52,Incoming
71183710,2023-02-08,1357.5,68.68,Outgoing
71183710,2023-02-13,1435.41,77.91,Incoming
71213535,2023-01-31,686.81,,-
71213535,2023-02-07,603.4699999999999,83.34,Outgoing
71213535,2023-02-08,384.56999999999994,218.9,Outgoing
71213535,2023-02-08,247.83999999999995,136.73,Outgoing
71247681,2023-01-31,955.43,,-
71247681,2023-02-03,1069.8999999999999,114.47,Incoming
71247681,2023-02-11,1199.9799999999998,130.08,Incoming
71247681,2023-02-14,1293.4999999999998,93.52,Incoming
71264941,2023-01-31,195.49,,-
71264941,2023-02-01,102.85000000000001,92.64,Outgoing
71264941,2023-02-01,-57.52999999999999,160.38,Outgoing
71264941,2023-02-01,-228.41999999999996,170.89,Outgoing
71264941,2023-02-06,-195.09999999999997,33.32,Incoming
71264941,2023-02-10,-214.81999999999996,19.72,Outgoing
71264941,2023-02-11,-208.39999999999998,6.42,Incoming
71264941,2023-02-11,-310.24,101.84,Outgoing
71264941,2023-02-11,-506.73,196.49,Outgoing
71264941,2023-02-11,-284.68,222.05,Incoming
71266283,2023-01-31,496.77,,-
71266283,2023-02-04,-721.23,1218.0,Outgoing
71266283,2023-02-05,-856.09,134.86,Outgoing
71266283,2023-02-07,-704.76,151.33,Incoming
71266283,2023-02-09,-809.97,105.21,Outgoing
71266283,2023-02-09,-748.82,61.15,Incoming
71266283,2023-02-13,-766.86,18.04,Outgoing
71266283,2023-02-13,-905.83,138.97,Outgoing
71266283,2023-02-13,-681.95,223.88,Incoming
71280775,2023-01-31,427.44,,-
71280775,2023-02-03,552.3199999999999,124.88,Incoming
71280775,2023-02-03,486.5199999999999,65.8,Outgoing
71280775,2023-02-04,338.4599999999999,148.06,Outgoing
71280775,2023-02-05,452.68999999999994,114.23,Incoming
71280775,2023-02-06,1629.5900000000001,1176.9,Incoming
71280775,2023-02-06,1537.7400000000002,91.85,Outgoing
71280775,2023-02-06,1409.8700000000003,127.87,Outgoing
71280775,2023-02-09,1297.1800000000003,112.69,Outgoing
71293250,2023-01-31,686.0,,-
71293250,2023-02-04,691.86,5.86,Incoming
71293250,2023-02-06,571.71,120.15,Outgoing
71293250,2023-02-08,481.62,90.09,Outgoing
71293250,2023-02-11,580.98,99.36,Incoming
71332337,2023-01-31,661.23,,-
71332337,2023-02-07,2095.5299999999997,1434.3,Incoming
71332337,2023-02-08,1981.8799999999997,113.65,Outgoing
71332337,2023-02-08,2177.8299999999995,195.95,Incoming
71332337,2023-02-10,2089.4999999999995,88.33,Outgoing
71332337,2023-02-12,1969.3799999999997,120.12,Outgoing
71332337,2023-02-14,2065.2499999999995,95.87,Incoming
71381278,2023-01-31,592.79,,-
71381278,2023-02-03,659.4599999999999,66.67,Incoming
71381278,2023-02-09,577.3599999999999,82.1,Outgoing
71381278,2023-02-11,767.54,190.18,Incoming
71381278,2023-02-11,-475.46000000000004,1243.0,Outgoing
71381278,2023-02-12,-229.76000000000005,245.7,Incoming
71381278,2023-02-14,-355.70000000000005,125.94,Outgoing
71383376,2023-01-31,448.26,,-
71383376,2023-02-01,619.22,170.96,Incoming
71383376,2023-02-03,-1000.3799999999999,1619.6,Outgoing
71383376,2023-02-04,-115.4799999999999,884.9,Incoming
71383376,2023-02-07,-208.1799999999999,92.7,Outgoing
71383376,2023-02-09,-102.4699999999999,105.71,Incoming
71383376,2023-02-10,-196.6099999999999,94.14,Outgoing
71383376,2023-02-11,-236.18999999999988,39.58,Outgoing
71394875,2023-01-31,778.77,,-
71394875,2023-02-01,891.11,112.34,Incoming
71394875,2023-02-03,725.6,165.51,Outgoing
71394875,2023-02-04,685.45,40.15,Outgoing
71394875,2023-02-05,616.7,68.75,Outgoing
71394875,2023-02-06,761.3800000000001,144.68,Incoming
71394875,2023-02-13,603.3500000000001,158.03,Outgoing
71394875,2023-02-14,670.7100000000002,67.36,Incoming
71444662,2023-01-31,276.78,,-
71444662,2023-02-01,377.85999999999996,101.08,Incoming
71444662,2023-02-02,493.85999999999996,116.0,Incoming
71444662,2023-02-04,1625.1599999999999,1131.3,Incoming
71444662,2023-02-07,1537.9699999999998,87.19,Outgoing
71444662,2023-02-12,1605.62,67.65,Incoming
71444662,2023-02-13,1424.11,181.51,Outgoing
71444662,2023-02-14,1548.87,124.76,Incoming
71469803,2023-01-31,14.79,,-
71469803,2023-02-05,-136.36,151.15,Outgoing
71469803,2023-02-05,-18.340000000000018,118.02,Incoming
71469803,2023-02-11,173.58999999999997,191.93,Incoming
71469803,2023-02-14,238.47999999999996,64.89,Incoming
71469803,2023-02-14,96.98999999999995,141.49,Outgoing
71536854,2023-01-31,42.99,,-
71536854,2023-02-06,136.95,93.96,Incoming
71536854,2023-02-10,317.95,181.0,Incoming
71536854,2023-02-11,175.48,142.47,Outgoing
71536854,2023-02-11,287.58,112.1,Incoming
71562080,2023-01-31,352.05,,-
71562080,2023-02-04,288.24,63.81,Outgoing
71562080,2023-02-09,186.73000000000002,101.51,Outgoing
71562080,2023-02-14,322.45000000000005,135.72,Incoming
71594658,2023-01-31,392.66,,-
71594658,2023-02-07,324.71000000000004,67.95,Outgoing
71594658,2023-02-10,418.08000000000004,93.37,Incoming
71594658,2023-02-11,520.99,102.91,Incoming
71594658,2023-02-11,484.63,36.36,Outgoing
71594658,2023-02-12,402.76,81.87,Outgoing
71594658,2023-02-12,294.57,108.19,Outgoing
71594658,2023-02-14,301.83,7.26,Incoming
71643841,2023-01-31,232.5,,-
71643841,2023-02-03,71.13,161.37,Outgoing
71643841,2023-02-06,184.76,113.63,Incoming
71643841,2023-02-12,113.36999999999999,71.39,Outgoing
71643841,2023-02-13,-11.790000000000006,125.16,Outgoing
71643841,2023-02-14,1296.81,1308.6,Incoming
71675127,2023-01-31,353.48,,-
71675127,2023-02-02,209.53000000000003,143.95,Outgoing
71675127,2023-02-07,381.06000000000006,171.53,Incoming
71675127,2023-02-11,298.68000000000006,82.38,Outgoing
71718483,2023-01-31,747.34,,-
71718483,2023-02-01,-342.2599999999999,1089.6,Outgoing
71718483,2023-02-02,-1535.56,1193.3,Outgoing
71718483,2023-02-02,-1434.95,100.61,Incoming
71718483,2023-02-02,-1322.6000000000001,112.35,Incoming
71718483,2023-02-02,-1417.17,94.57,Outgoing
71718483,2023-02-09,-1459.42,42.25,Outgoing
71718483,2023-02-12,-1549.75,90.33,Outgoing
71718483,2023-02-13,-1717.27,167.52,Outgoing
71791483,2023-01-31,873.44,,-
71791483,2023-02-03,773.51,99.93,Outgoing
71791483,2023-02-04,808.15,34.64,Incoming
71791483,2023-02-12,894.42,86.27,Incoming
71792376,2023-01-31,4.39,,-
71792376,2023-02-02,55.1,50.71,Incoming
71792376,2023-02-03,131.97,76.87,Incoming
71792376,2023-02-07,57.2,74.77,Outgoing
71792376,2023-02-09,125.82000000000001,68.62,Incoming
71792376,2023-02-09,285.92,160.1,Incoming
71792376,2023-02-11,233.44000000000003,52.48,Outgoing
71792376,2023-02-11,317.52000000000004,84.08,Incoming
71792376,2023-02-14,227.04000000000002,90.48,Outgoing
71825742,2023-01-31,665.75,,-
71825742,2023-02-02,467.47,198.28,Outgoing
71825742,2023-02-08,1436.27,968.8,Incoming
71852263,2023-01-31,676.77,,-
71852263,2023-02-10,634.63,42.14,Outgoing
71852263,2023-02-14,471.4,163.23,Outgoing
71868471,2023-01-31,474.32,,-
71868471,2023-02-05,1789.4199999999998,1315.1,Incoming
71868471,2023-02-07,1599.7999999999997,189.62,Outgoing
71868471,2023-02-08,1403.5499999999997,196.25,Outgoing
71868471,2023-02-11,1524.7999999999997,121.25,Incoming
71868471,2023-02-12,1517.2099999999998,7.59,Outgoing
71913103,2023-01-31,5.42,,-
71913103,2023-02-02,-112.07,117.49,Outgoing
71913103,2023-02-06,-233.2,121.13,Outgoing
71913103,2023-02-07,-360.57,127.37,Outgoing
71913103,2023-02-08,-401.53999999999996,40.97,Outgoing
71934515,2023-01-31,340.99,,-
71934515,2023-02-05,281.52,59.47,Outgoing
71934515,2023-02-06,1293.02,1011.5,Incoming
71934515,2023-02-08,1651.92,358.9,Incoming
71934515,2023-02-08,1501.3700000000001,150.55,Outgoing
71934515,2023-02-09,1583.47,82.1,Incoming
71939863,2023-01-31,116.31,,-
71939863,2023-02-01,-19.909999999999997,136.22,Outgoing
71939863,2023-02-05,-130.0,110.09,Outgoing
71939863,2023-02-06,-1125.2,995.2,Outgoing
71939863,2023-02-11,-1228.04,102.84,Outgoing
72008772,2023-01-31,725.22,,-
72008772,2023-02-01,836.12,110.9,Incoming
72008772,2023-02-03,-955.4799999999999,1791.6,Outgoing
72008772,2023-02-04,-843.2599999999999,112.22,Incoming
72008772,2023-02-06,-938.9699999999999,95.71,Outgoing
72008772,2023-02-06,-999.8199999999999,60.85,Outgoing
72008772,2023-02-09,-1083.46,83.64,Outgoing
72008772,2023-02-09,-908.07,175.39,Incoming
72008772,2023-02-13,-989.9300000000001,81.86,Outgoing
72008772,2023-02-14,-876.46,113.47,Incoming
72050477,2023-01-31,95.87,,-
72050477,2023-02-03,202.47,106.6,Incoming
72050477,2023-02-08,45.609999999999985,156.86,Outgoing
72055977,2023-01-31,172.73,,-
72055977,2023-02-09,-451.47,624.2,Outgoing
72055977,2023-02-09,-559.7,108.23,Outgoing
72055977,2023-02-10,-381.69000000000005,178.01,Incoming
72055977,2023-02-11,-460.35,78.66,Outgoing
72087700,2023-01-31,359.55,,-
72087700,2023-02-06,199.3,160.25,Outgoing
72087700,2023-02-07,-29.98999999999998,229.29,Outgoing
72087700,2023-02-09,-55.56999999999998,25.58,Outgoing
72087700,2023-02-12,54.33000000000003,109.9,Incoming
72087700,2023-02-13,-71.58999999999997,125.92,Outgoing
72120467,2023-01-31,340.15,,-
72120467,2023-02-04,415.4,75.25,Incoming
72120467,2023-02-11,540.9499999999999,125.55,Incoming
72164482,2023-01-31,535.39,,-
72164482,2023-02-02,619.18,83.79,Incoming
72164482,2023-02-09,1570.1799999999998,951.0,Incoming
72164482,2023-02-10,1659.2899999999997,89.11,Incoming
72164482,2023-02-12,1015.6899999999997,643.6,Outgoing
72176895,2023-01-31,109.78,,-
72176895,2023-02-03,44.870000000000005,64.91,Outgoing
72176895,2023-02-09,83.01,38.14,Incoming
72176895,2023-02-09,-77.52999999999999,160.54,Outgoing
72176895,2023-02-13,759.87,837.4,Incoming
72176895,2023-02-13,609.49,150.38,Outgoing
72208029,2023-01-31,11.37,,-
72208029,2023-02-01,10.87,0.5,Outgoing
72208029,2023-02-02,192.49,181.62,Incoming
72208029,2023-02-05,331.59000000000003,139.1,Incoming
72208029,2023-02-06,1355.79,1024.2,Incoming
72208029,2023-02-06,1289.6299999999999,66.16,Outgoing
72208029,2023-02-09,1463.5099999999998,173.88,Incoming
72208029,2023-02-09,1603.62,140.11,Incoming
72208029,2023-02-10,1683.9799999999998,80.36,Incoming
72208029,2023-02-13,1786.1999999999998,102.22,Incoming
72208029,2023-02-14,1927.8199999999997,141.62,Incoming
72230395,2023-01-31,773.55,,-
72230395,2023-02-03,904.29,130.74,Incoming
72230395,2023-02-03,749.27,155.02,Outgoing
72230395,2023-02-09,803.22,53.95,Incoming
72230395,2023-02-11,889.9100000000001,86.69,Incoming
72230395,2023-02-13,1408.21,518.3,Incoming
72230395,2023-02-14,2005.91,597.7,Incoming
72268811,2023-01-31,694.68,,-
72268811,2023-02-02,756.7199999999999,62.04,Incoming
72268811,2023-02-02,908.0899999999999,151.37,Incoming
72268811,2023-02-03,774.2399999999999,133.85,Outgoing
72268811,2023-02-08,704.1599999999999,70.08,Outgoing
72268811,2023-02-09,838.3699999999999,134.21,Incoming
72268811,2023-02-11,705.4299999999998,132.94,Outgoing
72268811,2023-02-12,621.2999999999998,84.13,Outgoing
72289791,2023-01-31,502.96,,-
72289791,2023-02-02,372.02,130.94,Outgoing
72289791,2023-02-07,360.03,11.99,Outgoing
72289791,2023-02-07,174.64,185.39,Outgoing
72289791,2023-02-10,1221.44,1046.8,Incoming
72289791,2023-02-11,1285.24,63.8,Incoming
72292735,2023-01-31,723.43,,-
72292735,2023-02-01,774.38,50.95,Incoming
72292735,2023-02-01,928.03,153.65,Incoming
72292735,2023-02-04,1050.23,122.2,Incoming
72292735,2023-02-09,921.9200000000001,128.31,Outgoing
72292735,2023-02-09,976.4900000000001,54.57,Incoming
72292735,2023-02-10,1065.1100000000001,88.62,Incoming
72292735,2023-02-12,1045.13,19.98,Outgoing
72292735,2023-02-14,991.1300000000001,54.0,Outgoing
72309641,2023-01-31,386.61,,-
72309641,2023-02-05,207.27,179.34,Outgoing
72309641,2023-02-06,303.67,96.4,Incoming
72309641,2023-02-07,304.5,0.83,Incoming
72309641,2023-02-11,306.7,2.2,Incoming
72309641,2023-02-13,444.94,138.24,Incoming
72309641,2023-02-14,1768.64,1323.7,Incoming
72323206,2023-01-31,372.97,,-
72323206,2023-02-06,301.57000000000005,71.4,Outgoing
72323206,2023-02-09,437.25000000000006,135.68,Incoming
72323206,2023-02-11,563.34,126.09,Incoming
72323206,2023-02-13,430.41,132.93,Outgoing
72354216,2023-01-31,852.23,,-
72354216,2023-02-02,734.0,118.23,Outgoing
72354216,2023-02-05,815.6,81.6,Incoming
72354216,2023-02-07,961.46,145.86,Incoming
72354216,2023-02-10,1024.4,62.94,Incoming
72354216,2023-02-11,1189.88,165.48,Incoming
72354216,2023-02-12,447.8800000000001,742.0,Outgoing
72354216,2023-02-13,594.9300000000001,147.05,Incoming
72354216,2023-02-13,-532.3699999999999,1127.3,Outgoing
72354216,2023-02-14,1477.63,2010.0,Incoming
72446758,2023-01-31,893.64,,-
72446758,2023-02-08,1089.8899999999999,196.25,Incoming
72446758,2023-02-08,1243.81,153.92,Incoming
72446758,2023-02-08,1176.21,67.6,Outgoing
72446758,2023-02-12,1235.03,58.82,Incoming
72446758,2023-02-14,1376.52,141.49,Incoming
72450129,2023-01-31,905.61,,-
72450129,2023-02-01,1113.84,208.23,Incoming
72450129,2023-02-02,1023.4599999999999,90.38,Outgoing
72450129,2023-02-03,892.76,130.7,Outgoing
72450129,2023-02-03,794.23,98.53,Outgoing
72450129,2023-02-10,637.95,156.28,Outgoing
72450129,2023-02-14,525.72,112.23,Outgoing
72466733,2023-01-31,580.24,,-
72466733,2023-02-03,105.54000000000002,474.7,Outgoing
72466733,2023-02-08,166.83,61.29,Incoming
72466733,2023-02-09,28.350000000000023,138.48,Outgoing
72466733,2023-02-10,107.18000000000002,78.83,Incoming
72526383,2023-01-31,885.37,,-
72526383,2023-02-07,31.769999999999982,853.6,Outgoing
72526383,2023-02-08,45.31999999999998,13.55,Incoming
72526383,2023-02-08,211.91999999999996,166.6,Incoming
72526383,2023-02-08,118.17999999999996,93.74,Outgoing
72526383,2023-02-12,-777.0200000000001,895.2,Outgoing
72526383,2023-02-13,-683.2,93.82,Incoming
72558185,2023-01-31,793.9,,-
72558185,2023-02-08,716.1,77.8,Outgoing
72600465,2023-01-31,595.44,,-
72600465,2023-02-03,486.84000000000003,108.6,Outgoing
72600465,2023-02-09,684.47,197.63,Incoming
72623919,2023-01-31,610.63,,-
72623919,2023-02-03,491.07,119.56,Outgoing
72623919,2023-02-07,-153.72999999999996,644.8,Outgoing
72623919,2023-02-07,-88.12999999999997,65.6,Incoming
72623919,2023-02-08,-15.979999999999961,72.15,Incoming
72623919,2023-02-12,787.9200000000001,803.9,Incoming
72623919,2023-02-13,689.47,98.45,Outgoing
72627756,2023-01-31,473.02,,-
72627756,2023-02-02,409.59999999999997,63.42,Outgoing
72627756,2023-02-04,364.97999999999996,44.62,Outgoing
72627756,2023-02-05,463.04999999999995,98.07,Incoming
72627756,2023-02-05,368.56999999999994,94.48,Outgoing
72627756,2023-02-12,319.03999999999996,49.53,Outgoing
72627756,2023-02-12,373.96,54.92,Incoming
72716288,2023-01-31,167.69,,-
72716288,2023-02-05,286.24,118.55,Incoming
72716288,2023-02-07,-996.1600000000001,1282.4,Outgoing
72716288,2023-02-09,-959.6800000000001,36.48,Incoming
72771982,2023-01-31,501.76,,-
72771982,2023-02-02,596.85,95.09,Incoming
72771982,2023-02-05,671.83,74.98,Incoming
72771982,2023-02-06,766.1500000000001,94.32,Incoming
72771982,2023-02-12,684.5200000000001,81.63,Outgoing
72771982,2023-02-13,770.7200000000001,86.2,Incoming
72784766,2023-01-31,181.69,,-
72784766,2023-02-01,323.83,142.14,Incoming
72784766,2023-02-01,162.51999999999998,161.31,Outgoing
72784766,2023-02-09,-1126.08,1288.6,Outgoing
72784766,2023-02-11,-1257.69,131.61,Outgoing
72784766,2023-02-11,-1739.79,482.1,Outgoing
72784766,2023-02-14,-1910.08,170.29,Outgoing
72799297,2023-01-31,614.69,,-
72799297,2023-02-04,660.1400000000001,45.45,Incoming
72809561,2023-01-31,270.68,,-
72809561,2023-02-02,333.19,62.51,Incoming
72809561,2023-02-02,176.67,156.52,Outgoing
72809561,2023-02-03,65.32,111.35,Outgoing
72809561,2023-02-09,134.32,69.0,Incoming
72809561,2023-02-10,286.07,151.75,Incoming
72809943,2023-01-31,870.72,,-
72809943,2023-02-02,799.36,71.36,Outgoing
72809943,2023-02-02,891.33,91.97,Incoming
72809943,2023-02-03,1002.57,111.24,Incoming
72809943,2023-02-06,1098.76,96.19,Incoming
72809943,2023-02-06,1156.23,57.47,Incoming
72809943,2023-02-07,1269.24,113.01,Incoming
72809943,2023-02-07,1394.97,125.73,Incoming
72809943,2023-02-08,1488.16,93.19,Incoming
72809943,2023-02-09,1606.7800000000002,118.62,Incoming
72809943,2023-02-12,1507.4800000000002,99.3,Outgoing
72809943,2023-02-14,210.2800000000002,1297.2,Outgoing
72809943,2023-02-14,94.1900000000002,116.09,Outgoing
72812647,2023-01-31,351.84,,-
72812647,2023-02-01,486.27,134.43,Incoming
72812647,2023-02-02,559.42,73.15,Incoming
72812647,2023-02-06,539.03,20.39,Outgoing
72812647,2023-02-07,464.26,74.77,Outgoing
72812647,2023-02-08,254.35999999999999,209.9,Outgoing
72812647,2023-02-11,413.44,159.08,Incoming
72856610,2023-01-31,576.08,,-
72856610,2023-02-01,472.09000000000003,103.99,Outgoing
72856610,2023-02-02,364.62,107.47,Outgoing
72856610,2023-02-05,355.9,8.72,Outgoing
72856610,2023-02-05,432.01,76.11,Incoming
72856610,2023-02-06,291.98,140.03,Outgoing
72856610,2023-02-08,177.29000000000002,114.69,Outgoing
72856610,2023-02-13,251.3,74.01,Incoming
72894034,2023-01-31,74.8,,-
72894034,2023-02-01,-89.51,164.31,Outgoing
72894034,2023-02-04,-168.75,79.24,Outgoing
72894034,2023-02-12,-111.59,57.16,Incoming
72925782,2023-01-31,351.64,,-
72925782,2023-02-02,230.06,121.58,Outgoing
72925782,2023-02-04,-531.8399999999999,761.9,Outgoing
72925782,2023-02-05,-519.6099999999999,12.23,Incoming
72925782,2023-02-09,-420.4999999999999,99.11,Incoming
72925782,2023-02-11,-270.65999999999985,149.84,Incoming
72934756,2023-01-31,829.55,,-
72934756,2023-02-01,816.7199999999999,12.83,Outgoing
72934756,2023-02-01,944.29,127.57,Incoming
72934756,2023-02-01,87.78999999999996,856.5,Outgoing
72934756,2023-02-02,182.47999999999996,94.69,Incoming
72934756,2023-02-03,154.00999999999996,28.47,Outgoing
72934756,2023-02-04,1234.21,1080.2,Incoming
72934756,2023-02-07,1167.43,66.78,Outgoing
72934756,2023-02-14,1231.28,63.85,Incoming
72971287,2023-01-31,890.23,,-
72971287,2023-02-01,955.49,65.26,Incoming
72971287,2023-02-01,887.97,67.52,Outgoing
72971287,2023-02-02,765.74,122.23,Outgoing
72971287,2023-02-10,1804.54,1038.8,Incoming
72971287,2023-02-11,1891.62,87.08,Incoming
72971287,2023-02-13,1782.29,109.33,Outgoing
72986897,2023-01-31,603.23,,-
72986897,2023-02-04,645.97,42.74,Incoming
72986897,2023-02-07,828.6600000000001,182.69,Incoming
72986897,2023-02-08,756.6100000000001,72.05,Outgoing
72986897,2023-02-09,687.2000000000002,69.41,Outgoing
72986897,2023-02-12,-995.1999999999999,1682.4,Outgoing
72986897,2023-02-14,-1081.3,86.1,Outgoing
72995062,2023-01-31,506.73,,-
72995062,2023-02-01,185.53000000000003,321.2,Outgoing
72995062,2023-02-03,290.76000000000005,105.23,Incoming
72995062,2023-02-03,168.99000000000007,121.77,Outgoing
72995062,2023-02-05,344.87000000000006,175.88,Incoming
72995062,2023-02-08,171.06000000000006,173.81,Outgoing
72995062,2023-02-09,244.88000000000005,73.82,Incoming
72995062,2023-02-14,-77.01999999999992,321.9,Outgoing
72996601,2023-01-31,730.27,,-
72996601,2023-02-03,931.41,201.14,Incoming
72996601,2023-02-03,981.8299999999999,50.42,Incoming
72996601,2023-02-04,1066.36,84.53,Incoming
72996601,2023-02-07,988.1599999999999,78.2,Outgoing
72996601,2023-02-08,830.6399999999999,157.52,Outgoing
72996601,2023-02-10,736.7699999999999,93.87,Outgoing
72996601,2023-02-10,1726.5699999999997,989.8,Incoming
72996601,2023-02-11,1840.0899999999997,113.52,Incoming
72996601,2023-02-13,1946.1699999999996,106.08,Incoming
73009461,2023-01-31,938.52,,-
73009461,2023-02-04,1027.71,89.19,Incoming
73009461,2023-02-09,902.0400000000001,125.67,Outgoing
73009461,2023-02-10,804.1600000000001,97.88,Outgoing
73009461,2023-02-13,830.1600000000001,26.0,Incoming
73009461,2023-02-14,741.4900000000001,88.67,Outgoing
73015538,2023-01-31,634.94,,-
73015538,2023-02-01,385.19000000000005,249.75,Outgoing
73015538,2023-02-02,911.99,526.8,Incoming
73015538,2023-02-03,949.14,37.15,Incoming
73015538,2023-02-07,2139.94,1190.8,Incoming
73015538,2023-02-08,1236.64,903.3,Outgoing
73015538,2023-02-09,1129.17,107.47,Outgoing
73015538,2023-02-10,1043.47,85.7,Outgoing
73015538,2023-02-11,486.47,557.0,Outgoing
73039019,2023-01-31,360.0,,-
73039019,2023-02-05,184.12,175.88,Outgoing
73039019,2023-02-09,360.68,176.56,Incoming
73039019,2023-02-11,395.75,35.07,Incoming
73059951,2023-01-31,955.01,,-
73059951,2023-02-02,826.88,128.13,Outgoing
73059951,2023-02-03,773.1,53.78,Outgoing
73059951,2023-02-04,574.73,198.37,Outgoing
73059951,2023-02-07,508.77000000000004,65.96,Outgoing
73059951,2023-02-12,302.49,206.28,Outgoing
73080553,2023-01-31,880.06,,-
73080553,2023-02-04,959.3,79.24,Incoming
73080553,2023-02-10,899.8599999999999,59.44,Outgoing
73080553,2023-02-11,1020.05,120.19,Incoming
73080553,2023-02-11,940.6199999999999,79.43,Outgoing
73124762,2023-01-31,110.47,,-
73124762,2023-02-01,159.95,49.48,Incoming
73124762,2023-02-01,210.27999999999997,50.33,Incoming
73124762,2023-02-06,234.65999999999997,24.38,Incoming
73124762,2023-02-07,146.71999999999997,87.94,Outgoing
73124762,2023-02-09,-30.480000000000018,177.2,Outgoing
73124762,2023-02-09,-227.12,196.64,Outgoing
73124762,2023-02-11,-175.18,51.94,Incoming
73124762,2023-02-12,-253.83,78.65,Outgoing
73208971,2023-01-31,107.97,,-
73208971,2023-02-02,293.23,185.26,Incoming
73208971,2023-02-07,-190.87,484.1,Outgoing
73208971,2023-02-12,-285.94,95.07,Outgoing
73234341,2023-01-31,811.71,,-
73234341,2023-02-04,710.4100000000001,101.3,Outgoing
73234341,2023-02-11,2755.01,2044.6,Incoming
73234341,2023-02-11,2647.0600000000004,107.95,Outgoing
73269307,2023-01-31,485.86,,-
73269307,2023-02-04,387.59000000000003,98.27,Outgoing
73269307,2023-02-04,344.86,42.73,Outgoing
73275714,2023-01-31,924.88,,-
73275714,2023-02-04,1098.63,173.75,Incoming
73275714,2023-02-06,1221.72,123.09,Incoming
73275714,2023-02-11,1086.3400000000001,135.38,Outgoing
73282074,2023-01-31,220.48,,-
73282074,2023-02-01,281.71,61.23,Incoming
73282074,2023-02-04,379.61,97.9,Incoming
73282074,2023-02-07,484.99,105.38,Incoming
73282074,2023-02-07,632.35,147.36,Incoming
73282074,2023-02-09,871.45,239.1,Incoming
73282074,2023-02-11,925.74,54.29,Incoming
73282074,2023-02-13,996.9200000000001,71.18,Incoming
73321391,2023-01-31,100.12,,-
73321391,2023-02-03,274.37,174.25,Incoming
73321391,2023-02-04,292.62,18.25,Incoming
73321391,2023-02-11,373.47,80.85,Incoming
73321391,2023-02-12,435.42,61.95,Incoming
73321391,2023-02-13,516.16,80.74,Incoming
73321391,2023-02-14,437.33,78.83,Outgoing
73328955,2023-01-31,404.7,,-
73328955,2023-02-06,435.15,30.45,Incoming
73328955,2023-02-07,2254.15,1819.0,Incoming
73328955,2023-02-09,2104.71,149.44,Outgoing
73328955,2023-02-10,2155.21,50.5,Incoming
73328955,2023-02-13,2078.11,77.1,Outgoing
73410227,2023-01-31,820.36,,-
73410227,2023-02-01,1040.07,219.71,Incoming
73410227,2023-02-06,987.2299999999999,52.84,Outgoing
73410227,2023-02-09,949.0899999999999,38.14,Outgoing
73410227,2023-02-12,1056.1799999999998,107.09,Incoming
73439131,2023-01-31,863.01,,-
73439131,2023-02-02,951.11,88.1,Incoming
73439131,2023-02-02,1006.04,54.93,Incoming
73439131,2023-02-02,1077.3999999999999,71.36,Incoming
73439131,2023-02-03,1226.9799999999998,149.58,Incoming
73439131,2023-02-04,1119.6,107.38,Outgoing
73439131,2023-02-04,1243.09,123.49,Incoming
73439131,2023-02-06,2312.09,1069.0,Incoming
73439131,2023-02-07,2242.4900000000002,69.6,Outgoing
73439131,2023-02-09,2341.4700000000003,98.98,Incoming
73439131,2023-02-14,2395.26,53.79,Incoming
73439131,2023-02-14,2290.01,105.25,Outgoing
73510067,2023-01-31,895.82,,-
73510067,2023-02-04,760.1,135.72,Outgoing
73510067,2023-02-07,895.87,135.77,Incoming
73510067,2023-02-14,873.28,22.59,Outgoing
73512834,2023-01-31,424.59,,-
73512834,2023-02-01,321.01,103.58,Outgoing
73512834,2023-02-02,210.57999999999998,110.43,Outgoing
73512834,2023-02-04,789.28,578.7,Incoming
73512834,2023-02-05,796.01,6.73,Incoming
73512834,2023-02-06,682.47,113.54,Outgoing
73512834,2023-02-09,859.3100000000001,176.84,Incoming
73512834,2023-02-09,804.96,54.35,Outgoing
73512834,2023-02-10,681.61,123.35,Outgoing
73512834,2023-02-11,791.72,110.11,Incoming
73512834,2023-02-11,823.13,31.41,Incoming
73512834,2023-02-12,702.13,121.0,Outgoing
73512834,2023-02-14,538.85,163.28,Outgoing
73534143,2023-01-31,804.34,,-
73534143,2023-02-12,889.61,85.27,Incoming
73538236,2023-01-31,231.93,,-
73538236,2023-02-01,171.35000000000002,60.58,Outgoing
73538236,2023-02-13,270.36,99.01,Incoming
73604500,2023-01-31,689.4,,-
73604500,2023-02-02,875.47,186.07,Incoming
73604500,2023-02-06,682.2,193.27,Outgoing
73604500,2023-02-12,541.5500000000001,140.65,Outgoing
73642628,2023-01-31,300.06,,-
73642628,2023-02-06,-741.94,1042.0,Outgoing
73642628,2023-02-06,-613.9200000000001,128.02,Incoming
73642628,2023-02-07,-723.24,109.32,Outgoing
73642628,2023-02-08,-851.77,128.53,Outgoing
73642628,2023-02-09,-956.8199999999999,105.05,Outgoing
73642628,2023-02-14,-1065.9499999999998,109.13,Outgoing
73652359,2023-01-31,80.58,,-
73652359,2023-02-08,11.849999999999994,68.73,Outgoing
73652359,2023-02-12,-123.20000000000002,135.05,Outgoing
73652359,2023-02-14,-136.00000000000003,12.8,Outgoing
73668192,2023-01-31,371.47,,-
73668192,2023-02-02,-1124.33,1495.8,Outgoing
73668192,2023-02-04,-970.3699999999999,153.96,Incoming
73668192,2023-02-05,-1119.77,149.4,Outgoing
73668192,2023-02-05,-1157.53,37.76,Outgoing
73668192,2023-02-07,-1064.5,93.03,Incoming
73668192,2023-02-10,-1052.6,11.9,Incoming
73668192,2023-02-10,-1163.7199999999998,111.12,Outgoing
73668192,2023-02-13,-1100.7899999999997,62.93,Incoming
73700087,2023-01-31,274.17,,-
73700087,2023-02-04,318.54,44.37,Incoming
73700087,2023-02-04,201.88000000000002,116.66,Outgoing
73700087,2023-02-06,308.41,106.53,Incoming
73700087,2023-02-08,237.91000000000003,70.5,Outgoing
73700087,2023-02-10,167.8,70.11,Outgoing
73700087,2023-02-12,252.52,84.72,Incoming
73744504,2023-01-31,270.6,,-
73744504,2023-02-05,325.09000000000003,54.49,Incoming
73744504,2023-02-07,377.61,52.52,Incoming
73744504,2023-02-08,325.86,51.75,Outgoing
73744504,2023-02-09,396.57,70.71,Incoming
73744504,2023-02-10,523.91,127.34,Incoming
73744504,2023-02-10,593.55,69.64,Incoming
73744504,2023-02-11,663.1899999999999,69.64,Incoming
73744504,2023-02-11,574.01,89.18,Outgoing
73744504,2023-02-12,702.62,128.61,Incoming
73744504,2023-02-13,536.95,165.67,Outgoing
73744504,2023-02-13,674.5300000000001,137.58,Incoming
73762750,2023-01-31,221.12,,-
73762750,2023-02-01,287.31,66.19,Incoming
73762750,2023-02-03,-1217.79,1505.1,Outgoing
73762750,2023-02-05,-1088.08,129.71,Incoming
73762750,2023-02-06,-1195.05,106.97,Outgoing
73762750,2023-02-08,-1351.58,156.53,Outgoing
73782061,2023-01-31,891.9,,-
73782061,2023-02-02,950.13,58.23,Incoming
73782061,2023-02-13,1114.13,164.0,Incoming
73782061,2023-02-13,1183.38,69.25,Incoming
73878828,2023-01-31,845.19,,-
73878828,2023-02-01,903.21,58.02,Incoming
73878828,2023-02-04,1876.51,973.3,Incoming
73878828,2023-02-06,1833.69,42.82,Outgoing
73878828,2023-02-09,1715.79,117.9,Outgoing
73878828,2023-02-10,1723.08,7.29,Incoming
73878828,2023-02-10,1648.48,74.6,Outgoing
73878828,2023-02-13,1561.83,86.65,Outgoing
73878828,2023-02-13,1624.24,62.41,Incoming
73983591,2023-01-31,292.39,,-
73983591,2023-02-01,175.07999999999998,117.31,Outgoing
73983591,2023-02-05,102.51999999999998,72.56,Outgoing
73983591,2023-02-06,226.73999999999998,124.22,Incoming
73983591,2023-02-07,219.17,7.57,Outgoing
73983591,2023-02-08,1887.67,1668.5,Incoming
73983591,2023-02-10,1970.97,83.3,Incoming
73983591,2023-02-11,2123.43,152.46,Incoming
73983591,2023-02-13,2207.2999999999997,83.87,Incoming
73983601,2023-01-31,617.23,,-
73983601,2023-02-04,803.82,186.59,Incoming
73983601,2023-02-06,915.7900000000001,111.97,Incoming
73983601,2023-02-08,852.9100000000001,62.88,Outgoing
73983601,2023-02-10,989.6400000000001,136.73,Incoming
73983601,2023-02-11,908.2200000000001,81.42,Outgoing
73983601,2023-02-12,945.4400000000002,37.22,Incoming
73983601,2023-02-13,1085.9600000000003,140.52,Incoming
73983601,2023-02-14,1003.5600000000003,82.4,Outgoing
74012560,2023-01-31,414.56,,-
74012560,2023-02-08,465.6,51.04,Incoming
74012560,2023-02-10,536.54,70.94,Incoming
74012560,2023-02-10,-1939.56,2476.1,Outgoing
74012560,2023-02-10,-2015.07,75.51,Outgoing
74012560,2023-02-10,-1943.9299999999998,71.14,Incoming
74012560,2023-02-10,-1793.6299999999999,150.3,Incoming
74012560,2023-02-14,-1696.6499999999999,96.98,Incoming
74154906,2023-01-31,743.84,,-
74154906,2023-02-09,711.1600000000001,32.68,Outgoing
74163559,2023-01-31,45.76,,-
74163559,2023-02-02,151.35,105.59,Incoming
74163559,2023-02-02,50.459999999999994,100.89,Outgoing
74163559,2023-02-07,-34.2,84.66,Outgoing
74163559,2023-02-09,57.64999999999999,91.85,Incoming
74163559,2023-02-10,166.21999999999997,108.57,Incoming
74163559,2023-02-11,246.96999999999997,80.75,Incoming
74218001,2023-01-31,133.02,,-
74218001,2023-02-05,64.49000000000001,68.53,Outgoing
74218001,2023-02-09,-833.71,898.2,Outgoing
74218001,2023-02-09,-826.3100000000001,7.4,Incoming
74252410,2023-01-31,278.47,,-
74252410,2023-02-01,240.53000000000003,37.94,Outgoing
74252410,2023-02-01,345.78000000000003,105.25,Incoming
74252410,2023-02-01,463.09000000000003,117.31,Incoming
74252410,2023-02-03,336.88000000000005,126.21,Outgoing
74252410,2023-02-03,482.30000000000007,145.42,Incoming
74252410,2023-02-08,514.74,32.44,Incoming
74252410,2023-02-10,-1016.26,1531.0,Outgoing
74252410,2023-02-11,191.44000000000005,1207.7,Incoming
74252410,2023-02-13,92.43000000000005,99.01,Outgoing
74252410,2023-02-14,-532.8699999999999,625.3,Outgoing
74255305,2023-01-31,3.7,,-
74255305,2023-02-02,-158.71,162.41,Outgoing
74255305,2023-02-03,-265.22,106.51,Outgoing
74255305,2023-02-06,-359.18,93.96,Outgoing
74255305,2023-02-07,-444.62,85.44,Outgoing
74255305,2023-02-11,-277.6,167.02,Incoming
74255305,2023-02-11,1395.1,1672.7,Incoming
74281404,2023-01-31,678.89,,-
74281404,2023-02-01,1135.09,456.2,Incoming
74281404,2023-02-04,995.81,139.28,Outgoing
74281404,2023-02-08,905.93,89.88,Outgoing
74281404,2023-02-11,1051.74,145.81,Incoming
74304084,2023-01-31,883.35,,-
74304084,2023-02-01,751.77,131.58,Outgoing
74304084,2023-02-08,180.87,570.9,Outgoing
74304084,2023-02-10,91.26,89.61,Outgoing
74304084,2023-02-14,213.87,122.61,Incoming
74365725,2023-01-31,518.04,,-
74365725,2023-02-03,615.4599999999999,97.42,Incoming
74365725,2023-02-06,590.6199999999999,24.84,Outgoing
74365725,2023-02-10,508.9099999999999,81.71,Outgoing
74365725,2023-02-13,345.19999999999993,163.71,Outgoing
74367877,2023-01-31,818.92,,-
74367877,2023-02-01,773.28,45.64,Outgoing
74367877,2023-02-02,877.31,104.03,Incoming
74367877,2023-02-03,404.80999999999995,472.5,Outgoing
74367877,2023-02-08,474.88999999999993,70.08,Incoming
74367877,2023-02-10,593.53,118.64,Incoming
74367877,2023-02-13,544.56,48.97,Outgoing
74387481,2023-01-31,883.93,,-
74387481,2023-02-02,1001.66,117.73,Incoming
74387481,2023-02-04,895.1999999999999,106.46,Outgoing
74387481,2023-02-07,806.6999999999999,88.5,Outgoing
74387481,2023-02-07,894.6399999999999,87.94,Incoming
74387481,2023-02-07,1539.4399999999998,644.8,Incoming
74387481,2023-02-08,1376.9499999999998,162.49,Outgoing
74387481,2023-02-09,1540.1499999999999,163.2,Incoming
74387481,2023-02-10,1632.0299999999997,91.88,Incoming
74387481,2023-02-13,1693.9799999999998,61.95,Incoming
74441123,2023-01-31,833.24,,-
74441123,2023-02-01,977.21,143.97,Incoming
74441123,2023-02-02,915.76,61.45,Outgoing
74441123,2023-02-08,1040.26,124.5,Incoming
74441123,2023-02-09,1168.76,128.5,Incoming
74441123,2023-02-10,1308.11,139.35,Incoming
74441123,2023-02-13,2462.81,1154.7,Incoming
74539170,2023-01-31,417.58,,-
74539170,2023-02-04,491.59999999999997,74.02,Incoming
74539170,2023-02-04,348.59,143.01,Outgoing
74539170,2023-02-07,491.53999999999996,142.95,Incoming
74539170,2023-02-10,618.03,126.49,Incoming
74539170,2023-02-11,619.74,1.71,Incoming
74539170,2023-02-11,535.52,84.22,Outgoing
74539170,2023-02-12,556.3299999999999,20.81,Incoming
74544582,2023-01-31,407.96,,-
74544582,2023-02-01,466.91999999999996,58.96,Incoming
74544582,2023-02-06,359.11999999999995,107.8,Outgoing
74544582,2023-02-07,269.94999999999993,89.17,Outgoing
74544582,2023-02-08,1280.55,1010.6,Incoming
74544582,2023-02-10,1403.37,122.82,Incoming
74544582,2023-02-11,1432.1699999999998,28.8,Incoming
74544582,2023-02-11,1448.2599999999998,16.09,Incoming
74544582,2023-02-13,1494.3399999999997,46.08,Incoming
74544582,2023-02-13,1690.7999999999997,196.46,Incoming
74604471,2023-01-31,661.57,,-
74604471,2023-02-03,683.0400000000001,21.47,Incoming
74604471,2023-02-11,-413.05999999999983,1096.1,Outgoing
74604471,2023-02-11,-1612.06,1199.0,Outgoing
74662976,2023-01-31,782.3,,-
74662976,2023-02-01,-852.4000000000001,1634.7,Outgoing
74662976,2023-02-06,-1065.8400000000001,213.44,Outgoing
74662976,2023-02-09,-960.7900000000002,105.05,Incoming
74662976,2023-02-11,-848.8300000000002,111.96,Incoming
74662976,2023-02-14,-779.2200000000001,69.61,Incoming
74703933,2023-01-31,321.42,,-
74703933,2023-02-01,81.70000000000002,239.72,Outgoing
74703933,2023-02-02,149.82000000000002,68.12,Incoming
74703933,2023-02-04,306.87,157.05,Incoming
74703933,2023-02-04,248.13,58.74,Outgoing
74703933,2023-02-07,-701.07,949.2,Outgoing
74703933,2023-02-11,-548.9000000000001,152.17,Incoming
74703933,2023-02-13,-630.1700000000001,81.27,Outgoing
74709026,2023-01-31,465.39,,-
74709026,2023-02-04,585.35,119.96,Incoming
74709026,2023-02-05,638.89,53.54,Incoming
74709026,2023-02-09,580.8,58.09,Outgoing
74709026,2023-02-11,733.27,152.47,Incoming
74709026,2023-02-14,570.92,162.35,Outgoing
74768567,2023-01-31,557.15,,-
74768567,2023-02-04,517.3299999999999,39.82,Outgoing
74768567,2023-02-08,576.28,58.95,Incoming
74768567,2023-02-10,679.3399999999999,103.06,Incoming
74768567,2023-02-11,799.17,119.83,Incoming
74770758,2023-01-31,643.52,,-
74770758,2023-02-01,499.65999999999997,143.86,Outgoing
74770758,2023-02-02,-146.14,645.8,Outgoing
74770758,2023-02-02,360.96000000000004,507.1,Incoming
74770758,2023-02-05,384.70000000000005,23.74,Incoming
74770758,2023-02-07,228.97000000000006,155.73,Outgoing
74770758,2023-02-07,201.09000000000006,27.88,Outgoing
74770758,2023-02-07,316.9200000000001,115.83,Incoming
74770758,2023-02-10,197.0900000000001,119.83,Outgoing
74770758,2023-02-11,259.56000000000006,62.47,Incoming
74770758,2023-02-13,78.75000000000006,180.81,Outgoing
74770758,2023-02-13,39.010000000000055,39.74,Outgoing
74770758,2023-02-14,136.36000000000004,97.35,Incoming
74770758,2023-02-14,677.36,541.0,Incoming
74770758,2023-02-14,586.57,90.79,Outgoing
74822001,2023-01-31,673.61,,-
74822001,2023-02-03,560.36,113.25,Outgoing
74822001,2023-02-04,475.45000000000005,84.91,Outgoing
74822001,2023-02-06,318.34000000000003,157.11,Outgoing
74822001,2023-02-08,361.22,42.88,Incoming
75000628,2023-01-31,117.33,,-
75000628,2023-02-03,219.82,102.49,Incoming
75000628,2023-02-06,1187.62,967.8,Incoming
75000628,2023-02-07,1163.7199999999998,23.9,Outgoing
75000628,2023-02-07,1051.7699999999998,111.95,Outgoing
75000628,2023-02-09,931.9099999999997,119.86,Outgoing
75000628,2023-02-11,1033.9399999999998,102.03,Incoming
75000628,2023-02-11,873.3799999999999,160.56,Outgoing
75000628,2023-02-12,848.6399999999999,24.74,Outgoing
75000628,2023-02-14,971.5199999999999,122.88,Incoming
75004471,2023-01-31,435.54,,-
75004471,2023-02-06,525.73,90.19,Incoming
75004471,2023-02-07,596.85,71.12,Incoming
75004471,2023-02-09,435.66,161.19,Outgoing
75004471,2023-02-10,490.39000000000004,54.73,Incoming
75027308,2023-01-31,307.44,,-
75027308,2023-02-05,236.63,70.81,Outgoing
75027308,2023-02-13,258.36,21.73,Incoming
75027308,2023-02-14,300.39,42.03,Incoming
75068844,2023-01-31,852.47,,-
75068844,2023-02-07,820.21,32.26,Outgoing
75068844,2023-02-09,995.13,174.92,Incoming
75068844,2023-02-10,1200.34,205.21,Incoming
75068844,2023-02-13,1143.9199999999998,56.42,Outgoing
75094093,2023-01-31,478.09,,-
75094093,2023-02-08,544.67,66.58,Incoming
75094093,2023-02-10,631.06,86.39,Incoming
75094093,2023-02-14,751.68,120.62,Incoming
75134291,2023-01-31,903.25,,-
75134291,2023-02-07,-2.0499999999999545,905.3,Outgoing
75134291,2023-02-08,135.61000000000004,137.66,Incoming
75134291,2023-02-10,-9.519999999999953,145.13,Outgoing
75134291,2023-02-11,-72.59999999999995,63.08,Outgoing
75134291,2023-02-11,-1750.1,1677.5,Outgoing
75134291,2023-02-12,-488.5,1261.6,Incoming
75134291,2023-02-13,-627.35,138.85,Outgoing
75164598,2023-01-31,569.4,,-
75164598,2023-02-01,484.44,84.96,Outgoing
75164598,2023-02-03,-1044.96,1529.4,Outgoing
75164598,2023-02-13,-1128.83,83.87,Outgoing
75164598,2023-02-14,-998.3899999999999,130.44,Incoming
75172199,2023-01-31,955.0,,-
75172199,2023-02-01,155.0,800.0,Outgoing
75172199,2023-02-05,265.09000000000003,110.09,Incoming
75172199,2023-02-10,373.69000000000005,108.6,Incoming
75172199,2023-02-14,414.81000000000006,41.12,Incoming
75205767,2023-01-31,113.75,,-
75205767,2023-02-01,101.25,12.5,Outgoing
75205767,2023-02-03,160.26,59.01,Incoming
75205767,2023-02-08,187.07999999999998,26.82,Incoming
75205767,2023-02-09,69.69999999999999,117.38,Outgoing
75205767,2023-02-10,-895.0999999999999,964.8,Outgoing
75205767,2023-02-11,-947.8399999999999,52.74,Outgoing
75205767,2023-02-12,-751.8899999999999,195.95,Incoming
75216128,2023-01-31,671.26,,-
75216128,2023-02-05,-177.44000000000005,848.7,Outgoing
75216128,2023-02-05,-125.68000000000006,51.76,Incoming
75216128,2023-02-06,-74.82000000000006,50.86,Incoming
75216128,2023-02-10,38.98999999999994,113.81,Incoming
75216128,2023-02-11,-97.01000000000006,136.0,Outgoing
75216128,2023-02-13,-242.91000000000008,145.9,Outgoing
75216128,2023-02-13,-280.2200000000001,37.31,Outgoing
75216128,2023-02-14,-170.0900000000001,110.13,Incoming
75223089,2023-01-31,557.48,,-
75223089,2023-02-02,654.85,97.37,Incoming
75223089,2023-02-06,514.09,140.76,Outgoing
75223089,2023-02-08,513.62,0.47,Outgoing
75223089,2023-02-10,442.21000000000004,71.41,Outgoing
75258542,2023-01-31,772.67,,-
75258542,2023-02-06,713.51,59.16,Outgoing
75331062,2023-01-31,117.81,,-
75331062,2023-02-01,-6.920000000000002,124.73,Outgoing
75331062,2023-02-02,-199.60000000000002,192.68,Outgoing
75331062,2023-02-02,-352.8,153.2,Outgoing
75331062,2023-02-09,-249.0,103.8,Incoming
75331062,2023-02-10,-325.32,76.32,Outgoing
75331062,2023-02-12,-493.89,168.57,Outgoing
75331062,2023-02-12,-676.52,182.63,Outgoing
75355842,2023-01-31,621.95,,-
75355842,2023-02-02,729.57,107.62,Incoming
75355842,2023-02-08,896.8000000000001,167.23,Incoming
75355842,2023-02-13,962.4200000000001,65.62,Incoming
75355842,2023-02-13,925.9900000000001,36.43,Outgoing
75394177,2023-01-31,191.04,,-
75394177,2023-02-01,-21.22,212.26,Outgoing
75394177,2023-02-01,167.85,189.07,Incoming
75394177,2023-02-05,83.5,84.35,Outgoing
75394177,2023-02-07,179.57999999999998,96.08,Incoming
75394177,2023-02-09,247.33999999999997,67.76,Incoming
75394177,2023-02-13,259.59999999999997,12.26,Incoming
75428657,2023-01-31,455.8,,-
75428657,2023-02-01,359.66,96.14,Outgoing
75428657,2023-02-04,287.42,72.24,Outgoing
75428657,2023-02-06,394.74,107.32,Incoming
75428657,2023-02-06,484.21000000000004,89.47,Incoming
75428657,2023-02-07,650.27,166.06,Incoming
75428657,2023-02-12,783.31,133.04,Incoming
75468090,2023-01-31,984.92,,-
75468090,2023-02-02,1079.3899999999999,94.47,Incoming
75468090,2023-02-03,1190.35,110.96,Incoming
75468090,2023-02-05,1047.05,143.3,Outgoing
75468090,2023-02-06,1075.4099999999999,28.36,Incoming
75468090,2023-02-09,993.2699999999999,82.14,Outgoing
75468090,2023-02-13,-1271.0300000000002,2264.3,Outgoing
75468090,2023-02-14,-1115.0100000000002,156.02,Incoming
75468090,2023-02-14,-1201.7400000000002,86.73,Outgoing
75551521,2023-01-31,538.64,,-
75551521,2023-02-01,709.53,170.89,Incoming
75551521,2023-02-10,885.48,175.95,Incoming
75551521,2023-02-11,926.29,40.81,Incoming
75553043,2023-01-31,669.59,,-
75553043,2023-02-01,794.45,124.86,Incoming
75553043,2023-02-02,860.87,66.42,Incoming
75553043,2023-02-07,907.01,46.14,Incoming
75553043,2023-02-08,861.47,45.54,Outgoing
75553043,2023-02-12,711.25,150.22,Outgoing
75553043,2023-02-12,623.92,87.33,Outgoing
75553043,2023-02-13,750.78,126.86,Incoming
75553043,2023-02-13,578.24,172.54,Outgoing
75553043,2023-02-13,734.28,156.04,Incoming
75569387,2023-01-31,249.27,,-
75569387,2023-02-01,-1526.33,1775.6,Outgoing
75569387,2023-02-03,-1349.1,177.23,Incoming
75569387,2023-02-05,-1425.4099999999999,76.31,Outgoing
75569387,2023-02-08,-1270.2599999999998,155.15,Incoming
75569387,2023-02-08,-1132.2899999999997,137.97,Incoming
75569387,2023-02-09,-1305.4899999999998,173.2,Outgoing
75569387,2023-02-10,-1128.2999999999997,177.19,Incoming
75569387,2023-02-12,-1223.9099999999996,95.61,Outgoing
75573750,2023-01-31,159.92,,-
75573750,2023-02-01,217.29,57.37,Incoming
75573750,2023-02-01,831.39,614.1,Incoming
75573750,2023-02-11,735.71,95.68,Outgoing
75687743,2023-01-31,668.39,,-
75687743,2023-02-02,745.43,77.04,Incoming
75687743,2023-02-02,866.9599999999999,121.53,Incoming
75687743,2023-02-06,797.9799999999999,68.98,Outgoing
75687743,2023-02-08,87.67999999999995,710.3,Outgoing
75687743,2023-02-13,188.88999999999993,101.21,Incoming
75687743,2023-02-13,313.3299999999999,124.44,Incoming
75692380,2023-01-31,477.28,,-
75692380,2023-02-07,463.57,13.71,Outgoing
75692380,2023-02-12,387.09,76.48,Outgoing
75696521,2023-01-31,660.34,,-
75696521,2023-02-02,508.97,151.37,Outgoing
75696521,2023-02-04,622.94,113.97,Incoming
75696521,2023-02-09,498.61000000000007,124.33,Outgoing
75696521,2023-02-12,941.71,443.1,Incoming
75696521,2023-02-13,835.75,105.96,Outgoing
75747094,2023-01-31,289.48,,-
75747094,2023-02-01,397.65000000000003,108.17,Incoming
75747094,2023-02-02,508.99,111.34,Incoming
75747094,2023-02-03,679.69,170.7,Incoming
75747094,2023-02-03,767.83,88.14,Incoming
75747094,2023-02-06,946.9100000000001,179.08,Incoming
75747094,2023-02-07,1016.2500000000001,69.34,Incoming
75747094,2023-02-09,890.5100000000001,125.74,Outgoing
75747094,2023-02-09,915.0000000000001,24.49,Incoming
75747094,2023-02-12,2229.3,1314.3,Incoming
75747094,2023-02-12,2030.9100000000003,198.39,Outgoing
75747094,2023-02-12,1911.8300000000004,119.08,Outgoing
75747094,2023-02-14,1860.4700000000005,51.36,Outgoing
75762044,2023-01-31,980.08,,-
75762044,2023-02-03,1097.55,117.47,Incoming
75762044,2023-02-05,1016.7199999999999,80.83,Outgoing
75762044,2023-02-05,399.01999999999987,617.7,Outgoing
75762044,2023-02-07,478.54999999999984,79.53,Incoming
75762044,2023-02-07,1586.1499999999996,1107.6,Incoming
75762044,2023-02-08,1825.0499999999997,238.9,Incoming
75762044,2023-02-09,1740.5399999999997,84.51,Outgoing
75762044,2023-02-12,1834.5399999999997,94.0,Incoming
75762044,2023-02-12,1898.7699999999998,64.23,Incoming
75762044,2023-02-14,1986.0999999999997,87.33,Incoming
75782714,2023-01-31,105.34,,-
75782714,2023-02-02,-77.37,182.71,Outgoing
75782714,2023-02-04,-171.32999999999998,93.96,Outgoing
75782714,2023-02-07,-268.62,97.29,Outgoing
75782714,2023-02-08,-209.8,58.82,Incoming
75782714,2023-02-11,-263.39,53.59,Outgoing
75839704,2023-01-31,202.34,,-
75839704,2023-02-06,142.74,59.6,Outgoing
75839704,2023-02-11,299.79,157.05,Incoming
75839704,2023-02-12,254.83,44.96,Outgoing
75893682,2023-01-31,573.74,,-
75893682,2023-02-03,468.96000000000004,104.78,Outgoing
75893682,2023-02-04,366.65000000000003,102.31,Outgoing
75893682,2023-02-08,472.53000000000003,105.88,Incoming
75893682,2023-02-09,323.97,148.56,Outgoing
75925793,2023-01-31,425.69,,-
75925793,2023-02-01,317.72,107.97,Outgoing
75925793,2023-02-03,368.12,50.4,Incoming
75925793,2023-02-04,455.77,87.65,Incoming
75925793,2023-02-11,378.15,77.62,Outgoing
75925793,2023-02-11,521.3,143.15,Incoming
75946768,2023-01-31,103.05,,-
75946768,2023-02-02,-55.269999999999996,158.32,Outgoing
75946768,2023-02-03,66.31,121.58,Incoming
75946768,2023-02-04,151.57999999999998,85.27,Incoming
75946768,2023-02-11,-5.820000000000022,157.4,Outgoing
75954317,2023-01-31,583.28,,-
75954317,2023-02-02,490.38,92.9,Outgoing
75954317,2023-02-05,449.17,41.21,Outgoing
75954317,2023-02-11,319.51,129.66,Outgoing
75954317,2023-02-13,-440.89,760.4,Outgoing
75954317,2023-02-13,-563.76,122.87,Outgoing
75954317,2023-02-14,-649.42,85.66,Outgoing
75969874,2023-01-31,454.25,,-
75969874,2023-02-05,129.25,325.0,Outgoing
75969874,2023-02-05,-36.16999999999999,165.42,Outgoing
75969874,2023-02-08,6.750000000000014,42.92,Incoming
75969874,2023-02-09,-41.29999999999998,48.05,Outgoing
76078639,2023-01-31,318.17,,-
76078639,2023-02-01,308.37,9.8,Outgoing
76078639,2023-02-06,153.68,154.69,Outgoing
76078639,2023-02-08,44.620000000000005,109.06,Outgoing
76078639,2023-02-09,70.2,25.58,Incoming
76096120,2023-01-31,996.6,,-
76096120,2023-02-01,1112.45,115.85,Incoming
76096120,2023-02-02,970.1700000000001,142.28,Outgoing
76096120,2023-02-02,868.95,101.22,Outgoing
76096120,2023-02-03,783.6600000000001,85.29,Outgoing
76096120,2023-02-05,925.7800000000001,142.12,Incoming
76096120,2023-02-06,826.3600000000001,99.42,Outgoing
76096120,2023-02-13,916.7600000000001,90.4,Incoming
76099143,2023-01-31,525.4,,-
76099143,2023-02-02,644.0,118.6,Incoming
76099143,2023-02-05,582.91,61.09,Outgoing
76099143,2023-02-13,636.24,53.33,Incoming
76122310,2023-01-31,985.6,,-
76122310,2023-02-10,1601.7,616.1,Incoming
76122310,2023-02-11,1569.5,32.2,Outgoing
76122310,2023-02-13,1420.76,148.74,Outgoing
76146870,2023-01-31,414.24,,-
76146870,2023-02-03,-863.96,1278.2,Outgoing
76146870,2023-02-06,-698.3100000000001,165.65,Incoming
76146870,2023-02-07,-866.48,168.17,Outgoing
76146870,2023-02-07,-1007.75,141.27,Outgoing
76146870,2023-02-08,-921.39,86.36,Incoming
76146870,2023-02-11,-1022.99,101.6,Outgoing
76146870,2023-02-14,-1111.09,88.1,Outgoing
76146870,2023-02-14,-1006.9099999999999,104.18,Incoming
76146870,2023-02-14,46.590000000000146,1053.5,Incoming
76169332,2023-01-31,615.46,,-
76169332,2023-02-02,2310.96,1695.5,Incoming
76169332,2023-02-02,2227.17,83.79,Outgoing
76169332,2023-02-03,2255.17,28.0,Incoming
76169332,2023-02-07,2170.98,84.19,Outgoing
76206810,2023-01-31,887.63,,-
76206810,2023-02-01,1016.41,128.78,Incoming
76206810,2023-02-05,1120.83,104.42,Incoming
76206810,2023-02-12,1016.05,104.78,Outgoing
76206810,2023-02-12,907.24,108.81,Outgoing
76206810,2023-02-14,869.5,37.74,Outgoing
76245103,2023-01-31,814.75,,-
76245103,2023-02-07,643.35,171.4,Outgoing
76245103,2023-02-08,715.54,72.19,Incoming
76245103,2023-02-10,824.18,108.64,Incoming
76245103,2023-02-11,950.5999999999999,126.42,Incoming
76245103,2023-02-11,1144.98,194.38,Incoming
76245103,2023-02-14,1080.4,64.58,Outgoing
76256026,2023-01-31,36.71,,-
76256026,2023-02-01,-77.5,114.21,Outgoing
76256026,2023-02-02,45.040000000000006,122.54,Incoming
76256026,2023-02-03,110.18,65.14,Incoming
76256026,2023-02-05,33.610000000000014,76.57,Outgoing
76256026,2023-02-06,617.3100000000001,583.7,Incoming
76256026,2023-02-06,708.8100000000001,91.5,Incoming
76256026,2023-02-07,771.6600000000001,62.85,Incoming
76256026,2023-02-08,617.19,154.47,Outgoing
76256026,2023-02-09,492.14000000000004,125.05,Outgoing
76256026,2023-02-12,-653.56,1145.7,Outgoing
76256026,2023-02-12,-1904.76,1251.2,Outgoing
76256026,2023-02-12,-1797.73,107.03,Incoming
76257915,2023-01-31,795.66,,-
76257915,2023-02-04,708.5799999999999,87.08,Outgoing
76257915,2023-02-05,600.55,108.03,Outgoing
76257915,2023-02-07,1837.25,1236.7,Incoming
76257915,2023-02-14,1785.47,51.78,Outgoing
76273831,2023-01-31,866.62,,-
76273831,2023-02-02,817.48,49.14,Outgoing
76273831,2023-02-03,931.07,113.59,Incoming
76273831,2023-02-07,821.49,109.58,Outgoing
76273831,2023-02-08,721.72,99.77,Outgoing
76273831,2023-02-12,832.51,110.79,Incoming
76273831,2023-02-13,956.96,124.45,Incoming
76273831,2023-02-14,827.71,129.25,Outgoing
76318330,2023-01-31,710.56,,-
76318330,2023-02-01,1671.36,960.8,Incoming
76318330,2023-02-03,1672.3899999999999,1.03,Incoming
76318330,2023-02-04,1721.9099999999999,49.52,Incoming
76318330,2023-02-04,1887.33,165.42,Incoming
76318330,2023-02-04,1846.1999999999998,41.13,Outgoing
76318330,2023-02-06,1718.1799999999998,128.02,Outgoing
76318330,2023-02-06,1312.4799999999998,405.7,Outgoing
76318330,2023-02-14,1156.2099999999998,156.27,Outgoing
76336076,2023-01-31,288.71,,-
76336076,2023-02-07,179.27999999999997,109.43,Outgoing
76336076,2023-02-13,276.26,96.98,Incoming
76336076,2023-02-14,1652.26,1376.0,Incoming
76342664,2023-01-31,371.62,,-
76342664,2023-02-03,329.28,42.34,Outgoing
76342664,2023-02-04,205.04999999999995,124.23,Outgoing
76342664,2023-02-05,249.55999999999995,44.51,Incoming
76342664,2023-02-12,149.49999999999994,100.06,Outgoing
76343783,2023-01-31,42.36,,-
76343783,2023-02-02,-91.02,133.38,Outgoing
76343783,2023-02-08,-1344.62,1253.6,Outgoing
76343783,2023-02-10,-1458.1799999999998,113.56,Outgoing
76343783,2023-02-13,-2963.88,1505.7,Outgoing
76355557,2023-01-31,285.61,,-
76355557,2023-02-03,175.05,110.56,Outgoing
76355557,2023-02-10,109.51,65.54,Outgoing
76355557,2023-02-10,316.48,206.97,Incoming
76355557,2023-02-11,131.98000000000002,184.5,Outgoing
76355557,2023-02-13,205.17000000000002,73.19,Incoming
76454427,2023-01-31,267.03,,-
76454427,2023-02-09,234.2,32.83,Outgoing
76454427,2023-02-10,170.07999999999998,64.12,Outgoing
76454427,2023-02-12,340.48,170.4,Incoming
76470405,2023-01-31,606.3,,-
76470405,2023-02-01,486.16999999999996,120.13,Outgoing
76470405,2023-02-02,551.37,65.2,Incoming
76470405,2023-02-02,488.85,62.52,Outgoing
76470405,2023-02-05,530.0600000000001,41.21,Incoming
76470405,2023-02-05,354.38000000000005,175.68,Outgoing
76470405,2023-02-05,250.18000000000006,104.2,Outgoing
76470405,2023-02-07,193.90000000000006,56.28,Outgoing
76470405,2023-02-07,292.51000000000005,98.61,Incoming
76470405,2023-02-10,408.57000000000005,116.06,Incoming
76474111,2023-01-31,563.43,,-
76474111,2023-02-01,474.43999999999994,88.99,Outgoing
76474111,2023-02-05,543.6299999999999,69.19,Incoming
76474111,2023-02-07,561.0199999999999,17.39,Incoming
76474111,2023-02-07,387.66999999999985,173.35,Outgoing
76474111,2023-02-09,545.9199999999998,158.25,Incoming
76474111,2023-02-11,619.8599999999999,73.94,Incoming
76474111,2023-02-12,510.2599999999999,109.6,Outgoing
76474111,2023-02-12,424.3599999999999,85.9,Outgoing
76474111,2023-02-14,-202.44000000000005,626.8,Outgoing
76482858,2023-01-31,568.63,,-
76482858,2023-02-04,1653.4299999999998,1084.8,Incoming
76482858,2023-02-05,1528.82,124.61,Outgoing
76482858,2023-02-06,1325.99,202.83,Outgoing
76482858,2023-02-07,89.28999999999996,1236.7,Outgoing
76482858,2023-02-08,871.99,782.7,Incoming
76524911,2023-01-31,190.9,,-
76524911,2023-02-01,232.45,41.55,Incoming
76524911,2023-02-05,298.02,65.57,Incoming
76524911,2023-02-07,121.75999999999999,176.26,Outgoing
76524911,2023-02-13,52.05,69.71,Outgoing
76537084,2023-01-31,884.7,,-
76537084,2023-02-03,807.5600000000001,77.14,Outgoing
76537084,2023-02-03,894.0500000000001,86.49,Incoming
76537084,2023-02-05,1011.85,117.8,Incoming
76537084,2023-02-06,928.09,83.76,Outgoing
76537084,2023-02-11,843.8000000000001,84.29,Outgoing
76537084,2023-02-12,920.1600000000001,76.36,Incoming
76537084,2023-02-13,843.58,76.58,Outgoing
76546657,2023-01-31,434.77,,-
76546657,2023-02-03,534.62,99.85,Incoming
76546657,2023-02-05,656.87,122.25,Incoming
76546657,2023-02-06,745.39,88.52,Incoming
76546657,2023-02-07,830.99,85.6,Incoming
76546657,2023-02-07,845.8,14.81,Incoming
76546657,2023-02-08,1968.8999999999999,1123.1,Incoming
76546657,2023-02-09,605.3,1363.6,Outgoing
76546657,2023-02-10,395.4599999999999,209.84,Outgoing
76629706,2023-01-31,962.66,,-
76629706,2023-02-04,909.9,52.76,Outgoing
76629706,2023-02-04,783.88,126.02,Outgoing
76629706,2023-02-07,678.22,105.66,Outgoing
76629706,2023-02-09,836.88,158.66,Incoming
76629706,2023-02-10,762.47,74.41,Outgoing
76662799,2023-01-31,296.68,,-
76662799,2023-02-01,380.75,84.07,Incoming
76662799,2023-02-04,457.40999999999997,76.66,Incoming
76662799,2023-02-06,534.88,77.47,Incoming
76662799,2023-02-08,602.05,67.17,Incoming
76662799,2023-02-08,541.3499999999999,60.7,Outgoing
76662799,2023-02-09,470.63999999999993,70.71,Outgoing
76662799,2023-02-10,1864.7399999999998,1394.1,Incoming
76662799,2023-02-14,1769.5399999999997,95.2,Outgoing
76698056,2023-01-31,827.36,,-
76698056,2023-02-02,716.02,111.34,Outgoing
76698056,2023-02-02,509.11,206.91,Outgoing
76698056,2023-02-02,410.74,98.37,Outgoing
76698056,2023-02-03,401.71000000000004,9.03,Outgoing
76698056,2023-02-07,316.74,84.97,Outgoing
76698056,2023-02-07,441.05,124.31,Incoming
76698056,2023-02-08,220.05,221.0,Outgoing
76720959,2023-01-31,436.06,,-
76720959,2023-02-04,335.43,100.63,Outgoing
76720959,2023-02-05,242.4,93.03,Outgoing
76720959,2023-02-07,148.52,93.88,Outgoing
76720959,2023-02-10,315.06,166.54,Incoming
76720959,2023-02-13,181.71,133.35,Outgoing
76787359,2023-01-31,386.73,,-
76787359,2023-02-03,270.18,116.55,Outgoing
76787359,2023-02-03,380.77,110.59,Incoming
76787359,2023-02-04,-1017.9300000000001,1398.7,Outgoing
76787359,2023-02-06,-956.0100000000001,61.92,Incoming
76787359,2023-02-07,-804.6100000000001,151.4,Incoming
76787359,2023-02-07,3.4899999999998954,808.1,Incoming
76787359,2023-02-08,-151.4400000000001,154.93,Outgoing
76799768,2023-01-31,981.08,,-
76799768,2023-02-01,1058.89,77.81,Incoming
76799768,2023-02-03,1159.7,100.81,Incoming
76799768,2023-02-03,1109.3,50.4,Outgoing
76799768,2023-02-03,1753.6,644.3,Incoming
76799768,2023-02-04,1704.07,49.53,Outgoing
76799768,2023-02-04,1630.1399999999999,73.93,Outgoing
76799768,2023-02-04,1576.34,53.8,Outgoing
76799768,2023-02-06,1647.86,71.52,Incoming
76799768,2023-02-09,1566.2099999999998,81.65,Outgoing
76799768,2023-02-14,1510.4199999999998,55.79,Outgoing
76847816,2023-01-31,197.8,,-
76847816,2023-02-01,327.19,129.39,Incoming
76847816,2023-02-01,343.25,16.06,Incoming
76847816,2023-02-02,1042.75,699.5,Incoming
76847816,2023-02-03,-216.8499999999999,1259.6,Outgoing
76847816,2023-02-07,1065.5500000000002,1282.4,Incoming
76847816,2023-02-09,905.4500000000002,160.1,Outgoing
76847816,2023-02-10,789.4700000000001,115.98,Outgoing
76847816,2023-02-12,-478.62999999999977,1268.1,Outgoing
76847816,2023-02-12,-385.69999999999976,92.93,Incoming
76847816,2023-02-13,-317.81999999999977,67.88,Incoming
76857747,2023-01-31,952.88,,-
76857747,2023-02-04,1074.94,122.06,Incoming
76857747,2023-02-04,1138.4,63.46,Incoming
76857747,2023-02-05,1209.21,70.81,Incoming
76857747,2023-02-06,1096.88,112.33,Outgoing
76857747,2023-02-07,999.0600000000002,97.82,Outgoing
76857747,2023-02-08,881.8400000000001,117.22,Outgoing
76857747,2023-02-09,774.6200000000001,107.22,Outgoing
76857747,2023-02-10,569.4100000000001,205.21,Outgoing
76857747,2023-02-11,493.93000000000006,75.48,Outgoing
76857747,2023-02-12,371.32000000000005,122.61,Outgoing
76869201,2023-01-31,515.62,,-
76869201,2023-02-01,613.88,98.26,Incoming
76869201,2023-02-04,763.21,149.33,Incoming
76869201,2023-02-05,847.5600000000001,84.35,Incoming
76869201,2023-02-09,-637.4399999999999,1485.0,Outgoing
76869201,2023-02-12,-509.15999999999997,128.28,Incoming
76869201,2023-02-14,-488.74999999999994,20.41,Incoming
76869375,2023-01-31,894.84,,-
76869375,2023-02-01,853.6600000000001,41.18,Outgoing
76869375,2023-02-01,761.3100000000001,92.35,Outgoing
76869375,2023-02-02,864.34,103.03,Incoming
76869375,2023-02-03,723.1800000000001,141.16,Outgoing
76869375,2023-02-04,626.8700000000001,96.31,Outgoing
76869375,2023-02-05,681.6600000000001,54.79,Incoming
76869375,2023-02-06,764.4100000000001,82.75,Incoming
76869375,2023-02-13,616.2400000000001,148.17,Outgoing
76953050,2023-01-31,453.1,,-
76953050,2023-02-04,543.07,89.97,Incoming
76953050,2023-02-05,413.6,129.47,Outgoing
76953050,2023-02-09,374.21000000000004,39.39,Outgoing
76953050,2023-02-10,272.15000000000003,102.06,Outgoing
76953050,2023-02-14,151.61,120.54,Outgoing
77010964,2023-01-31,899.11,,-
77010964,2023-02-05,807.3,91.81,Outgoing
77010964,2023-02-07,750.05,57.25,Outgoing
77010964,2023-02-10,866.7199999999999,116.67,Incoming
77010964,2023-02-11,781.7199999999999,85.0,Outgoing
77010964,2023-02-11,851.9599999999999,70.24,Incoming
77017650,2023-01-31,699.24,,-
77017650,2023-02-01,802.28,103.04,Incoming
77017650,2023-02-03,681.13,121.15,Outgoing
77017650,2023-02-04,773.18,92.05,Incoming
77017650,2023-02-07,651.28,121.9,Outgoing
77017650,2023-02-07,612.87,38.41,Outgoing
77017650,2023-02-08,717.05,104.18,Incoming
77017650,2023-02-08,620.65,96.4,Outgoing
77017650,2023-02-12,678.15,57.5,Incoming
77017650,2023-02-12,773.9499999999999,95.8,Incoming
77017650,2023-02-13,675.51,98.44,Outgoing
77017650,2023-02-13,731.93,56.42,Incoming
77017650,2023-02-14,848.67,116.74,Incoming
77017650,2023-02-14,898.2199999999999,49.55,Incoming
77017650,2023-02-14,784.7599999999999,113.46,Outgoing
77026279,2023-01-31,126.05,,-
77026279,2023-02-05,165.25,39.2,Incoming
77026279,2023-02-06,63.849999999999994,101.4,Outgoing
77026279,2023-02-08,27.069999999999993,36.78,Outgoing
77026279,2023-02-09,132.11,105.04,Incoming
77026279,2023-02-12,-1508.69,1640.8,Outgoing
77026279,2023-02-13,-1610.27,101.58,Outgoing
77026279,2023-02-13,-1473.29,136.98,Incoming
77207452,2023-01-31,696.83,,-
77207452,2023-02-04,631.7,65.13,Outgoing
77207452,2023-02-04,527.25,104.45,Outgoing
77207452,2023-02-04,491.57,35.68,Outgoing
77207452,2023-02-09,569.3199999999999,77.75,Incoming
77207452,2023-02-10,2544.92,1975.6,Incoming
77207452,2023-02-10,2649.31,104.39,Incoming
77207452,2023-02-11,3131.41,482.1,Incoming
77207452,2023-02-11,3662.81,531.4,Incoming
77207452,2023-02-11,3512.55,150.26,Outgoing
77241606,2023-01-31,761.38,,-
77241606,2023-02-02,867.43,106.05,Incoming
77241606,2023-02-07,692.66,174.77,Outgoing
77241606,2023-02-07,789.92,97.26,Incoming
77241606,2023-02-08,874.03,84.11,Incoming
77241606,2023-02-09,879.62,5.59,Incoming
77241606,2023-02-12,738.61,141.01,Outgoing
77241606,2023-02-12,660.71,77.9,Outgoing
77243259,2023-01-31,614.86,,-
77243259,2023-02-01,527.89,86.97,Outgoing
77243259,2023-02-01,634.78,106.89,Incoming
77243259,2023-02-02,548.16,86.62,Outgoing
77243259,2023-02-08,712.8599999999999,164.7,Incoming
77243259,2023-02-08,615.79,97.07,Outgoing
77243259,2023-02-10,525.5899999999999,90.2,Outgoing
77243259,2023-02-12,401.63999999999993,123.95,Outgoing
77289104,2023-01-31,737.08,,-
77289104,2023-02-03,591.94,145.14,Outgoing
77289104,2023-02-06,457.86,134.08,Outgoing
77289104,2023-02-07,390.82,67.04,Outgoing
77289104,2023-02-10,538.86,148.04,Incoming
77289104,2023-02-13,445.65000000000003,93.21,Outgoing
77342574,2023-01-31,907.34,,-
77342574,2023-02-01,1022.75,115.41,Incoming
77342574,2023-02-02,998.7,24.05,Outgoing
77342574,2023-02-02,2773.4,1774.7,Incoming
77342574,2023-02-02,4439.4,1666.0,Incoming
77342574,2023-02-02,4572.04,132.64,Incoming
77342574,2023-02-04,4699.84,127.8,Incoming
77342574,2023-02-10,4887.53,187.69,Incoming
77342574,2023-02-13,4676.4,211.13,Outgoing
77342574,2023-02-14,4807.0599999999995,130.66,Incoming
77342574,2023-02-14,4847.789999999999,40.73,Incoming
77342574,2023-02-14,4733.069999999999,114.72,Outgoing
77377150,2023-01-31,673.03,,-
77377150,2023-02-01,681.1,8.07,Incoming
77377150,2023-02-06,825.13,144.03,Incoming
77377150,2023-02-08,937.5699999999999,112.44,Incoming
77377150,2023-02-11,1077.1299999999999,139.56,Incoming
77377150,2023-02-12,1868.9299999999998,791.8,Incoming
77379844,2023-01-31,32.65,,-
77379844,2023-02-02,-22.43,55.08,Outgoing
77379844,2023-02-03,116.72999999999999,139.16,Incoming
77379844,2023-02-04,254.42999999999998,137.7,Incoming
77379844,2023-02-06,117.82999999999998,136.6,Outgoing
77379844,2023-02-13,155.65999999999997,37.83,Incoming
77387016,2023-01-31,894.34,,-
77387016,2023-02-05,389.34000000000003,505.0,Outgoing
77387016,2023-02-14,-317.9599999999999,707.3,Outgoing
77418940,2023-01-31,263.71,,-
77418940,2023-02-03,104.28999999999999,159.42,Outgoing
77418940,2023-02-04,-23.470000000000013,127.76,Outgoing
77418940,2023-02-05,60.359999999999985,83.83,Incoming
77418940,2023-02-05,98.11999999999998,37.76,Incoming
77418940,2023-02-10,6.029999999999973,92.09,Outgoing
77418940,2023-02-11,136.64,130.61,Incoming
77418940,2023-02-11,324.16999999999996,187.53,Incoming
77418940,2023-02-11,404.67999999999995,80.51,Incoming
77418940,2023-02-11,-608.12,1012.8,Outgoing
77447018,2023-01-31,754.64,,-
77447018,2023-02-03,810.98,56.34,Incoming
77447018,2023-02-08,974.03,163.05,Incoming
77447018,2023-02-08,1033.5,59.47,Incoming
77447018,2023-02-10,1157.26,123.76,Incoming
77447018,2023-02-10,998.06,159.2,Outgoing
77447018,2023-02-11,1048.1299999999999,50.07,Incoming
77447018,2023-02-11,1195.9399999999998,147.81,Incoming
77504884,2023-01-31,221.03,,-
77504884,2023-02-01,-474.27,695.3,Outgoing
77504884,2023-02-07,-597.26,122.99,Outgoing
77504884,2023-02-08,-689.37,92.11,Outgoing
77504884,2023-02-08,-645.48,43.89,Incoming
77504884,2023-02-08,-753.99,108.51,Outgoing
77504884,2023-02-12,-702.94,51.05,Incoming
77504884,2023-02-12,-584.33,118.61,Incoming
77551209,2023-01-31,7.33,,-
77551209,2023-02-04,-1788.47,1795.8,Outgoing
77551209,2023-02-05,-1719.31,69.16,Incoming
77551209,2023-02-09,-2385.71,666.4,Outgoing
77551209,2023-02-09,-2522.5,136.79,Outgoing
77551209,2023-02-11,-1949.3,573.2,Incoming
77551209,2023-02-13,-1844.74,104.56,Incoming
77554032,2023-01-31,646.5,,-
77554032,2023-02-02,600.75,45.75,Outgoing
77554032,2023-02-02,725.09,124.34,Incoming
77554032,2023-02-04,666.23,58.86,Outgoing
77554032,2023-02-07,1696.13,1029.9,Incoming
77554032,2023-02-07,1894.3400000000001,198.21,Incoming
77554032,2023-02-10,1996.0600000000002,101.72,Incoming
77554032,2023-02-10,2020.0200000000002,23.96,Incoming
77587664,2023-01-31,769.43,,-
77587664,2023-02-04,841.92,72.49,Incoming
77587664,2023-02-05,932.5799999999999,90.66,Incoming
77587664,2023-02-06,881.53,51.05,Outgoing
77587664,2023-02-06,726.72,154.81,Outgoing
77587664,2023-02-07,760.07,33.35,Incoming
77587664,2023-02-09,849.46,89.39,Incoming
77587664,2023-02-12,776.52,72.94,Outgoing
77646359,2023-01-31,434.93,,-
77646359,2023-02-11,391.46000000000004,43.47,Outgoing
77668890,2023-01-31,804.88,,-
77668890,2023-02-02,908.3199999999999,103.44,Incoming
77668890,2023-02-03,318.2199999999999,590.1,Outgoing
77668890,2023-02-03,419.5199999999999,101.3,Incoming
77668890,2023-02-05,569.4499999999999,149.93,Incoming
77668890,2023-02-10,690.3599999999999,120.91,Incoming
77668890,2023-02-11,864.7599999999999,174.4,Incoming
77668890,2023-02-13,963.0999999999999,98.34,Incoming
77668890,2023-02-14,830.3499999999999,132.75,Outgoing
77668890,2023-02-14,849.18,18.83,Incoming
77668890,2023-02-14,830.3499999999999,18.83,Outgoing
77668890,2023-02-14,863.4399999999999,33.09,Incoming
77688406,2023-01-31,224.2,,-
77688406,2023-02-05,174.35999999999999,49.84,Outgoing
77688406,2023-02-06,190.85999999999999,16.5,Incoming
77688406,2023-02-07,-1325.44,1516.3,Outgoing
77688406,2023-02-08,-1185.3700000000001,140.07,Incoming
77688406,2023-02-10,-1280.45,95.08,Outgoing
77688406,2023-02-14,-1179.3500000000001,101.1,Incoming
77717508,2023-01-31,493.27,,-
77717508,2023-02-01,667.23,173.96,Incoming
77717508,2023-02-03,740.54,73.31,Incoming
77717508,2023-02-04,620.7099999999999,119.83,Outgoing
77717508,2023-02-12,510.44999999999993,110.26,Outgoing
77717508,2023-02-12,411.03999999999996,99.41,Outgoing
77717508,2023-02-12,285.41999999999996,125.62,Outgoing
77722115,2023-01-31,735.94,,-
77722115,2023-02-01,896.7,160.76,Incoming
77722115,2023-02-02,1027.6000000000001,130.9,Incoming
77722115,2023-02-03,898.2400000000001,129.36,Outgoing
77722115,2023-02-05,805.6400000000001,92.6,Outgoing
77722115,2023-02-05,725.0800000000002,80.56,Outgoing
77722115,2023-02-05,863.4000000000001,138.32,Incoming
77722115,2023-02-06,728.44,134.96,Outgoing
77722115,2023-02-07,933.25,204.81,Incoming
77722115,2023-02-09,754.64,178.61,Outgoing
77722115,2023-02-14,897.5,142.86,Incoming
77737443,2023-01-31,220.7,,-
77737443,2023-02-03,336.57,115.87,Incoming
77737443,2023-02-04,523.76,187.19,Incoming
77737443,2023-02-06,420.68,103.08,Outgoing
77737443,2023-02-07,376.66,44.02,Outgoing
77737443,2023-02-11,302.72,73.94,Outgoing
77737443,2023-02-12,208.94000000000003,93.78,Outgoing
77737443,2023-02-12,197.16000000000003,11.78,Outgoing
77792490,2023-01-31,822.76,,-
77792490,2023-02-01,973.14,150.38,Incoming
77792490,2023-02-03,850.92,122.22,Outgoing
77792490,2023-02-04,974.3499999999999,123.43,Incoming
77792490,2023-02-04,1107.81,133.46,Incoming
77792490,2023-02-06,983.64,124.17,Outgoing
77792490,2023-02-11,1076.26,92.62,Incoming
77792490,2023-02-11,1165.76,89.5,Incoming
77792490,2023-02-12,1033.48,132.28,Outgoing
77792490,2023-02-13,921.73,111.75,Outgoing
77797288,2023-01-31,199.97,,-
77797288,2023-02-02,268.6,68.63,Incoming
77797288,2023-02-05,-1584.1,1852.7,Outgoing
77797288,2023-02-12,-3393.0,1808.9,Outgoing
77797288,2023-02-12,-3284.81,108.19,Incoming
77802960,2023-01-31,157.47,,-
77802960,2023-02-06,314.44,156.97,Incoming
77802960,2023-02-07,421.24,106.8,Incoming
77802960,2023-02-14,280.27,140.97,Outgoing
77838890,2023-01-31,951.16,,-
77838890,2023-02-01,865.55,85.61,Outgoing
77838890,2023-02-10,52.75,812.8,Outgoing
77838890,2023-02-11,64.05,11.3,Incoming
77838890,2023-02-13,-37.35000000000001,101.4,Outgoing
77838890,2023-02-14,-93.59,56.24,Outgoing
77841390,2023-01-31,673.82,,-
77841390,2023-02-04,755.73,81.91,Incoming
77841390,2023-02-07,854.39,98.66,Incoming
77841390,2023-02-08,-1054.31,1908.7,Outgoing
77841390,2023-02-12,-902.9399999999999,151.37,Incoming
77841390,2023-02-13,-841.1099999999999,61.83,Incoming
77841390,2023-02-14,-796.6699999999998,44.44,Incoming
77847751,2023-01-31,850.14,,-
77847751,2023-02-09,924.53,74.39,Incoming
77847751,2023-02-10,1120.32,195.79,Incoming
77847751,2023-02-13,1094.32,26.0,Outgoing
77847751,2023-02-14,1397.02,302.7,Incoming
77867306,2023-01-31,907.96,,-
77867306,2023-02-06,1076.89,168.93,Incoming
77867306,2023-02-09,1864.0900000000001,787.2,Incoming
77867306,2023-02-09,2054.77,190.68,Incoming
77867306,2023-02-11,2905.9700000000003,851.2,Incoming
77867306,2023-02-12,2829.82,76.15,Outgoing
77867306,2023-02-14,2899.81,69.99,Incoming
77880852,2023-01-31,550.69,,-
77880852,2023-02-02,371.0200000000001,179.67,Outgoing
77880852,2023-02-03,484.05000000000007,113.03,Incoming
77880852,2023-02-04,-1165.15,1649.2,Outgoing
77880852,2023-02-04,-1220.8500000000001,55.7,Outgoing
77880852,2023-02-06,-1080.8200000000002,140.03,Incoming
77880852,2023-02-07,-1162.2700000000002,81.45,Outgoing
77880852,2023-02-10,-1058.65,103.62,Incoming
77880852,2023-02-10,-1105.8700000000001,47.22,Outgoing
77880852,2023-02-12,-1174.25,68.38,Outgoing
77911836,2023-01-31,87.75,,-
77911836,2023-02-02,139.36,51.61,Incoming
77911836,2023-02-03,762.26,622.9,Incoming
77911836,2023-02-03,715.97,46.29,Outgoing
77911836,2023-02-06,830.3000000000001,114.33,Incoming
77911836,2023-02-08,730.8000000000001,99.5,Outgoing
77913078,2023-01-31,885.96,,-
77913078,2023-02-01,871.74,14.22,Outgoing
77913078,2023-02-02,778.24,93.5,Outgoing
77913078,2023-02-03,971.53,193.29,Incoming
77913078,2023-02-10,928.01,43.52,Outgoing
77913078,2023-02-12,773.19,154.82,Outgoing
77917083,2023-01-31,929.41,,-
77917083,2023-02-04,793.52,135.89,Outgoing
77917083,2023-02-05,872.3199999999999,78.8,Incoming
77917083,2023-02-08,-247.27999999999997,1119.6,Outgoing
77931114,2023-01-31,480.52,,-
77931114,2023-02-01,422.57,57.95,Outgoing
77931114,2023-02-05,358.15999999999997,64.41,Outgoing
77931114,2023-02-06,426.11999999999995,67.96,Incoming
77931114,2023-02-07,525.99,99.87,Incoming
77931114,2023-02-09,608.98,82.99,Incoming
77931114,2023-02-11,790.49,181.51,Incoming
77931114,2023-02-12,1832.39,1041.9,Incoming
77966293,2023-01-31,904.28,,-
77966293,2023-02-03,981.28,77.0,Incoming
77966293,2023-02-04,936.78,44.5,Outgoing
77966293,2023-02-05,855.5699999999999,81.21,Outgoing
77966293,2023-02-06,833.03,22.54,Outgoing
77966293,2023-02-08,700.04,132.99,Outgoing
77966293,2023-02-08,603.38,96.66,Outgoing
77966293,2023-02-12,737.79,134.41,Incoming
77966293,2023-02-13,819.1999999999999,81.41,Incoming
77966293,2023-02-14,718.79,100.41,Outgoing
77980498,2023-01-31,893.87,,-
77980498,2023-02-01,944.42,50.55,Incoming
77980498,2023-02-01,1025.78,81.36,Incoming
77980498,2023-02-01,1128.09,102.31,Incoming
77980498,2023-02-04,1175.05,46.96,Incoming
77980498,2023-02-10,356.04999999999995,819.0,Outgoing
77980498,2023-02-11,319.97999999999996,36.07,Outgoing
78004131,2023-01-31,723.24,,-
78004131,2023-02-01,757.41,34.17,Incoming
78004131,2023-02-04,795.16,37.75,Incoming
78004131,2023-02-07,807.85,12.69,Incoming
78004131,2023-02-08,2053.35,1245.5,Incoming
78004131,2023-02-10,1896.4099999999999,156.94,Outgoing
78047487,2023-01-31,417.33,,-
78047487,2023-02-13,478.47999999999996,61.15,Incoming
78065026,2023-01-31,356.26,,-
78065026,2023-02-02,436.27,80.01,Incoming
78065026,2023-02-05,477.82,41.55,Incoming
78065026,2023-02-07,553.28,75.46,Incoming
78065026,2023-02-09,514.9399999999999,38.34,Outgoing
78065026,2023-02-13,709.15,194.21,Incoming
78072161,2023-01-31,914.19,,-
78072161,2023-02-01,990.8800000000001,76.69,Incoming
78072161,2023-02-03,919.8900000000001,70.99,Outgoing
78072161,2023-02-05,1094.94,175.05,Incoming
78072161,2023-02-06,1213.42,118.48,Incoming
78072161,2023-02-07,1102.3400000000001,111.08,Outgoing
78072161,2023-02-11,1204.6000000000001,102.26,Incoming
78076137,2023-01-31,290.47,,-
78076137,2023-02-01,161.54000000000002,128.93,Outgoing
78076137,2023-02-02,207.29000000000002,45.75,Incoming
78076137,2023-02-04,337.41,130.12,Incoming
78076137,2023-02-04,-893.79,1231.2,Outgoing
78076137,2023-02-05,-535.89,357.9,Incoming
78076137,2023-02-10,-364.66999999999996,171.22,Incoming
78076137,2023-02-12,-443.5799999999999,78.91,Outgoing
78076137,2023-02-13,-559.0799999999999,115.5,Outgoing
78076137,2023-02-13,175.22000000000003,734.3,Incoming
78129803,2023-01-31,233.76,,-
78129803,2023-02-03,195.14999999999998,38.61,Outgoing
78129803,2023-02-03,363.48,168.33,Incoming
78129803,2023-02-05,-177.31999999999994,540.8,Outgoing
78129803,2023-02-08,-22.85999999999993,154.46,Incoming
78129803,2023-02-11,-57.88999999999993,35.03,Outgoing
78129803,2023-02-12,-204.69999999999993,146.81,Outgoing
78129803,2023-02-12,-82.33999999999993,122.36,Incoming
78129803,2023-02-13,-2.499999999999929,79.84,Incoming
78129803,2023-02-13,39.25000000000007,41.75,Incoming
78133064,2023-01-31,103.96,,-
78133064,2023-02-02,260.48,156.52,Incoming
78133064,2023-02-02,157.04000000000002,103.44,Outgoing
78133064,2023-02-03,-1778.46,1935.5,Outgoing
78133064,2023-02-10,-1908.15,129.69,Outgoing
78133064,2023-02-12,-1808.0900000000001,100.06,Incoming
78133064,2023-02-12,-1985.6100000000001,177.52,Outgoing
78133064,2023-02-12,-2134.88,149.27,Outgoing
78167719,2023-01-31,969.06,,-
78167719,2023-02-03,1099.97,130.91,Incoming
78167719,2023-02-03,1046.54,53.43,Outgoing
78167719,2023-02-04,974.97,71.57,Outgoing
78167719,2023-02-04,30.470000000000027,944.5,Outgoing
78167719,2023-02-07,-112.47999999999996,142.95,Outgoing
78167719,2023-02-07,-27.66999999999996,84.81,Incoming
78167719,2023-02-09,36.280000000000044,63.95,Incoming
78167719,2023-02-14,133.34000000000003,97.06,Incoming
78167719,2023-02-14,281.06000000000006,147.72,Incoming
78167719,2023-02-14,391.4800000000001,110.42,Incoming
78175956,2023-01-31,124.55,,-
78175956,2023-02-02,10.11,114.44,Outgoing
78175956,2023-02-04,84.95,74.84,Incoming
78175956,2023-02-06,-21.36,106.31,Outgoing
78175956,2023-02-09,-11.309999999999999,10.05,Incoming
78175956,2023-02-14,50.03,61.34,Incoming
78184766,2023-01-31,98.1,,-
78184766,2023-02-05,207.51,109.41,Incoming
78184766,2023-02-08,163.60999999999999,43.9,Outgoing
78184766,2023-02-08,232.23999999999998,68.63,Incoming
78184766,2023-02-10,307.75,75.51,Incoming
78184766,2023-02-12,384.46,76.71,Incoming
78234498,2023-01-31,697.88,,-
78234498,2023-02-01,628.7,69.18,Outgoing
78234498,2023-02-04,-740.8999999999999,1369.6,Outgoing
78234498,2023-02-13,-853.7799999999999,112.88,Outgoing
78257880,2023-01-31,933.22,,-
78257880,2023-02-03,752.7,180.52,Outgoing
78257880,2023-02-03,654.74,97.96,Outgoing
78257880,2023-02-03,-98.75999999999999,753.5,Outgoing
78257880,2023-02-08,-250.23,151.47,Outgoing
78257880,2023-02-09,337.66999999999996,587.9,Incoming
78257880,2023-02-09,-210.63,548.3,Outgoing
78257880,2023-02-10,-179.35,31.28,Incoming
78268704,2023-01-31,888.99,,-
78268704,2023-02-05,747.63,141.36,Outgoing
78268704,2023-02-05,-249.76999999999998,997.4,Outgoing
78268704,2023-02-06,-681.67,431.9,Outgoing
78268704,2023-02-07,-595.51,86.16,Incoming
78268704,2023-02-07,-569.18,26.33,Incoming
78268704,2023-02-13,-544.8599999999999,24.32,Incoming
78296743,2023-01-31,406.97,,-
78296743,2023-02-01,2295.17,1888.2,Incoming
78296743,2023-02-02,2403.84,108.67,Incoming
78296743,2023-02-07,2498.11,94.27,Incoming
78296743,2023-02-08,2534.83,36.72,Incoming
78296743,2023-02-08,2438.49,96.34,Outgoing
78296743,2023-02-08,2593.0899999999997,154.6,Incoming
78296743,2023-02-09,2696.5299999999997,103.44,Incoming
78296743,2023-02-10,2840.37,143.84,Incoming
78296743,2023-02-10,2906.56,66.19,Incoming
78296743,2023-02-13,2844.2,62.36,Outgoing
78296743,2023-02-13,3179.1,334.9,Incoming
78303304,2023-01-31,921.4,,-
78303304,2023-02-03,1029.72,108.32,Incoming
78303304,2023-02-06,1121.3,91.58,Incoming
78303304,2023-02-08,990.8699999999999,130.43,Outgoing
78343618,2023-01-31,30.43,,-
78343618,2023-02-01,-50.00000000000001,80.43,Outgoing
78343618,2023-02-01,-59.32000000000001,9.32,Outgoing
78343618,2023-02-02,1133.98,1193.3,Incoming
78343618,2023-02-02,1061.08,72.9,Outgoing
78343618,2023-02-03,2693.08,1632.0,Incoming
78343618,2023-02-08,2585.61,107.47,Outgoing
78343618,2023-02-13,2420.8500000000004,164.76,Outgoing
78362587,2023-01-31,390.79,,-
78362587,2023-02-01,1683.29,1292.5,Incoming
78362587,2023-02-02,3183.19,1499.9,Incoming
78362587,2023-02-02,3040.7400000000002,142.45,Outgoing
78362587,2023-02-04,3107.0600000000004,66.32,Incoming
78362587,2023-02-04,1840.6600000000003,1266.4,Outgoing
78362587,2023-02-04,3351.1600000000003,1510.5,Incoming
78362587,2023-02-07,3487.4600000000005,136.3,Incoming
78362587,2023-02-10,3512.8700000000003,25.41,Incoming
78362587,2023-02-10,3477.2300000000005,35.64,Outgoing
78362587,2023-02-12,3596.0000000000005,118.77,Incoming
78392456,2023-01-31,592.04,,-
78392456,2023-02-02,468.23999999999995,123.8,Outgoing
78392456,2023-02-04,509.36999999999995,41.13,Incoming
78392456,2023-02-05,443.63999999999993,65.73,Outgoing
78392456,2023-02-07,515.6299999999999,71.99,Incoming
78392456,2023-02-09,356.8599999999999,158.77,Outgoing
78392456,2023-02-10,579.2599999999999,222.4,Incoming
78392456,2023-02-11,373.8199999999999,205.44,Outgoing
78392456,2023-02-11,279.5099999999999,94.31,Outgoing
78392456,2023-02-12,170.9999999999999,108.51,Outgoing
78392456,2023-02-13,213.53999999999988,42.54,Incoming
78395863,2023-01-31,458.24,,-
78395863,2023-02-01,289.9,168.34,Outgoing
78395863,2023-02-02,-89.60000000000002,379.5,Outgoing
78395863,2023-02-02,11.859999999999971,101.46,Incoming
78395863,2023-02-03,165.44,153.58,Incoming
78395863,2023-02-09,215.12,49.68,Incoming
78395863,2023-02-10,129.81,85.31,Outgoing
78395863,2023-02-11,256.59000000000003,126.78,Incoming
78395863,2023-02-12,1875.8899999999999,1619.3,Incoming
78395863,2023-02-13,1698.37,177.52,Outgoing
78493642,2023-01-31,748.98,,-
78493642,2023-02-02,803.09,54.11,Incoming
78493642,2023-02-02,906.5600000000001,103.47,Incoming
78493642,2023-02-02,852.97,53.59,Outgoing
78493642,2023-02-07,787.37,65.6,Outgoing
78493642,2023-02-07,674.14,113.23,Outgoing
78493642,2023-02-07,489.12,185.02,Outgoing
78493642,2023-02-09,354.34000000000003,134.78,Outgoing
78493642,2023-02-10,186.65000000000003,167.69,Outgoing
78493642,2023-02-13,24.850000000000023,161.8,Outgoing
78501355,2023-01-31,910.42,,-
78501355,2023-02-04,-700.38,1610.8,Outgoing
78501355,2023-02-07,-910.66,210.28,Outgoing
78501355,2023-02-10,-1949.46,1038.8,Outgoing
78541427,2023-01-31,366.51,,-
78541427,2023-02-03,-351.69000000000005,718.2,Outgoing
78541427,2023-02-06,1399.9099999999999,1751.6,Incoming
78541427,2023-02-06,2381.81,981.9,Incoming
78541427,2023-02-07,2305.23,76.58,Outgoing
78541427,2023-02-09,2338.1,32.87,Incoming
78541427,2023-02-13,2221.7999999999997,116.3,Outgoing
78541427,2023-02-14,2317.1,95.3,Incoming
78580221,2023-01-31,271.94,,-
78580221,2023-02-01,166.78,105.16,Outgoing
78580221,2023-02-06,287.90999999999997,121.13,Incoming
78580221,2023-02-12,384.51,96.6,Incoming
78580221,2023-02-12,581.8,197.29,Incoming
78580221,2023-02-14,462.31999999999994,119.48,Outgoing
78584818,2023-01-31,723.21,,-
78584818,2023-02-02,600.7900000000001,122.42,Outgoing
78584818,2023-02-03,481.7700000000001,119.02,Outgoing
78584818,2023-02-07,357.2200000000001,124.55,Outgoing
78584818,2023-02-09,413.2500000000001,56.03,Incoming
78667134,2023-01-31,672.23,,-
78667134,2023-02-02,765.32,93.09,Incoming
78667134,2023-02-03,900.76,135.44,Incoming
78667134,2023-02-04,747.45,153.31,Outgoing
78667134,2023-02-04,707.74,39.71,Outgoing
78667134,2023-02-08,804.81,97.07,Incoming
78667134,2023-02-13,859.88,55.07,Incoming
78667134,2023-02-13,782.11,77.77,Outgoing
78667134,2023-02-14,850.6700000000001,68.56,Incoming
78673350,2023-01-31,307.25,,-
78673350,2023-02-03,232.53,74.72,Outgoing
78673350,2023-02-08,120.09,112.44,Outgoing
78673350,2023-02-09,257.26,137.17,Incoming
78673350,2023-02-14,238.64,18.62,Outgoing
78716149,2023-01-31,658.83,,-
78716149,2023-02-01,708.6700000000001,49.84,Incoming
78716149,2023-02-02,892.96,184.29,Incoming
78716149,2023-02-06,854.26,38.7,Outgoing
78716149,2023-02-08,814.13,40.13,Outgoing
78716149,2023-02-10,920.16,106.03,Incoming
78716149,2023-02-14,834.3499999999999,85.81,Outgoing
78767161,2023-01-31,248.42,,-
78767161,2023-02-01,363.83,115.41,Incoming
78767161,2023-02-02,341.28999999999996,22.54,Outgoing
78767161,2023-02-02,474.88,133.59,Incoming
78767161,2023-02-05,660.1800000000001,185.3,Incoming
78767161,2023-02-06,730.0200000000001,69.84,Incoming
78767161,2023-02-06,721.9800000000001,8.04,Outgoing
78767161,2023-02-08,611.9100000000001,110.07,Outgoing
78767161,2023-02-11,536.7700000000001,75.14,Outgoing
78767161,2023-02-14,639.95,103.18,Incoming
78773905,2023-01-31,511.78,,-
78773905,2023-02-10,701.29,189.51,Incoming
78773905,2023-02-11,1805.79,1104.5,Incoming
78773905,2023-02-12,1688.96,116.83,Outgoing
78773905,2023-02-12,1739.98,51.02,Incoming
78773905,2023-02-13,1778.1100000000001,38.13,Incoming
78807944,2023-01-31,442.48,,-
78807944,2023-02-01,533.38,90.9,Incoming
78807944,2023-02-04,667.72,134.34,Incoming
78807944,2023-02-06,526.49,141.23,Outgoing
78807944,2023-02-07,299.65999999999997,226.83,Outgoing
78807944,2023-02-08,308.84999999999997,9.19,Incoming
78807944,2023-02-10,156.67999999999998,152.17,Outgoing
78807944,2023-02-12,326.02,169.34,Incoming
78807944,2023-02-12,401.46,75.44,Incoming
78807944,2023-02-13,308.92999999999995,92.53,Outgoing
78807944,2023-02-13,470.72999999999996,161.8,Incoming
78844183,2023-01-31,194.7,,-
78844183,2023-02-02,207.04999999999998,12.35,Incoming
78844183,2023-02-05,388.46999999999997,181.42,Incoming
78844183,2023-02-06,520.76,132.29,Incoming
78844183,2023-02-12,571.1,50.34,Incoming
78844183,2023-02-13,672.19,101.09,Incoming
78905675,2023-01-31,11.18,,-
78905675,2023-02-01,95.25999999999999,84.08,Incoming
78905675,2023-02-04,233.29999999999998,138.04,Incoming
78905675,2023-02-05,335.14,101.84,Incoming
78905675,2023-02-08,205.44,129.7,Outgoing
78905675,2023-02-08,151.78,53.66,Outgoing
78905675,2023-02-08,50.93000000000001,100.85,Outgoing
78905675,2023-02-09,15.750000000000007,35.18,Outgoing
78905675,2023-02-10,4.680000000000007,11.07,Outgoing
78905675,2023-02-13,52.690000000000005,48.01,Incoming
78905675,2023-02-13,132.61,79.92,Incoming
78913378,2023-01-31,378.08,,-
78913378,2023-02-01,462.33,84.25,Incoming
78913378,2023-02-03,589.95,127.62,Incoming
78913378,2023-02-04,733.83,143.88,Incoming
78913378,2023-02-04,664.96,68.87,Outgoing
78913378,2023-02-05,723.4100000000001,58.45,Incoming
78913378,2023-02-06,1434.6100000000001,711.2,Incoming
78913378,2023-02-08,1288.1100000000001,146.5,Outgoing
78913378,2023-02-12,1373.5000000000002,85.39,Incoming
78913378,2023-02-12,1445.5900000000001,72.09,Incoming
78927989,2023-01-31,825.23,,-
78927989,2023-02-02,802.59,22.64,Outgoing
78927989,2023-02-05,862.94,60.35,Incoming
78927989,2023-02-05,2037.74,1174.8,Incoming
78927989,2023-02-07,2142.92,105.18,Incoming
78927989,2023-02-09,1989.47,153.45,Outgoing
78927989,2023-02-09,1772.2,217.27,Outgoing
78927989,2023-02-11,1921.01,148.81,Incoming
78927989,2023-02-12,1854.69,66.32,Outgoing
78927989,2023-02-13,1802.43,52.26,Outgoing
78927989,2023-02-13,1735.88,66.55,Outgoing
78927989,2023-02-14,1770.72,34.84,Incoming
78927989,2023-02-14,1802.42,31.7,Incoming
78945298,2023-01-31,609.68,,-
78945298,2023-02-03,508.86999999999995,100.81,Outgoing
78945298,2023-02-04,-811.3300000000002,1320.2,Outgoing
78945298,2023-02-05,-931.0800000000002,119.75,Outgoing
78945298,2023-02-05,-1046.6100000000001,115.53,Outgoing
78945298,2023-02-07,-852.6000000000001,194.01,Incoming
78945298,2023-02-07,-1736.2000000000003,883.6,Outgoing
78945298,2023-02-08,-1795.0200000000002,58.82,Outgoing
78945298,2023-02-09,-1679.9600000000003,115.06,Incoming
78953379,2023-01-31,45.3,,-
78953379,2023-02-02,226.86,181.56,Incoming
78953379,2023-02-05,551.86,325.0,Incoming
78953379,2023-02-05,498.32,53.54,Outgoing
78953379,2023-02-10,417.96,80.36,Outgoing
78953379,2023-02-12,332.03,85.93,Outgoing
78953379,2023-02-12,278.46,53.57,Outgoing
78953379,2023-02-14,342.2,63.74,Incoming
79015773,2023-01-31,706.11,,-
79015773,2023-02-03,780.83,74.72,Incoming
79015773,2023-02-10,669.7800000000001,111.05,Outgoing
79015773,2023-02-11,595.4200000000001,74.36,Outgoing
79015773,2023-02-12,687.23,91.81,Incoming
79015773,2023-02-12,783.07,95.84,Incoming
79015773,2023-02-13,743.9200000000001,39.15,Outgoing
79015773,2023-02-14,625.1700000000001,118.75,Outgoing
79033058,2023-01-31,97.12,,-
79033058,2023-02-01,264.65,167.53,Incoming
79033058,2023-02-02,382.14,117.49,Incoming
79033058,2023-02-04,-1072.7600000000002,1454.9,Outgoing
79033058,2023-02-09,431.9399999999998,1504.7,Incoming
79033058,2023-02-12,363.04999999999984,68.89,Outgoing
79033058,2023-02-13,410.86999999999983,47.82,Incoming
79036903,2023-01-31,491.23,,-
79036903,2023-02-01,475.17,16.06,Outgoing
79036903,2023-02-03,520.58,45.41,Incoming
79036903,2023-02-09,339.27000000000004,181.31,Outgoing
79036903,2023-02-09,458.78000000000003,119.51,Incoming
79036903,2023-02-10,637.88,179.1,Incoming
79036903,2023-02-11,775.14,137.26,Incoming
79036903,2023-02-11,847.84,72.7,Incoming
79036903,2023-02-11,912.0500000000001,64.21,Incoming
79036903,2023-02-13,1073.49,161.44,Incoming
79036903,2023-02-14,1214.62,141.13,Incoming
79069274,2023-01-31,685.1,,-
79069274,2023-02-03,789.1,104.0,Incoming
79069274,2023-02-09,886.25,97.15,Incoming
79069274,2023-02-12,989.99,103.74,Incoming
79069274,2023-02-13,1076.78,86.79,Incoming
79090076,2023-01-31,119.25,,-
79090076,2023-02-01,-11.580000000000013,130.83,Outgoing
79090076,2023-02-02,-1532.3799999999999,1520.8,Outgoing
79090076,2023-02-02,-981.1799999999998,551.2,Incoming
79090076,2023-02-03,-1168.8799999999999,187.7,Outgoing
79090076,2023-02-07,-1114.53,54.35,Incoming
79090076,2023-02-07,-988.21,126.32,Incoming
79090076,2023-02-09,-887.09,101.12,Incoming
79090076,2023-02-09,-1097.89,210.8,Outgoing
79090076,2023-02-13,-953.0700000000002,144.82,Incoming
79090076,2023-02-14,-1127.3300000000002,174.26,Outgoing
79091642,2023-01-31,961.45,,-
79091642,2023-02-02,297.85,663.6,Outgoing
79091642,2023-02-05,187.73000000000002,110.12,Outgoing
79091642,2023-02-07,53.77000000000001,133.96,Outgoing
79091642,2023-02-10,179.24,125.47,Incoming
79091642,2023-02-10,114.78000000000002,64.46,Outgoing
79118116,2023-01-31,463.1,,-
79118116,2023-02-01,568.65,105.55,Incoming
79118116,2023-02-01,513.0699999999999,55.58,Outgoing
79118116,2023-02-02,649.4499999999999,136.38,Incoming
79118116,2023-02-04,527.3899999999999,122.06,Outgoing
79118116,2023-02-06,386.32999999999987,141.06,Outgoing
79118116,2023-02-07,487.76999999999987,101.44,Incoming
79118116,2023-02-10,390.7399999999999,97.03,Outgoing
79147964,2023-01-31,753.1,,-
79147964,2023-02-01,583.4200000000001,169.68,Outgoing
79147964,2023-02-01,480.81000000000006,102.61,Outgoing
79147964,2023-02-01,533.1300000000001,52.32,Incoming
79147964,2023-02-02,402.23000000000013,130.9,Outgoing
79147964,2023-02-02,586.0600000000002,183.83,Incoming
79147964,2023-02-04,375.8100000000002,210.25,Outgoing
79147964,2023-02-05,439.51000000000016,63.7,Incoming
79163824,2023-01-31,938.15,,-
79163824,2023-02-01,1837.9499999999998,899.8,Incoming
79163824,2023-02-04,1901.7599999999998,63.81,Incoming
79163824,2023-02-06,1820.0799999999997,81.68,Outgoing
79163824,2023-02-06,1694.2599999999998,125.82,Outgoing
79163824,2023-02-12,1582.5799999999997,111.68,Outgoing
79163824,2023-02-14,1435.3399999999997,147.24,Outgoing
79169988,2023-01-31,354.01,,-
79169988,2023-02-02,217.63,136.38,Outgoing
79169988,2023-02-06,166.1,51.53,Outgoing
79169988,2023-02-08,197.4,31.3,Incoming
79169988,2023-02-08,299.51,102.11,Incoming
79169988,2023-02-09,-527.79,827.3,Outgoing
79169988,2023-02-10,-739.89,212.1,Outgoing
79169988,2023-02-13,-798.1899999999999,58.3,Outgoing
79169988,2023-02-13,-704.6299999999999,93.56,Incoming
79181666,2023-01-31,600.88,,-
79181666,2023-02-04,497.55,103.33,Outgoing
79181666,2023-02-08,635.86,138.31,Incoming
79181666,2023-02-09,512.02,123.84,Outgoing
79181666,2023-02-10,445.03999999999996,66.98,Outgoing
79181666,2023-02-11,367.27,77.77,Outgoing
79181666,2023-02-12,258.31,108.96,Outgoing
79181666,2023-02-14,387.6,129.29,Incoming
79181666,2023-02-14,258.01,129.59,Outgoing
79213491,2023-01-31,308.65,,-
79213491,2023-02-03,357.80999999999995,49.16,Incoming
79213491,2023-02-05,409.53,51.72,Incoming
79213491,2023-02-05,625.93,216.4,Incoming
79213491,2023-02-07,637.92,11.99,Incoming
79213491,2023-02-09,675.8199999999999,37.9,Incoming
79307217,2023-01-31,307.87,,-
79307217,2023-02-02,214.56,93.31,Outgoing
79307217,2023-02-08,187.74,26.82,Outgoing
79307217,2023-02-09,86.37,101.37,Outgoing
79307217,2023-02-10,7.290000000000006,79.08,Outgoing
79307217,2023-02-13,-52.89999999999999,60.19,Outgoing
79309039,2023-01-31,642.08,,-
79309039,2023-02-01,738.22,96.14,Incoming
79309039,2023-02-03,573.28,164.94,Outgoing
79309039,2023-02-04,448.53999999999996,124.74,Outgoing
79309039,2023-02-06,369.77,78.77,Outgoing
79309039,2023-02-06,1346.77,977.0,Incoming
79309039,2023-02-11,1437.48,90.71,Incoming
79309039,2023-02-11,1531.79,94.31,Incoming
79325967,2023-01-31,647.65,,-
79325967,2023-02-04,490.33,157.32,Outgoing
79329254,2023-01-31,984.43,,-
79329254,2023-02-08,1067.45,83.02,Incoming
79329254,2023-02-10,977.1300000000001,90.32,Outgoing
79329254,2023-02-12,813.1000000000001,164.03,Outgoing
79329254,2023-02-12,-330.5999999999999,1143.7,Outgoing
79329254,2023-02-12,-235.45999999999992,95.14,Incoming
79355498,2023-01-31,132.74,,-
79355498,2023-02-01,-679.86,812.6,Outgoing
79355498,2023-02-03,-560.3,119.56,Incoming
79355498,2023-02-05,-486.02,74.28,Incoming
79355498,2023-02-06,-648.22,162.2,Outgoing
79380893,2023-01-31,163.15,,-
79380893,2023-02-01,226.26,63.11,Incoming
79380893,2023-02-02,51.51999999999998,174.74,Outgoing
79380893,2023-02-03,198.39999999999998,146.88,Incoming
79380893,2023-02-03,78.71999999999997,119.68,Outgoing
79380893,2023-02-09,-117.75000000000003,196.47,Outgoing
79380893,2023-02-12,4.729999999999976,122.48,Incoming
79380893,2023-02-12,-23.880000000000024,28.61,Outgoing
79380893,2023-02-12,136.25999999999996,160.14,Incoming
79415620,2023-01-31,729.51,,-
79415620,2023-02-07,624.87,104.64,Outgoing
79415620,2023-02-08,738.25,113.38,Incoming
79415620,2023-02-10,856.04,117.79,Incoming
79415620,2023-02-11,849.62,6.42,Outgoing
79415620,2023-02-14,754.32,95.3,Outgoing
79415620,2023-02-14,818.4200000000001,64.1,Incoming
79435523,2023-01-31,920.0,,-
79435523,2023-02-03,937.57,17.57,Incoming
79435523,2023-02-04,836.9100000000001,100.66,Outgoing
79435523,2023-02-08,977.6400000000001,140.73,Incoming
79435523,2023-02-12,885.7400000000001,91.9,Outgoing
79435523,2023-02-13,2283.34,1397.6,Incoming
79499412,2023-01-31,159.51,,-
79499412,2023-02-01,-801.29,960.8,Outgoing
79499412,2023-02-01,-1328.3899999999999,527.1,Outgoing
79499412,2023-02-14,-1371.81,43.42,Outgoing
79566165,2023-01-31,64.47,,-
79566165,2023-02-01,150.5,86.03,Incoming
79566165,2023-02-04,248.92000000000002,98.42,Incoming
79566165,2023-02-05,154.47000000000003,94.45,Outgoing
79566165,2023-02-05,59.520000000000024,94.95,Outgoing
79566165,2023-02-08,-72.92999999999996,132.45,Outgoing
79566165,2023-02-09,-91.28999999999996,18.36,Outgoing
79566165,2023-02-11,-161.52999999999997,70.24,Outgoing
79566165,2023-02-12,-21.009999999999962,140.52,Incoming
79566165,2023-02-14,65.85000000000004,86.86,Incoming
79566627,2023-01-31,377.62,,-
79566627,2023-02-02,1254.02,876.4,Incoming
79566627,2023-02-03,1362.15,108.13,Incoming
79566627,2023-02-04,1239.92,122.23,Outgoing
79566627,2023-02-04,1345.8500000000001,105.93,Incoming
79566627,2023-02-05,1363.5400000000002,17.69,Incoming
79566627,2023-02-07,1195.8200000000002,167.72,Outgoing
79566627,2023-02-08,1366.3200000000002,170.5,Incoming
79566627,2023-02-09,1475.6000000000001,109.28,Incoming
79566627,2023-02-12,1590.71,115.11,Incoming
79566627,2023-02-13,1672.57,81.86,Incoming
79566627,2023-02-14,1600.22,72.35,Outgoing
79570236,2023-01-31,91.66,,-
79570236,2023-02-05,249.93,158.27,Incoming
79570236,2023-02-07,351.29,101.36,Incoming
79570236,2023-02-08,-816.81,1168.1,Outgoing
79570236,2023-02-11,183.3900000000001,1000.2,Incoming
79599747,2023-01-31,393.28,,-
79599747,2023-02-02,450.93999999999994,57.66,Incoming
79599747,2023-02-03,357.99999999999994,92.94,Outgoing
79599747,2023-02-04,248.54999999999995,109.45,Outgoing
79599747,2023-02-06,122.95999999999995,125.59,Outgoing
79632523,2023-01-31,867.95,,-
79632523,2023-02-04,772.9000000000001,95.05,Outgoing
79632523,2023-02-04,623.57,149.33,Outgoing
79632523,2023-02-04,476.89000000000004,146.68,Outgoing
79632523,2023-02-05,606.1600000000001,129.27,Incoming
79632523,2023-02-08,512.4300000000001,93.73,Outgoing
79632523,2023-02-12,1422.5300000000002,910.1,Incoming
79656112,2023-01-31,848.18,,-
79656112,2023-02-04,1005.5,157.32,Incoming
79656112,2023-02-04,1204.91,199.41,Incoming
79656355,2023-01-31,766.41,,-
79656355,2023-02-01,-1053.8899999999999,1820.3,Outgoing
79656355,2023-02-02,-1239.9599999999998,186.07,Outgoing
79656355,2023-02-05,-1154.3399999999997,85.62,Incoming
79656355,2023-02-07,-1223.1999999999996,68.86,Outgoing
79656355,2023-02-08,-1107.2099999999996,115.99,Incoming
79656355,2023-02-09,-1057.9299999999996,49.28,Incoming
79656355,2023-02-10,-892.9099999999996,165.02,Incoming
79656355,2023-02-11,-835.6099999999997,57.3,Incoming
79656355,2023-02-13,-929.7999999999997,94.19,Outgoing
79656355,2023-02-14,-1595.8999999999996,666.1,Outgoing
79656355,2023-02-14,-1445.7099999999996,150.19,Incoming
79757019,2023-01-31,369.26,,-
79757019,2023-02-01,485.83,116.57,Incoming
79757019,2023-02-04,602.48,116.65,Incoming
79757019,2023-02-05,550.72,51.76,Outgoing
79757019,2023-02-07,476.61,74.11,Outgoing
79757019,2023-02-13,569.75,93.14,Incoming
79771974,2023-01-31,350.67,,-
79771974,2023-02-03,-262.33,613.0,Outgoing
79771974,2023-02-04,-157.88,104.45,Incoming
79771974,2023-02-04,-317.29999999999995,159.42,Outgoing
79771974,2023-02-07,-218.72999999999996,98.57,Incoming
79771974,2023-02-09,-286.48999999999995,67.76,Outgoing
79771974,2023-02-14,-242.53999999999996,43.95,Incoming
79792810,2023-01-31,505.57,,-
79792810,2023-02-02,814.3399999999999,308.77,Incoming
79792810,2023-02-11,889.4399999999999,75.1,Incoming
79792810,2023-02-12,1032.22,142.78,Incoming
79792810,2023-02-12,933.99,98.23,Outgoing
79933337,2023-01-31,508.79,,-
79933337,2023-02-01,424.54,84.25,Outgoing
79933337,2023-02-02,502.75,78.21,Incoming
79933337,2023-02-03,-751.05,1253.8,Outgoing
79933337,2023-02-04,-864.67,113.62,Outgoing
79933337,2023-02-09,-738.6899999999999,125.98,Incoming
79933337,2023-02-12,-614.7399999999999,123.95,Incoming
80001684,2023-01-31,572.24,,-
80001684,2023-02-05,1112.04,539.8,Incoming
80001684,2023-02-05,1070.71,41.33,Outgoing
80005822,2023-01-31,930.08,,-
80005822,2023-02-05,769.85,160.23,Outgoing
80005822,2023-02-10,889.77,119.92,Incoming
80005822,2023-02-10,799.73,90.04,Outgoing
80005822,2023-02-12,738.3000000000001,61.43,Outgoing
80005822,2023-02-14,-18.59999999999991,756.9,Outgoing
80015485,2023-01-31,310.56,,-
80015485,2023-02-05,367.07,56.51,Incoming
80015485,2023-02-10,459.93,92.86,Incoming
80015485,2023-02-14,306.70000000000005,153.23,Outgoing
80040176,2023-01-31,533.74,,-
80040176,2023-02-03,395.76,137.98,Outgoing
80040176,2023-02-03,489.83,94.07,Incoming
80040176,2023-02-07,646.23,156.4,Incoming
80040176,2023-02-07,667.25,21.02,Incoming
80040176,2023-02-08,556.77,110.48,Outgoing
80040176,2023-02-11,801.81,245.04,Incoming
80040176,2023-02-13,862.0,60.19,Incoming
80046304,2023-01-31,951.74,,-
80046304,2023-02-03,1022.73,70.99,Incoming
80046304,2023-02-03,923.05,99.68,Outgoing
80046304,2023-02-04,1090.78,167.73,Incoming
80046304,2023-02-04,1037.75,53.03,Outgoing
80046304,2023-02-05,847.74,190.01,Outgoing
80046304,2023-02-06,957.22,109.48,Incoming
80046304,2023-02-13,837.0600000000001,120.16,Outgoing
80046304,2023-02-14,800.46,36.6,Outgoing
80135904,2023-01-31,120.34,,-
80135904,2023-02-03,-873.36,993.7,Outgoing
80135904,2023-02-05,-781.08,92.28,Incoming
80135904,2023-02-07,-694.25,86.83,Incoming
80135904,2023-02-08,-813.73,119.48,Outgoing
80135904,2023-02-13,-1188.83,375.1,Outgoing
80168427,2023-01-31,19.01,,-
80168427,2023-02-01,200.07,181.06,Incoming
80168427,2023-02-01,281.28999999999996,81.22,Incoming
80168427,2023-02-03,206.00999999999996,75.28,Outgoing
80168427,2023-02-04,344.34999999999997,138.34,Incoming
80168427,2023-02-06,242.14999999999998,102.2,Outgoing
80184223,2023-01-31,52.59,,-
80184223,2023-02-07,205.83,153.24,Incoming
80184223,2023-02-10,10.04000000000002,195.79,Outgoing
80184223,2023-02-12,23.61000000000002,13.57,Incoming
80184223,2023-02-12,-72.09999999999997,95.71,Outgoing
80244844,2023-01-31,774.54,,-
80244844,2023-02-01,864.6099999999999,90.07,Incoming
80244844,2023-02-04,1063.9699999999998,199.36,Incoming
80244844,2023-02-04,935.7799999999997,128.19,Outgoing
80244844,2023-02-04,1051.3399999999997,115.56,Incoming
80244844,2023-02-08,911.2699999999998,140.07,Outgoing
80244844,2023-02-08,1060.9999999999998,149.73,Incoming
80244844,2023-02-09,924.6999999999998,136.3,Outgoing
80244844,2023-02-11,883.8899999999999,40.81,Outgoing
80244844,2023-02-11,744.3299999999999,139.56,Outgoing
80244844,2023-02-14,692.43,51.9,Outgoing
80283776,2023-01-31,334.03,,-
80283776,2023-02-02,250.14999999999998,83.88,Outgoing
80283776,2023-02-02,398.24,148.09,Incoming
80283776,2023-02-06,420.41,22.17,Incoming
80283776,2023-02-07,542.08,121.67,Incoming
80283776,2023-02-08,449.24,92.84,Outgoing
80283776,2023-02-08,572.53,123.29,Incoming
80283776,2023-02-13,612.55,40.02,Incoming
80291188,2023-01-31,338.65,,-
80291188,2023-02-01,268.38,70.27,Outgoing
80291188,2023-02-05,392.9,124.52,Incoming
80291188,2023-02-07,354.60999999999996,38.29,Outgoing
80291188,2023-02-08,330.81999999999994,23.79,Outgoing
80291188,2023-02-11,402.05999999999995,71.24,Incoming
80291188,2023-02-11,477.53999999999996,75.48,Incoming
80291188,2023-02-12,553.0999999999999,75.56,Incoming
80291188,2023-02-13,441.13999999999993,111.96,Outgoing
80304720,2023-01-31,614.87,,-
80304720,2023-02-01,444.62,170.25,Outgoing
80304720,2023-02-05,513.37,68.75,Incoming
80325529,2023-01-31,996.6,,-
80325529,2023-02-03,1121.94,125.34,Incoming
80325529,2023-02-03,1077.94,44.0,Outgoing
80325529,2023-02-05,932.8100000000001,145.13,Outgoing
80325529,2023-02-05,1128.81,196.0,Incoming
80325529,2023-02-11,538.2099999999999,590.6,Outgoing
80325529,2023-02-13,466.50999999999993,71.7,Outgoing
80355773,2023-01-31,906.28,,-
80355773,2023-02-01,944.22,37.94,Incoming
80355773,2023-02-03,949.6,5.38,Incoming
80355773,2023-02-03,827.07,122.53,Outgoing
80355773,2023-02-05,949.25,122.18,Incoming
80355773,2023-02-09,1031.39,82.14,Incoming
80355773,2023-02-13,974.4800000000001,56.91,Outgoing
80355773,2023-02-14,1528.0800000000002,553.6,Incoming
80360244,2023-01-31,658.35,,-
80360244,2023-02-03,792.48,134.13,Incoming
80360244,2023-02-05,876.07,83.59,Incoming
80360244,2023-02-06,957.75,81.68,Incoming
80360244,2023-02-06,2905.05,1947.3,Incoming
80360244,2023-02-07,2890.2400000000002,14.81,Outgoing
80360244,2023-02-09,2813.63,76.61,Outgoing
80360244,2023-02-10,2824.94,11.31,Incoming
80379245,2023-01-31,793.17,,-
80379245,2023-02-01,849.23,56.06,Incoming
80379245,2023-02-03,702.64,146.59,Outgoing
80379245,2023-02-06,704.22,1.58,Incoming
80379245,2023-02-06,642.3000000000001,61.92,Outgoing
80379245,2023-02-07,536.0600000000001,106.24,Outgoing
80379245,2023-02-08,621.35,85.29,Incoming
80379245,2023-02-09,662.12,40.77,Incoming
80379245,2023-02-13,554.14,107.98,Outgoing
80391084,2023-01-31,466.35,,-
80391084,2023-02-03,1050.65,584.3,Incoming
80391084,2023-02-06,1022.3100000000001,28.34,Outgoing
80391084,2023-02-07,1144.44,122.13,Incoming
80391084,2023-02-14,1261.3400000000001,116.9,Incoming
80428983,2023-01-31,323.32,,-
80428983,2023-02-02,376.90999999999997,53.59,Incoming
80428983,2023-02-04,218.49999999999997,158.41,Outgoing
80428983,2023-02-09,130.51,87.99,Outgoing
80428983,2023-02-11,188.51999999999998,58.01,Incoming
80428983,2023-02-12,752.92,564.4,Incoming
80428983,2023-02-13,821.6099999999999,68.69,Incoming
80428983,2023-02-13,999.1299999999999,177.52,Incoming
80428983,2023-02-14,1060.1,60.97,Incoming
80439799,2023-01-31,968.23,,-
80439799,2023-02-05,918.28,49.95,Outgoing
80439799,2023-02-11,855.9499999999999,62.33,Outgoing
80439799,2023-02-11,1012.4399999999999,156.49,Incoming
80439799,2023-02-14,1103.1799999999998,90.74,Incoming
80464084,2023-01-31,12.73,,-
80464084,2023-02-02,-132.54000000000002,145.27,Outgoing
80464084,2023-02-03,-100.46000000000002,32.08,Incoming
80464084,2023-02-04,88.59999999999998,189.06,Incoming
80464084,2023-02-05,7.929999999999978,80.67,Outgoing
80464084,2023-02-06,221.36999999999998,213.44,Incoming
80464084,2023-02-06,292.30999999999995,70.94,Incoming
80504934,2023-01-31,759.22,,-
80504934,2023-02-04,834.1700000000001,74.95,Incoming
80504934,2023-02-06,668.5200000000001,165.65,Outgoing
80504934,2023-02-11,828.8100000000001,160.29,Incoming
80504934,2023-02-14,713.83,114.98,Outgoing
80596699,2023-01-31,47.06,,-
80596699,2023-02-01,-76.02,123.08,Outgoing
80596699,2023-02-01,-206.95,130.93,Outgoing
80596699,2023-02-03,-375.28,168.33,Outgoing
80596699,2023-02-03,-466.65,91.37,Outgoing
80596699,2023-02-04,-524.68,58.03,Outgoing
80596699,2023-02-06,-489.29999999999995,35.38,Incoming
80596699,2023-02-06,-575.1999999999999,85.9,Outgoing
80596699,2023-02-07,-623.8499999999999,48.65,Outgoing
80596699,2023-02-13,-597.6099999999999,26.24,Incoming
80610910,2023-01-31,139.54,,-
80610910,2023-02-02,283.49,143.95,Incoming
80610910,2023-02-05,119.14000000000001,164.35,Outgoing
80610910,2023-02-06,1151.44,1032.3,Incoming
80610910,2023-02-07,937.2700000000001,214.17,Outgoing
80678427,2023-01-31,97.72,,-
80678427,2023-02-01,44.29,53.43,Outgoing
80678427,2023-02-01,-58.61000000000001,102.9,Outgoing
80678427,2023-02-04,28.489999999999988,87.1,Incoming
80678427,2023-02-05,-113.79000000000002,142.28,Outgoing
80678427,2023-02-08,30.46999999999997,144.26,Incoming
80678427,2023-02-08,167.19999999999996,136.73,Incoming
80678427,2023-02-08,1218.6000000000001,1051.4,Incoming
80678427,2023-02-12,1359.39,140.79,Incoming
80678427,2023-02-12,1252.5300000000002,106.86,Outgoing
80678427,2023-02-13,1115.63,136.9,Outgoing
80678577,2023-01-31,288.61,,-
80678577,2023-02-04,193.99,94.62,Outgoing
80678577,2023-02-11,30.340000000000003,163.65,Outgoing
80678577,2023-02-13,-44.67999999999999,75.02,Outgoing
80709302,2023-01-31,280.92,,-
80709302,2023-02-05,136.13000000000002,144.79,Outgoing
80709302,2023-02-11,-1908.4699999999998,2044.6,Outgoing
80747298,2023-01-31,768.33,,-
80747298,2023-02-09,648.5600000000001,119.77,Outgoing
80747298,2023-02-13,510.32000000000005,138.24,Outgoing
80758476,2023-01-31,977.44,,-
80758476,2023-02-06,885.9100000000001,91.53,Outgoing
80758476,2023-02-07,890.9800000000001,5.07,Incoming
80758476,2023-02-11,719.4300000000001,171.55,Outgoing
80761210,2023-01-31,545.59,,-
80761210,2023-02-01,689.44,143.85,Incoming
80761210,2023-02-04,515.69,173.75,Outgoing
80761210,2023-02-04,675.96,160.27,Incoming
80761210,2023-02-07,781.0500000000001,105.09,Incoming
80761210,2023-02-08,707.3700000000001,73.68,Outgoing
80761210,2023-02-10,593.3800000000001,113.99,Outgoing
80778066,2023-01-31,217.49,,-
80778066,2023-02-01,273.07,55.58,Incoming
80778066,2023-02-03,123.19999999999999,149.87,Outgoing
80778066,2023-02-03,86.63,36.57,Outgoing
80778066,2023-02-07,30.499999999999993,56.13,Outgoing
80778066,2023-02-08,33.21999999999999,2.72,Incoming
80787776,2023-01-31,460.46,,-
80787776,2023-02-01,318.2,142.26,Outgoing
80787776,2023-02-03,245.79,72.41,Outgoing
80787776,2023-02-03,268.05,22.26,Incoming
80787776,2023-02-05,370.95000000000005,102.9,Incoming
80787776,2023-02-05,1666.45,1295.5,Incoming
80787776,2023-02-10,1778.81,112.36,Incoming
80787776,2023-02-11,1951.31,172.5,Incoming
80787776,2023-02-14,1800.8899999999999,150.42,Outgoing
80808205,2023-01-31,280.92,,-
80808205,2023-02-01,369.02,88.1,Incoming
80808205,2023-02-02,2067.02,1698.0,Incoming
80808205,2023-02-02,3149.7200000000003,1082.7,Incoming
80808205,2023-02-03,3016.6200000000003,133.1,Outgoing
80808205,2023-02-05,2942.84,73.78,Outgoing
80808205,2023-02-06,3002.44,59.6,Incoming
80808205,2023-02-11,3196.33,193.89,Incoming
80808205,2023-02-13,2981.72,214.61,Outgoing
80808205,2023-02-13,3999.3199999999997,1017.6,Incoming
80811957,2023-01-31,139.95,,-
80811957,2023-02-05,54.02999999999999,85.92,Outgoing
80811957,2023-02-07,166.25,112.22,Incoming
80811957,2023-02-13,125.6,40.65,Outgoing
80812213,2023-01-31,277.14,,-
80812213,2023-02-07,380.49,103.35,Incoming
80812213,2023-02-07,462.24,81.75,Incoming
80812213,2023-02-08,530.1700000000001,67.93,Incoming
80818151,2023-01-31,320.64,,-
80818151,2023-02-01,245.27999999999997,75.36,Outgoing
80818151,2023-02-02,255.37999999999997,10.1,Incoming
80818151,2023-02-06,-180.72000000000006,436.1,Outgoing
80877479,2023-01-31,210.98,,-
80877479,2023-02-03,109.72999999999999,101.25,Outgoing
80877479,2023-02-05,221.74,112.01,Incoming
80877479,2023-02-06,1679.54,1457.8,Incoming
80877479,2023-02-06,1763.6399999999999,84.1,Incoming
80877479,2023-02-07,1696.9699999999998,66.67,Outgoing
80877479,2023-02-09,1493.7299999999998,203.24,Outgoing
80884901,2023-01-31,453.71,,-
80884901,2023-02-05,632.73,179.02,Incoming
80884901,2023-02-06,692.46,59.73,Incoming
80884901,2023-02-07,777.69,85.23,Incoming
80884901,2023-02-09,906.0,128.31,Incoming
80884901,2023-02-11,871.11,34.89,Outgoing
80884901,2023-02-14,809.95,61.16,Outgoing
80889919,2023-01-31,298.45,,-
80889919,2023-02-06,318.84,20.39,Incoming
80889919,2023-02-08,188.12999999999997,130.71,Outgoing
80938878,2023-01-31,29.73,,-
80938878,2023-02-02,5.5,24.23,Outgoing
80938878,2023-02-08,76.0,70.5,Incoming
80938878,2023-02-12,-75.28999999999999,151.29,Outgoing
80939694,2023-01-31,923.76,,-
80939694,2023-02-04,62.65999999999997,861.1,Outgoing
80939694,2023-02-05,-39.81000000000003,102.47,Outgoing
80939694,2023-02-08,39.75999999999996,79.57,Incoming
80939694,2023-02-08,-26.81000000000003,66.57,Outgoing
80939694,2023-02-13,37.49999999999997,64.31,Incoming
80940019,2023-01-31,957.41,,-
80940019,2023-02-02,648.64,308.77,Outgoing
80940019,2023-02-03,1261.24,612.6,Incoming
80940019,2023-02-07,1562.24,301.0,Incoming
80940019,2023-02-11,1410.13,152.11,Outgoing
81049128,2023-01-31,694.91,,-
81049128,2023-02-06,581.4399999999999,113.47,Outgoing
81049128,2023-02-09,2309.24,1727.8,Incoming
81049128,2023-02-10,2500.7999999999997,191.56,Incoming
81049128,2023-02-11,2426.1899999999996,74.61,Outgoing
81075588,2023-01-31,297.73,,-
81075588,2023-02-01,198.43,99.3,Outgoing
81075588,2023-02-01,105.0,93.43,Outgoing
81075588,2023-02-06,4.909999999999997,100.09,Outgoing
81075588,2023-02-08,-138.94,143.85,Outgoing
81075588,2023-02-08,-256.01,117.07,Outgoing
81075588,2023-02-09,-132.66,123.35,Incoming
81075588,2023-02-09,-261.4,128.74,Outgoing
81075588,2023-02-10,-92.39999999999998,169.0,Incoming
81075588,2023-02-10,75.11000000000001,167.51,Incoming
81075588,2023-02-11,227.87,152.76,Incoming
81075588,2023-02-11,324.21000000000004,96.34,Incoming
81087182,2023-01-31,861.31,,-
81087182,2023-02-04,969.0899999999999,107.78,Incoming
81087182,2023-02-05,1111.28,142.19,Incoming
81087182,2023-02-06,1247.8799999999999,136.6,Incoming
81087182,2023-02-09,1413.84,165.96,Incoming
81087182,2023-02-14,1260.1799999999998,153.66,Outgoing
81099534,2023-01-31,216.8,,-
81099534,2023-02-01,316.48,99.68,Incoming
81099534,2023-02-04,178.44000000000003,138.04,Outgoing
81099534,2023-02-11,110.30000000000003,68.14,Outgoing
81099534,2023-02-14,227.53000000000003,117.23,Incoming
81145048,2023-01-31,290.02,,-
81145048,2023-02-02,405.07,115.05,Incoming
81145048,2023-02-03,536.61,131.54,Incoming
81145048,2023-02-05,-323.28999999999996,859.9,Outgoing
81145048,2023-02-06,-375.06999999999994,51.78,Outgoing
81145048,2023-02-09,523.1300000000001,898.2,Incoming
81145048,2023-02-12,622.5400000000001,99.41,Incoming
81145048,2023-02-12,793.2500000000001,170.71,Incoming
81159651,2023-01-31,466.71,,-
81159651,2023-02-02,511.27,44.56,Incoming
81159651,2023-02-05,384.76,126.51,Outgoing
81159651,2023-02-07,329.48,55.28,Outgoing
81159651,2023-02-08,461.58000000000004,132.1,Incoming
81159651,2023-02-09,529.57,67.99,Incoming
81159651,2023-02-12,639.1700000000001,109.6,Incoming
81159651,2023-02-13,201.67000000000007,437.5,Outgoing
81159651,2023-02-14,243.86000000000007,42.19,Incoming
81181209,2023-01-31,828.91,,-
81181209,2023-02-02,887.14,58.23,Incoming
81181209,2023-02-09,705.37,181.77,Outgoing
81181209,2023-02-09,586.67,118.7,Outgoing
81181209,2023-02-09,579.2299999999999,7.44,Outgoing
81181209,2023-02-10,-631.07,1210.3,Outgoing
81181209,2023-02-11,-526.72,104.35,Incoming
81191580,2023-01-31,584.56,,-
81191580,2023-02-06,599.1099999999999,14.55,Incoming
81191580,2023-02-10,744.6399999999999,145.53,Incoming
81191580,2023-02-12,601.5399999999998,143.1,Outgoing
81191580,2023-02-12,524.6099999999999,76.93,Outgoing
81191580,2023-02-14,659.9699999999999,135.36,Incoming
81200849,2023-01-31,479.29,,-
81200849,2023-02-03,346.76,132.53,Outgoing
81200849,2023-02-06,446.07,99.31,Incoming
81200849,2023-02-06,382.74,63.33,Outgoing
81200849,2023-02-07,459.09000000000003,76.35,Incoming
81200849,2023-02-08,449.11,9.98,Outgoing
81200849,2023-02-11,430.72,18.39,Outgoing
81200849,2023-02-12,596.14,165.42,Incoming
81206535,2023-01-31,452.69,,-
81206535,2023-02-05,368.28999999999996,84.4,Outgoing
81206535,2023-02-05,338.53999999999996,29.75,Outgoing
81206535,2023-02-05,220.75999999999996,117.78,Outgoing
81206535,2023-02-08,178.16999999999996,42.59,Outgoing
81206535,2023-02-09,201.09999999999997,22.93,Incoming
81206535,2023-02-10,10.20999999999998,190.89,Outgoing
81206535,2023-02-13,-37.33000000000002,47.54,Outgoing
81206535,2023-02-14,798.67,836.0,Incoming
81227009,2023-01-31,475.45,,-
81227009,2023-02-01,508.94,33.49,Incoming
81227009,2023-02-01,413.11,95.83,Outgoing
81227009,2023-02-03,322.47,90.64,Outgoing
81227009,2023-02-03,381.75,59.28,Incoming
81227009,2023-02-07,289.83,91.92,Outgoing
81227009,2023-02-10,145.49999999999997,144.33,Outgoing
81227009,2023-02-11,70.37999999999997,75.12,Outgoing
81227009,2023-02-11,109.76999999999997,39.39,Incoming
81227009,2023-02-12,-432.13,541.9,Outgoing
81227009,2023-02-12,-576.3199999999999,144.19,Outgoing
81227009,2023-02-13,-439.91999999999996,136.4,Incoming
81227009,2023-02-14,-328.77,111.15,Incoming
81227009,2023-02-14,-379.42999999999995,50.66,Outgoing
81245588,2023-01-31,775.87,,-
81245588,2023-02-05,861.79,85.92,Incoming
81245588,2023-02-10,778.28,83.51,Outgoing
81245588,2023-02-10,898.67,120.39,Incoming
81245588,2023-02-13,828.9399999999999,69.73,Outgoing
81245588,2023-02-14,692.2099999999999,136.73,Outgoing
81267006,2023-01-31,425.16,,-
81267006,2023-02-02,256.49,168.67,Outgoing
81267006,2023-02-03,325.75,69.26,Incoming
81267006,2023-02-05,217.95,107.8,Outgoing
81267006,2023-02-10,353.84,135.89,Incoming
81267006,2023-02-10,-1076.76,1430.6,Outgoing
81336389,2023-01-31,210.06,,-
81336389,2023-02-01,90.56,119.5,Outgoing
81336389,2023-02-03,13.200000000000003,77.36,Outgoing
81336389,2023-02-03,201.67000000000002,188.47,Incoming
81336389,2023-02-05,308.21000000000004,106.54,Incoming
81336389,2023-02-06,417.73,109.52,Incoming
81336389,2023-02-09,333.74,83.99,Outgoing
81336389,2023-02-10,549.82,216.08,Incoming
81336389,2023-02-13,450.28000000000003,99.54,Outgoing
81336389,2023-02-13,600.19,149.91,Incoming
81336468,2023-01-31,935.41,,-
81336468,2023-02-02,127.50999999999999,807.9,Outgoing
81336468,2023-02-02,-652.39,779.9,Outgoing
81336468,2023-02-02,675.11,1327.5,Incoming
81336468,2023-02-02,1338.71,663.6,Incoming
81336468,2023-02-05,1300.73,37.98,Outgoing
81336468,2023-02-06,1224.96,75.77,Outgoing
81336468,2023-02-07,1097.4,127.56,Outgoing
81336468,2023-02-09,951.3800000000001,146.02,Outgoing
81336468,2023-02-09,796.4000000000001,154.98,Outgoing
81337623,2023-01-31,815.36,,-
81337623,2023-02-04,1000.99,185.63,Incoming
81337623,2023-02-07,817.55,183.44,Outgoing
81337623,2023-02-10,715.99,101.56,Outgoing
81337623,2023-02-10,548.86,167.13,Outgoing
81337623,2023-02-12,575.21,26.35,Incoming
81337623,2023-02-14,505.70000000000005,69.51,Outgoing
81340143,2023-01-31,647.34,,-
81340143,2023-02-05,543.98,103.36,Outgoing
81340143,2023-02-09,1226.58,682.6,Incoming
81340143,2023-02-11,1273.96,47.38,Incoming
81384411,2023-01-31,175.86,,-
81384411,2023-02-03,1.5500000000000114,174.31,Outgoing
81384411,2023-02-04,1362.55,1361.0,Incoming
81384411,2023-02-10,1426.4199999999998,63.87,Incoming
81384411,2023-02-11,1631.86,205.44,Incoming
81384411,2023-02-11,1564.6499999999999,67.21,Outgoing
81384411,2023-02-12,1678.9199999999998,114.27,Incoming
81398388,2023-01-31,979.87,,-
81398388,2023-02-02,858.94,120.93,Outgoing
81398388,2023-02-02,843.0100000000001,15.93,Outgoing
81398388,2023-02-09,958.5100000000001,115.5,Incoming
81398388,2023-02-10,1056.39,97.88,Incoming
81398388,2023-02-13,1100.26,43.87,Incoming
81445756,2023-01-31,267.66,,-
81445756,2023-02-03,1521.46,1253.8,Incoming
81445756,2023-02-04,1631.46,110.0,Incoming
81475774,2023-01-31,568.11,,-
81475774,2023-02-03,724.31,156.2,Incoming
81475774,2023-02-04,634.3399999999999,89.97,Outgoing
81475774,2023-02-04,-424.76,1059.1,Outgoing
81475774,2023-02-07,-543.68,118.92,Outgoing
81475774,2023-02-10,-484.88999999999993,58.79,Incoming
81475774,2023-02-12,-287.90999999999997,196.98,Incoming
81475774,2023-02-13,-221.36999999999995,66.54,Incoming
81527490,2023-01-31,234.05,,-
81527490,2023-02-01,336.66,102.61,Incoming
81527490,2023-02-02,227.99,108.67,Outgoing
81527490,2023-02-05,92.4,135.59,Outgoing
81527490,2023-02-06,91.26,1.14,Outgoing
81527490,2023-02-07,21.320000000000007,69.94,Outgoing
81527490,2023-02-07,38.900000000000006,17.58,Incoming
81527490,2023-02-09,293.82,254.92,Incoming
81527490,2023-02-09,475.59000000000003,181.77,Incoming
81527490,2023-02-12,300.6700000000001,174.92,Outgoing
81527490,2023-02-13,200.62000000000006,100.05,Outgoing
81527490,2023-02-13,316.06000000000006,115.44,Incoming
81561788,2023-01-31,454.89,,-
81561788,2023-02-02,1561.79,1106.9,Incoming
81561788,2023-02-05,739.99,821.8,Outgoing
81561788,2023-02-05,834.44,94.45,Incoming
81561788,2023-02-06,785.99,48.45,Outgoing
81561788,2023-02-07,689.06,96.93,Outgoing
81561788,2023-02-08,604.05,85.01,Outgoing
81561788,2023-02-09,713.3699999999999,109.32,Incoming
81561788,2023-02-11,-1064.43,1777.8,Outgoing
81561788,2023-02-11,-1185.76,121.33,Outgoing
81590655,2023-01-31,742.17,,-
81590655,2023-02-04,687.8299999999999,54.34,Outgoing
81590655,2023-02-05,584.8299999999999,103.0,Outgoing
81590655,2023-02-09,639.18,54.35,Incoming
81590655,2023-02-10,-73.0200000000001,712.2,Outgoing
81646873,2023-01-31,188.36,,-
81646873,2023-02-02,283.56,95.2,Incoming
81646873,2023-02-03,346.15,62.59,Incoming
81646873,2023-02-04,267.21999999999997,78.93,Outgoing
81646873,2023-02-06,177.58999999999997,89.63,Outgoing
81646873,2023-02-07,95.62999999999998,81.96,Outgoing
81646873,2023-02-09,256.65,161.02,Incoming
81646873,2023-02-09,246.2,10.45,Outgoing
81646873,2023-02-10,-433.59999999999997,679.8,Outgoing
81646873,2023-02-13,-333.09999999999997,100.5,Incoming
81651344,2023-01-31,219.55,,-
81651344,2023-02-06,64.18,155.37,Outgoing
81651344,2023-02-08,156.56,92.38,Incoming
81651344,2023-02-09,234.72,78.16,Incoming
81655495,2023-01-31,315.33,,-
81655495,2023-02-01,1455.03,1139.7,Incoming
81655495,2023-02-02,2546.23,1091.2,Incoming
81655495,2023-02-03,2457.09,89.14,Outgoing
81655495,2023-02-06,2265.84,191.25,Outgoing
81655495,2023-02-14,2347.05,81.21,Incoming
81662619,2023-01-31,712.33,,-
81662619,2023-02-01,850.23,137.9,Incoming
81662619,2023-02-06,767.72,82.51,Outgoing
81662619,2023-02-07,614.76,152.96,Outgoing
81662619,2023-02-10,649.75,34.99,Incoming
81662619,2023-02-12,759.64,109.89,Incoming
81662619,2023-02-14,618.43,141.21,Outgoing
81727860,2023-01-31,192.44,,-
81727860,2023-02-05,291.69,99.25,Incoming
81727860,2023-02-08,215.04,76.65,Outgoing
81727860,2023-02-09,408.82,193.78,Incoming
81740267,2023-01-31,67.86,,-
81740267,2023-02-02,-42.519999999999996,110.38,Outgoing
81740267,2023-02-06,-124.05,81.53,Outgoing
81740267,2023-02-06,-13.959999999999994,110.09,Incoming
81823420,2023-01-31,259.73,,-
81823420,2023-02-01,157.63000000000002,102.1,Outgoing
81823420,2023-02-04,-43.51999999999998,201.15,Outgoing
81823420,2023-02-06,5.950000000000017,49.47,Incoming
81823420,2023-02-10,-2.339999999999982,8.29,Outgoing
81823420,2023-02-11,-40.58999999999998,38.25,Outgoing
81855175,2023-01-31,907.59,,-
81855175,2023-02-01,956.96,49.37,Incoming
81855175,2023-02-01,999.3000000000001,42.34,Incoming
81855175,2023-02-02,924.19,75.11,Outgoing
81855175,2023-02-03,821.7,102.49,Outgoing
81855175,2023-02-09,1714.1,892.4,Incoming
81855175,2023-02-10,1804.3,90.2,Incoming
81855175,2023-02-12,3605.7,1801.4,Incoming
81855175,2023-02-14,3638.66,32.96,Incoming
81923993,2023-01-31,686.37,,-
81923993,2023-02-05,1323.67,637.3,Incoming
81923993,2023-02-10,1295.95,27.72,Outgoing
81923993,2023-02-11,1153.23,142.72,Outgoing
81923993,2023-02-11,1023.15,130.08,Outgoing
81923993,2023-02-12,1204.56,181.41,Incoming
81923993,2023-02-14,663.56,541.0,Outgoing
81932657,2023-01-31,146.81,,-
81932657,2023-02-01,66.11,80.7,Outgoing
81932657,2023-02-01,8.11,58.0,Outgoing
81932657,2023-02-08,-1036.5900000000001,1044.7,Outgoing
81932657,2023-02-09,-1031.9800000000002,4.61,Incoming
81932657,2023-02-12,-952.8600000000002,79.12,Incoming
81994568,2023-01-31,578.86,,-
81994568,2023-02-03,531.08,47.78,Outgoing
81994568,2023-02-03,551.51,20.43,Incoming
81994568,2023-02-04,-958.99,1510.5,Outgoing
81994568,2023-02-06,-1017.83,58.84,Outgoing
81994568,2023-02-10,-941.84,75.99,Incoming
81994568,2023-02-10,-2405.44,1463.6,Outgoing
81994568,2023-02-10,-2436.05,30.61,Outgoing
82002852,2023-01-31,816.53,,-
82002852,2023-02-04,668.18,148.35,Outgoing
82002852,2023-02-06,717.39,49.21,Incoming
82002852,2023-02-09,778.52,61.13,Incoming
82002852,2023-02-12,897.55,119.03,Incoming
82023979,2023-01-31,744.37,,-
82023979,2023-02-02,1763.87,1019.5,Incoming
82023979,2023-02-03,1659.25,104.62,Outgoing
82023979,2023-02-10,1766.65,107.4,Incoming
82027257,2023-01-31,681.1,,-
82027257,2023-02-02,551.33,129.77,Outgoing
82027257,2023-02-07,669.52,118.19,Incoming
82027257,2023-02-11,854.18,184.66,Incoming
82027257,2023-02-11,731.99,122.19,Outgoing
82027257,2023-02-11,584.45,147.54,Outgoing
82027257,2023-02-12,739.27,154.82,Incoming
82027257,2023-02-13,650.48,88.79,Outgoing
82027257,2023-02-13,724.78,74.3,Incoming
82043720,2023-01-31,803.68,,-
82043720,2023-02-01,750.78,52.9,Outgoing
82043720,2023-02-04,869.12,118.34,Incoming
82043720,2023-02-08,749.61,119.51,Outgoing
82043720,2023-02-10,811.76,62.15,Incoming
82043720,2023-02-12,715.49,96.27,Outgoing
82101740,2023-01-31,469.34,,-
82101740,2023-02-01,541.53,72.19,Incoming
82101740,2023-02-02,473.32,68.21,Outgoing
82101740,2023-02-11,443.18,30.14,Outgoing
82101740,2023-02-12,596.59,153.41,Incoming
82101740,2023-02-13,640.12,43.53,Incoming
82115900,2023-01-31,446.89,,-
82115900,2023-02-14,-861.7099999999999,1308.6,Outgoing
82177278,2023-01-31,236.32,,-
82177278,2023-02-02,-687.6800000000001,924.0,Outgoing
82177278,2023-02-02,-564.6600000000001,123.02,Incoming
82177278,2023-02-08,-458.99000000000007,105.67,Incoming
82177278,2023-02-09,-554.7500000000001,95.76,Outgoing
82177278,2023-02-10,-630.7300000000001,75.98,Outgoing
82177278,2023-02-11,-566.0300000000001,64.7,Incoming
82177278,2023-02-12,-435.2400000000001,130.79,Incoming
82177278,2023-02-13,-311.5500000000001,123.69,Incoming
82177278,2023-02-14,-503.07000000000016,191.52,Outgoing
82188502,2023-01-31,788.02,,-
82188502,2023-02-01,721.8299999999999,66.19,Outgoing
82188502,2023-02-01,818.03,96.2,Incoming
82188502,2023-02-02,708.73,109.3,Outgoing
82188502,2023-02-03,663.32,45.41,Outgoing
82188502,2023-02-09,790.7,127.38,Incoming
82188502,2023-02-09,900.58,109.88,Incoming
82188502,2023-02-10,790.1700000000001,110.41,Outgoing
82188502,2023-02-10,863.5600000000001,73.39,Incoming
82233451,2023-01-31,795.71,,-
82233451,2023-02-01,698.34,97.37,Outgoing
82233451,2023-02-05,866.19,167.85,Incoming
82233451,2023-02-13,710.75,155.44,Outgoing
82259327,2023-01-31,982.72,,-
82259327,2023-02-03,1117.07,134.35,Incoming
82259327,2023-02-04,2061.5699999999997,944.5,Incoming
82259327,2023-02-05,597.9699999999998,1463.6,Outgoing
82259327,2023-02-07,485.8599999999998,112.11,Outgoing
82259327,2023-02-07,439.0499999999998,46.81,Outgoing
82259327,2023-02-09,331.4199999999998,107.63,Outgoing
82259327,2023-02-10,426.25999999999976,94.84,Incoming
82263080,2023-01-31,928.54,,-
82263080,2023-02-03,1109.06,180.52,Incoming
82263080,2023-02-04,1010.54,98.52,Outgoing
82263080,2023-02-11,228.33999999999992,782.2,Outgoing
82263080,2023-02-12,94.66999999999993,133.67,Outgoing
82263080,2023-02-13,154.35999999999993,59.69,Incoming
82283956,2023-01-31,745.72,,-
82283956,2023-02-01,904.64,158.92,Incoming
82283956,2023-02-02,846.41,58.23,Outgoing
82283956,2023-02-03,1196.01,349.6,Incoming
82303710,2023-01-31,619.98,,-
82303710,2023-02-03,517.13,102.85,Outgoing
82303710,2023-02-10,404.52,112.61,Outgoing
82303710,2023-02-14,496.21999999999997,91.7,Incoming
82303710,2023-02-14,288.21999999999997,208.0,Outgoing
82303710,2023-02-14,1962.22,1674.0,Incoming
82314789,2023-01-31,735.77,,-
82314789,2023-02-01,682.68,53.09,Outgoing
82314789,2023-02-04,770.03,87.35,Incoming
82314789,2023-02-06,615.02,155.01,Outgoing
82314789,2023-02-09,1955.12,1340.1,Incoming
82314789,2023-02-13,2030.9299999999998,75.81,Incoming
82424659,2023-01-31,568.77,,-
82424659,2023-02-02,511.83,56.94,Outgoing
82424659,2023-02-05,698.0,186.17,Incoming
82424659,2023-02-09,785.15,87.15,Incoming
82424659,2023-02-09,644.54,140.61,Outgoing
82424659,2023-02-12,493.05999999999995,151.48,Outgoing
82424659,2023-02-13,471.3299999999999,21.73,Outgoing
82461559,2023-01-31,652.26,,-
82461559,2023-02-03,750.64,98.38,Incoming
82461559,2023-02-07,633.56,117.08,Outgoing
82461559,2023-02-07,750.64,117.08,Incoming
82461559,2023-02-08,665.5699999999999,85.07,Outgoing
82461559,2023-02-09,672.52,6.95,Incoming
82461559,2023-02-12,635.38,37.14,Outgoing
82461559,2023-02-13,803.14,167.76,Incoming
82461559,2023-02-14,921.89,118.75,Incoming
82543932,2023-01-31,279.1,,-
82543932,2023-02-03,383.88,104.78,Incoming
82543932,2023-02-05,212.98,170.9,Outgoing
82543932,2023-02-05,380.15999999999997,167.18,Incoming
82543932,2023-02-10,478.60999999999996,98.45,Incoming
82543932,2023-02-12,665.8199999999999,187.21,Incoming
82558079,2023-01-31,381.22,,-
82558079,2023-02-02,275.17,106.05,Outgoing
82558079,2023-02-07,340.62,65.45,Incoming
82558079,2023-02-12,313.72,26.9,Outgoing
82558079,2023-02-13,390.82000000000005,77.1,Incoming
82558079,2023-02-13,445.4100000000001,54.59,Incoming
82568859,2023-01-31,32.21,,-
82568859,2023-02-03,-4.789999999999999,37.0,Outgoing
82568859,2023-02-03,-436.99,432.2,Outgoing
82568859,2023-02-05,-524.65,87.66,Outgoing
82568859,2023-02-06,-422.54999999999995,102.1,Incoming
82568859,2023-02-10,-533.17,110.62,Outgoing
82589836,2023-01-31,648.06,,-
82589836,2023-02-02,687.1899999999999,39.13,Incoming
82589836,2023-02-03,479.28,207.91,Outgoing
82589836,2023-02-08,402.02,77.26,Outgoing
82589836,2023-02-09,548.04,146.02,Incoming
82589836,2023-02-13,661.0799999999999,113.04,Incoming
82589836,2023-02-13,798.7099999999999,137.63,Incoming
82696309,2023-01-31,352.08,,-
82696309,2023-02-01,261.17999999999995,90.9,Outgoing
82696309,2023-02-11,376.15,114.97,Incoming
82696309,2023-02-13,439.28999999999996,63.14,Incoming
82734145,2023-01-31,278.57,,-
82734145,2023-02-02,92.82999999999998,185.74,Outgoing
82734145,2023-02-07,-32.030000000000015,124.86,Outgoing
82734145,2023-02-09,62.02999999999999,94.06,Incoming
82734145,2023-02-12,147.07,85.04,Incoming
82734145,2023-02-13,61.22999999999999,85.84,Outgoing
82734145,2023-02-13,-55.290000000000006,116.52,Outgoing
82734145,2023-02-13,-705.79,650.5,Outgoing
82764940,2023-01-31,876.37,,-
82764940,2023-02-01,834.03,42.34,Outgoing
82764940,2023-02-02,934.49,100.46,Incoming
82764940,2023-02-02,-182.51,1117.0,Outgoing
82764940,2023-02-10,1398.39,1580.9,Incoming
82764940,2023-02-12,1271.2600000000002,127.13,Outgoing
82764940,2023-02-12,1118.2100000000003,153.05,Outgoing
82764940,2023-02-14,936.1100000000002,182.1,Outgoing
82776251,2023-01-31,747.11,,-
82776251,2023-02-01,655.34,91.77,Outgoing
82776251,2023-02-03,531.96,123.38,Outgoing
82776251,2023-02-04,1847.16,1315.2,Incoming
82776251,2023-02-11,1645.01,202.15,Outgoing
82807528,2023-01-31,117.15,,-
82807528,2023-02-02,226.72,109.57,Incoming
82807528,2023-02-02,98.69,128.03,Outgoing
82807528,2023-02-03,19.00999999999999,79.68,Outgoing
82807528,2023-02-09,37.91999999999999,18.91,Incoming
82807528,2023-02-13,83.01999999999998,45.1,Incoming
82807528,2023-02-14,196.53999999999996,113.52,Incoming
82807528,2023-02-14,268.41999999999996,71.88,Incoming
82879607,2023-01-31,72.18,,-
82879607,2023-02-06,243.47,171.29,Incoming
82879607,2023-02-08,141.36,102.11,Outgoing
82879607,2023-02-11,-23.00999999999999,164.37,Outgoing
82879607,2023-02-12,86.79,109.8,Incoming
82879607,2023-02-13,10.980000000000004,75.81,Outgoing
82879607,2023-02-14,128.22,117.24,Incoming
82911152,2023-01-31,564.11,,-
82911152,2023-02-02,632.69,68.58,Incoming
82911152,2023-02-02,523.6300000000001,109.06,Outgoing
82911152,2023-02-11,480.73000000000013,42.9,Outgoing
82911152,2023-02-11,1584.73,1104.0,Incoming
82911152,2023-02-11,1466.54,118.19,Outgoing
82911152,2023-02-13,1635.77,169.23,Incoming
82911152,2023-02-14,1792.56,156.79,Incoming
82920281,2023-01-31,41.13,,-
82920281,2023-02-02,-53.07,94.2,Outgoing
82920281,2023-02-03,1738.53,1791.6,Incoming
82920281,2023-02-06,2282.43,543.9,Incoming
82920281,2023-02-10,2167.71,114.72,Outgoing
82927034,2023-01-31,435.71,,-
82927034,2023-02-03,567.5799999999999,131.87,Incoming
82927034,2023-02-04,503.74999999999994,63.83,Outgoing
82927034,2023-02-08,570.68,66.93,Incoming
82927034,2023-02-09,484.67999999999995,86.0,Outgoing
82927034,2023-02-11,601.14,116.46,Incoming
82927034,2023-02-14,501.93,99.21,Outgoing
82930132,2023-01-31,131.87,,-
82930132,2023-02-03,-43.81,175.68,Outgoing
82930132,2023-02-03,-235.89000000000001,192.08,Outgoing
82930132,2023-02-04,-304.94,69.05,Outgoing
82930132,2023-02-05,-424.82,119.88,Outgoing
82930132,2023-02-06,-319.01,105.81,Incoming
82930132,2023-02-11,-181.14999999999998,137.86,Incoming
82930132,2023-02-12,-182.08999999999997,0.94,Outgoing
83003822,2023-01-31,286.54,,-
83003822,2023-02-03,429.96000000000004,143.42,Incoming
83003822,2023-02-10,1860.56,1430.6,Incoming
83003822,2023-02-11,1960.49,99.93,Incoming
83056011,2023-01-31,968.4,,-
83056011,2023-02-03,839.02,129.38,Outgoing
83056011,2023-02-08,670.88,168.14,Outgoing
83056011,2023-02-11,737.27,66.39,Incoming
83067540,2023-01-31,258.33,,-
83067540,2023-02-03,295.33,37.0,Incoming
83067540,2023-02-03,406.33,111.0,Incoming
83067540,2023-02-06,-537.8700000000001,944.2,Outgoing
83067540,2023-02-11,-671.5400000000001,133.67,Outgoing
83081615,2023-01-31,301.32,,-
83081615,2023-02-02,159.35,141.97,Outgoing
83081615,2023-02-04,117.57999999999998,41.77,Outgoing
83081615,2023-02-05,3.759999999999991,113.82,Outgoing
83081615,2023-02-07,-136.20000000000002,139.96,Outgoing
83081615,2023-02-11,-203.23000000000002,67.03,Outgoing
83124388,2023-01-31,504.59,,-
83124388,2023-02-02,403.12,101.47,Outgoing
83124388,2023-02-03,309.05,94.07,Outgoing
83124388,2023-02-04,211.24,97.81,Outgoing
83124388,2023-02-09,275.71000000000004,64.47,Incoming
83124388,2023-02-09,321.79,46.08,Incoming
83124388,2023-02-14,393.20000000000005,71.41,Incoming
83128181,2023-01-31,816.12,,-
83128181,2023-02-01,913.48,97.36,Incoming
83128181,2023-02-03,830.77,82.71,Outgoing
83128181,2023-02-07,697.86,132.91,Outgoing
83128181,2023-02-09,2023.56,1325.7,Incoming
83128181,2023-02-12,3705.46,1681.9,Incoming
83128544,2023-01-31,25.71,,-
83128544,2023-02-05,4.039999999999999,21.67,Outgoing
83128544,2023-02-07,-177.07000000000002,181.11,Outgoing
83128544,2023-02-07,-178.10000000000002,1.03,Outgoing
83128544,2023-02-07,-24.940000000000026,153.16,Incoming
83128544,2023-02-08,103.58999999999997,128.53,Incoming
83128544,2023-02-13,235.89,132.3,Incoming
83128544,2023-02-14,150.21999999999997,85.67,Outgoing
83166098,2023-01-31,827.81,,-
83166098,2023-02-01,944.52,116.71,Incoming
83166098,2023-02-06,1080.33,135.81,Incoming
83166098,2023-02-07,980.4599999999999,99.87,Outgoing
83166098,2023-02-07,1027.3799999999999,46.92,Incoming
83166098,2023-02-08,1198.36,170.98,Incoming
83166098,2023-02-10,208.55999999999995,989.8,Outgoing
83166098,2023-02-11,319.11999999999995,110.56,Incoming
83166098,2023-02-13,484.93999999999994,165.82,Incoming
83166098,2023-02-13,447.10999999999996,37.83,Outgoing
83187508,2023-01-31,714.42,,-
83187508,2023-02-01,583.6199999999999,130.8,Outgoing
83187508,2023-02-05,548.1799999999998,35.44,Outgoing
83187508,2023-02-05,633.9599999999998,85.78,Incoming
83187508,2023-02-06,527.9299999999998,106.03,Outgoing
83187508,2023-02-06,437.14999999999986,90.78,Outgoing
83187508,2023-02-08,563.1799999999998,126.03,Incoming
83187508,2023-02-09,497.79999999999984,65.38,Outgoing
83187508,2023-02-09,620.5899999999998,122.79,Incoming
83187508,2023-02-10,-427.61000000000024,1048.2,Outgoing
83187508,2023-02-11,-269.2600000000002,158.35,Incoming
83187508,2023-02-13,-1476.8600000000001,1207.6,Outgoing
83187508,2023-02-14,-1335.89,140.97,Incoming
83191889,2023-01-31,344.33,,-
83191889,2023-02-02,435.87,91.54,Incoming
83191889,2023-02-02,550.99,115.12,Incoming
83191889,2023-02-02,652.14,101.15,Incoming
83191889,2023-02-04,254.03999999999996,398.1,Outgoing
83191889,2023-02-10,342.76,88.72,Incoming
83191889,2023-02-10,252.02999999999997,90.73,Outgoing
83191889,2023-02-12,81.59999999999997,170.43,Outgoing
83191889,2023-02-13,-47.180000000000035,128.78,Outgoing
83202693,2023-01-31,165.41,,-
83202693,2023-02-02,80.24,85.17,Outgoing
83202693,2023-02-03,276.15,195.91,Incoming
83202693,2023-02-07,612.3499999999999,336.2,Incoming
83202693,2023-02-09,482.7799999999999,129.57,Outgoing
83202693,2023-02-11,389.2499999999999,93.53,Outgoing
83202693,2023-02-13,422.2899999999999,33.04,Incoming
83281565,2023-01-31,968.83,,-
83281565,2023-02-06,899.95,68.88,Outgoing
83281565,2023-02-08,1046.45,146.5,Incoming
83281565,2023-02-08,1070.24,23.79,Incoming
83281565,2023-02-08,1196.35,126.11,Incoming
83281565,2023-02-09,1046.12,150.23,Outgoing
83281565,2023-02-12,1221.04,174.92,Incoming
83281565,2023-02-13,1114.07,106.97,Outgoing
83281565,2023-02-14,989.31,124.76,Outgoing
83302154,2023-01-31,465.25,,-
83302154,2023-02-02,575.6,110.35,Incoming
83302154,2023-02-03,1511.9,936.3,Incoming
83302154,2023-02-04,913.5000000000001,598.4,Outgoing
83302154,2023-02-04,840.5300000000001,72.97,Outgoing
83302154,2023-02-06,982.07,141.54,Incoming
83302154,2023-02-10,775.2,206.87,Outgoing
83302154,2023-02-13,942.1800000000001,166.98,Incoming
83443439,2023-01-31,97.61,,-
83443439,2023-02-03,-1120.39,1218.0,Outgoing
83443439,2023-02-03,-1116.3700000000001,4.02,Incoming
83443439,2023-02-04,-1021.2400000000001,95.13,Incoming
83443439,2023-02-05,-918.2400000000001,103.0,Incoming
83443439,2023-02-06,-862.9400000000002,55.3,Incoming
83443439,2023-02-10,-1079.0200000000002,216.08,Outgoing
83443439,2023-02-10,-1196.1200000000001,117.1,Outgoing
83443439,2023-02-13,-1310.9,114.78,Outgoing
83475318,2023-01-31,228.96,,-
83475318,2023-02-01,324.79,95.83,Incoming
83475318,2023-02-12,245.72000000000003,79.07,Outgoing
83475318,2023-02-14,353.43,107.71,Incoming
83530155,2023-01-31,638.57,,-
83530155,2023-02-02,697.22,58.65,Incoming
83530155,2023-02-10,833.53,136.31,Incoming
83530155,2023-02-12,1840.03,1006.5,Incoming
83530155,2023-02-12,1851.81,11.78,Incoming
83530155,2023-02-13,1771.21,80.6,Outgoing
83530541,2023-01-31,630.6,,-
83530541,2023-02-07,597.25,33.35,Outgoing
83530541,2023-02-08,1913.65,1316.4,Incoming
83530541,2023-02-13,2011.63,97.98,Incoming
83531401,2023-01-31,445.24,,-
83531401,2023-02-09,456.91,11.67,Incoming
83531401,2023-02-10,333.72,123.19,Outgoing
83531401,2023-02-12,266.07000000000005,67.65,Outgoing
83539050,2023-01-31,172.33,,-
83539050,2023-02-09,108.30000000000001,64.03,Outgoing
83539050,2023-02-09,246.49,138.19,Incoming
83539050,2023-02-14,131.95,114.54,Outgoing
83557419,2023-01-31,374.69,,-
83557419,2023-02-03,490.4,115.71,Incoming
83557419,2023-02-05,589.3,98.9,Incoming
83557419,2023-02-13,395.0899999999999,194.21,Outgoing
83565726,2023-01-31,910.38,,-
83565726,2023-02-02,1702.38,792.0,Incoming
83565726,2023-02-02,1792.8700000000001,90.49,Incoming
83565726,2023-02-03,1861.3000000000002,68.43,Incoming
83565726,2023-02-07,1948.8200000000002,87.52,Incoming
83565726,2023-02-07,1786.5900000000001,162.23,Outgoing
83565726,2023-02-11,832.1900000000002,954.4,Outgoing
83565726,2023-02-12,713.1000000000001,119.09,Outgoing
83565726,2023-02-12,612.3600000000001,100.74,Outgoing
83565726,2023-02-13,1571.96,959.6,Incoming
83573848,2023-01-31,818.5,,-
83573848,2023-02-01,913.06,94.56,Incoming
83573848,2023-02-02,779.9699999999999,133.09,Outgoing
83573848,2023-02-02,656.0199999999999,123.95,Outgoing
83573848,2023-02-05,826.9199999999998,170.9,Incoming
83573848,2023-02-09,952.5899999999998,125.67,Incoming
83573848,2023-02-09,758.8099999999998,193.78,Outgoing
83573848,2023-02-10,674.9199999999998,83.89,Outgoing
83639740,2023-01-31,266.62,,-
83639740,2023-02-02,138.32,128.3,Outgoing
83639740,2023-02-02,32.8,105.52,Outgoing
83639740,2023-02-03,-5.340000000000003,38.14,Outgoing
83639740,2023-02-09,-593.24,587.9,Outgoing
83639740,2023-02-11,-793.82,200.58,Outgoing
83659554,2023-01-31,548.94,,-
83659554,2023-02-08,-988.1599999999999,1537.1,Outgoing
83659554,2023-02-12,-1048.4599999999998,60.3,Outgoing
83659554,2023-02-12,-904.2699999999998,144.19,Incoming
83668302,2023-01-31,686.96,,-
83668302,2023-02-03,733.25,46.29,Incoming
83668302,2023-02-07,744.62,11.37,Incoming
83668302,2023-02-12,773.23,28.61,Incoming
83668302,2023-02-12,736.9,36.33,Outgoing
83668302,2023-02-12,946.88,209.98,Incoming
83672404,2023-01-31,269.57,,-
83672404,2023-02-01,105.50999999999999,164.06,Outgoing
83672404,2023-02-02,236.53,131.02,Incoming
83672404,2023-02-04,386.53999999999996,150.01,Incoming
83672404,2023-02-04,1000.54,614.0,Incoming
83672404,2023-02-07,1111.62,111.08,Incoming
83672404,2023-02-09,1056.1999999999998,55.42,Outgoing
83672404,2023-02-09,980.7399999999998,75.46,Outgoing
83693383,2023-01-31,138.05,,-
83693383,2023-02-02,195.56,57.51,Incoming
83693383,2023-02-07,1100.86,905.3,Incoming
83693383,2023-02-07,1267.73,166.87,Incoming
83693383,2023-02-07,1305.77,38.04,Incoming
83693383,2023-02-08,1116.06,189.71,Outgoing
83693383,2023-02-10,1049.05,67.01,Outgoing
83693383,2023-02-14,984.16,64.89,Outgoing
83693383,2023-02-14,847.67,136.49,Outgoing
83698413,2023-01-31,223.67,,-
83698413,2023-02-07,110.07,113.6,Outgoing
83698413,2023-02-09,154.26,44.19,Incoming
83698413,2023-02-12,254.26999999999998,100.01,Incoming
83698413,2023-02-13,112.80999999999997,141.46,Outgoing
83698413,2023-02-13,202.80999999999997,90.0,Incoming
83788130,2023-01-31,833.68,,-
83788130,2023-02-01,966.14,132.46,Incoming
83788130,2023-02-02,1042.28,76.14,Incoming
83788130,2023-02-03,1239.01,196.73,Incoming
83788130,2023-02-03,1375.62,136.61,Incoming
83788130,2023-02-06,1536.6499999999999,161.03,Incoming
83788130,2023-02-08,1402.4199999999998,134.23,Outgoing
83788130,2023-02-11,1332.58,69.84,Outgoing
83796561,2023-01-31,410.08,,-
83796561,2023-02-01,2649.38,2239.3,Incoming
83796561,2023-02-03,2764.54,115.16,Incoming
83796561,2023-02-04,2694.71,69.83,Outgoing
83796561,2023-02-13,2570.06,124.65,Outgoing
83796561,2023-02-14,2382.7599999999998,187.3,Outgoing
83828891,2023-01-31,780.59,,-
83828891,2023-02-05,917.19,136.6,Incoming
83828891,2023-02-05,876.7800000000001,40.41,Outgoing
83828891,2023-02-08,756.21,120.57,Outgoing
83828891,2023-02-09,808.1800000000001,51.97,Incoming
83828891,2023-02-12,724.1500000000001,84.03,Outgoing
83828891,2023-02-13,607.7800000000001,116.37,Outgoing
83828891,2023-02-14,539.1100000000001,68.67,Outgoing
83852014,2023-01-31,830.02,,-
83852014,2023-02-01,726.62,103.4,Outgoing
83852014,2023-02-04,788.5,61.88,Incoming
83852014,2023-02-04,731.01,57.49,Outgoing
83852014,2023-02-05,813.34,82.33,Incoming
83852014,2023-02-06,659.27,154.07,Outgoing
83852014,2023-02-12,743.4,84.13,Incoming
83852014,2023-02-14,706.18,37.22,Outgoing
83854141,2023-01-31,280.06,,-
83854141,2023-02-02,407.0,126.94,Incoming
83854141,2023-02-04,478.57,71.57,Incoming
83854141,2023-02-05,452.19,26.38,Outgoing
83854141,2023-02-13,343.15,109.04,Outgoing
83854141,2023-02-14,283.24,59.91,Outgoing
83891783,2023-01-31,158.08,,-
83891783,2023-02-01,302.33000000000004,144.25,Incoming
83891783,2023-02-02,430.64000000000004,128.31,Incoming
83891783,2023-02-02,414.87000000000006,15.77,Outgoing
83891783,2023-02-08,296.76000000000005,118.11,Outgoing
83891783,2023-02-09,420.38000000000005,123.62,Incoming
83891783,2023-02-13,1180.78,760.4,Incoming
83891783,2023-02-14,1147.98,32.8,Outgoing
83975923,2023-01-31,837.45,,-
83975923,2023-02-01,994.24,156.79,Incoming
83975923,2023-02-06,1062.55,68.31,Incoming
83975923,2023-02-07,1075.21,12.66,Incoming
83975923,2023-02-12,1206.55,131.34,Incoming
83981442,2023-01-31,89.35,,-
83981442,2023-02-02,-43.99000000000001,133.34,Outgoing
83981442,2023-02-02,-137.55,93.56,Outgoing
83981442,2023-02-06,1000.8500000000001,1138.4,Incoming
83981442,2023-02-07,915.2500000000001,85.6,Outgoing
84070285,2023-01-31,796.6,,-
84070285,2023-02-02,1732.7,936.1,Incoming
84070285,2023-02-04,1765.32,32.62,Incoming
84070285,2023-02-06,1605.1499999999999,160.17,Outgoing
84070285,2023-02-08,1487.62,117.53,Outgoing
84070285,2023-02-12,358.91999999999985,1128.7,Outgoing
84070285,2023-02-12,487.10999999999984,128.19,Incoming
84070285,2023-02-13,404.73999999999984,82.37,Outgoing
84070285,2023-02-13,474.28999999999985,69.55,Incoming
84070285,2023-02-13,398.51999999999987,75.77,Outgoing
84107088,2023-01-31,2.2,,-
84107088,2023-02-04,-114.45,116.65,Outgoing
84107088,2023-02-05,-219.78,105.33,Outgoing
84107088,2023-02-05,-153.86,65.92,Incoming
84107088,2023-02-07,437.34000000000003,591.2,Incoming
84107088,2023-02-09,515.37,78.03,Incoming
84107088,2023-02-09,550.39,35.02,Incoming
84187157,2023-01-31,252.9,,-
84187157,2023-02-04,377.97,125.07,Incoming
84187157,2023-02-05,193.11,184.86,Outgoing
84187157,2023-02-07,86.31000000000002,106.8,Outgoing
84187157,2023-02-09,182.67000000000002,96.36,Incoming
84187157,2023-02-14,361.13,178.46,Incoming
84187157,2023-02-14,-1124.5700000000002,1485.7,Outgoing
84188877,2023-01-31,624.29,,-
84188877,2023-02-03,519.47,104.82,Outgoing
84188877,2023-02-04,578.02,58.55,Incoming
84188877,2023-02-05,761.93,183.91,Incoming
84188877,2023-02-06,872.76,110.83,Incoming
84188877,2023-02-06,780.06,92.7,Outgoing
84188877,2023-02-09,847.9,67.84,Incoming
84188877,2023-02-09,904.02,56.12,Incoming
84188877,2023-02-10,2704.7200000000003,1800.7,Incoming
84188877,2023-02-11,2602.59,102.13,Outgoing
84188877,2023-02-11,3875.69,1273.1,Incoming
84188877,2023-02-12,3691.96,183.73,Outgoing
84275961,2023-01-31,625.24,,-
84275961,2023-02-01,487.05,138.19,Outgoing
84275961,2023-02-03,376.09000000000003,110.96,Outgoing
84275961,2023-02-03,277.68000000000006,98.41,Outgoing
84275961,2023-02-07,357.5200000000001,79.84,Incoming
84275961,2023-02-09,349.5600000000001,7.96,Outgoing
84275961,2023-02-10,532.3100000000002,182.75,Incoming
84280969,2023-01-31,161.7,,-
84280969,2023-02-02,69.22999999999999,92.47,Outgoing
84280969,2023-02-09,-34.21000000000001,103.44,Outgoing
84280969,2023-02-10,41.61999999999999,75.83,Incoming
84280969,2023-02-12,160.7,119.08,Incoming
84280969,2023-02-12,253.26,92.56,Incoming
84290934,2023-01-31,914.5,,-
84290934,2023-02-05,996.3,81.8,Incoming
84290934,2023-02-06,1063.71,67.41,Incoming
84290934,2023-02-06,1171.51,107.8,Incoming
84290934,2023-02-07,1243.03,71.52,Incoming
84290934,2023-02-09,1057.93,185.1,Outgoing
84295462,2023-01-31,154.03,,-
84295462,2023-02-01,-759.47,913.5,Outgoing
84295462,2023-02-10,-896.2,136.73,Outgoing
84295462,2023-02-10,-985.6700000000001,89.47,Outgoing
84295462,2023-02-11,-1113.74,128.07,Outgoing
84295462,2023-02-12,-1064.33,49.41,Incoming
84310867,2023-01-31,258.66,,-
84310867,2023-02-01,193.54000000000002,65.12,Outgoing
84310867,2023-02-10,337.83000000000004,144.29,Incoming
84310867,2023-02-11,233.48000000000005,104.35,Outgoing
84310867,2023-02-12,163.02000000000004,70.46,Outgoing
84310867,2023-02-12,-730.78,893.8,Outgoing
84310867,2023-02-14,564.8199999999999,1295.6,Incoming
84333228,2023-01-31,330.99,,-
84333228,2023-02-02,140.07000000000002,190.92,Outgoing
84333228,2023-02-02,215.91000000000003,75.84,Incoming
84333228,2023-02-03,101.31000000000003,114.6,Outgoing
84333228,2023-02-05,197.36,96.05,Incoming
84333228,2023-02-05,316.14,118.78,Incoming
84333228,2023-02-11,232.06,84.08,Outgoing
84334262,2023-01-31,525.57,,-
84334262,2023-02-02,431.63000000000005,93.94,Outgoing
84334262,2023-02-04,541.6800000000001,110.05,Incoming
84334262,2023-02-06,408.38000000000005,133.3,Outgoing
84334262,2023-02-11,302.72,105.66,Outgoing
84334262,2023-02-11,-107.07999999999998,409.8,Outgoing
84334262,2023-02-12,100.52000000000001,207.6,Incoming
84334262,2023-02-13,-3.7199999999999847,104.24,Outgoing
84334262,2023-02-14,198.11,201.83,Incoming
84366763,2023-01-31,734.48,,-
84366763,2023-02-02,844.9100000000001,110.43,Incoming
84366763,2023-02-05,768.6700000000001,76.24,Outgoing
84366763,2023-02-06,1239.27,470.6,Incoming
84366763,2023-02-11,1164.76,74.51,Outgoing
84366763,2023-02-11,2177.56,1012.8,Incoming
84366763,2023-02-11,2070.02,107.54,Outgoing
84375036,2023-01-31,356.1,,-
84375036,2023-02-01,241.88000000000002,114.22,Outgoing
84375036,2023-02-07,555.38,313.5,Incoming
84375036,2023-02-07,440.23,115.15,Outgoing
84375036,2023-02-08,285.08000000000004,155.15,Outgoing
84375036,2023-02-11,415.97,130.89,Incoming
84375036,2023-02-11,346.33000000000004,69.64,Outgoing
84375036,2023-02-13,-164.06999999999994,510.4,Outgoing
84396180,2023-01-31,103.83,,-
84396180,2023-02-04,49.68,54.15,Outgoing
84396180,2023-02-08,180.22,130.54,Incoming
84396180,2023-02-10,1145.02,964.8,Incoming
84396180,2023-02-10,1044.59,100.43,Outgoing
84396180,2023-02-11,1013.1899999999999,31.4,Outgoing
84396180,2023-02-13,856.8199999999999,156.37,Outgoing
84406205,2023-01-31,818.63,,-
84406205,2023-02-05,772.29,46.34,Outgoing
84406205,2023-02-08,677.9499999999999,94.34,Outgoing
84406205,2023-02-13,2505.5499999999997,1827.6,Incoming
84406205,2023-02-14,2578.49,72.94,Incoming
84411377,2023-01-31,870.25,,-
84411377,2023-02-07,757.74,112.51,Outgoing
84411377,2023-02-12,1109.3400000000001,351.6,Incoming
84411377,2023-02-13,969.5100000000001,139.83,Outgoing
84411930,2023-01-31,916.61,,-
84411930,2023-02-04,974.66,58.05,Incoming
84411930,2023-02-05,1070.5,95.84,Incoming
84411930,2023-02-05,1107.27,36.77,Incoming
84411930,2023-02-06,1159.58,52.31,Incoming
84411930,2023-02-07,1215.8999999999999,56.32,Incoming
84411930,2023-02-12,1052.07,163.83,Outgoing
84416510,2023-01-31,793.45,,-
84416510,2023-02-02,825.09,31.64,Incoming
84416510,2023-02-02,913.95,88.86,Incoming
84416510,2023-02-09,829.4000000000001,84.55,Outgoing
84416510,2023-02-11,-124.99999999999989,954.4,Outgoing
84416510,2023-02-12,-249.5899999999999,124.59,Outgoing
84416510,2023-02-13,-322.52999999999986,72.94,Outgoing
84416510,2023-02-14,82.37000000000012,404.9,Incoming
84418749,2023-01-31,457.27,,-
84418749,2023-02-01,535.74,78.47,Incoming
84418749,2023-02-01,335.34000000000003,200.4,Outgoing
84418749,2023-02-02,288.57000000000005,46.77,Outgoing
84418749,2023-02-08,397.63000000000005,109.06,Incoming
84418749,2023-02-09,280.82000000000005,116.81,Outgoing
84418749,2023-02-12,259.21000000000004,21.61,Outgoing
84418749,2023-02-13,165.82000000000005,93.39,Outgoing
84448752,2023-01-31,412.15,,-
84448752,2023-02-06,323.24,88.91,Outgoing
84448752,2023-02-06,-1086.36,1409.6,Outgoing
84448752,2023-02-08,167.24,1253.6,Incoming
84448752,2023-02-08,-1201.36,1368.6,Outgoing
84471701,2023-01-31,89.27,,-
84471701,2023-02-01,27.269999999999996,62.0,Outgoing
84471701,2023-02-02,-70.10000000000001,97.37,Outgoing
84471701,2023-02-05,-14.290000000000006,55.81,Incoming
84471701,2023-02-08,-91.52000000000001,77.23,Outgoing
84656105,2023-01-31,547.59,,-
84656105,2023-02-03,604.36,56.77,Incoming
84656105,2023-02-06,494.85,109.51,Outgoing
84656105,2023-02-06,-962.9499999999999,1457.8,Outgoing
84656105,2023-02-07,-1063.73,100.78,Outgoing
84656105,2023-02-08,-1253.01,189.28,Outgoing
84656105,2023-02-13,-1147.83,105.18,Incoming
84682032,2023-01-31,612.1,,-
84682032,2023-02-03,615.6,3.5,Incoming
84682032,2023-02-09,765.04,149.44,Incoming
84682032,2023-02-14,888.89,123.85,Incoming
84682032,2023-02-14,968.78,79.89,Incoming
84695068,2023-01-31,693.94,,-
84695068,2023-02-09,768.35,74.41,Incoming
84695068,2023-02-10,733.64,34.71,Outgoing
84695068,2023-02-12,-1030.7600000000002,1764.4,Outgoing
84695068,2023-02-13,-1020.9600000000003,9.8,Incoming
84714323,2023-01-31,667.61,,-
84714323,2023-02-03,710.9200000000001,43.31,Incoming
84714323,2023-02-04,-557.78,1268.7,Outgoing
84746166,2023-01-31,806.73,,-
84746166,2023-02-03,786.3000000000001,20.43,Outgoing
84746166,2023-02-04,762.1500000000001,24.15,Outgoing
84746166,2023-02-05,821.95,59.8,Incoming
84746166,2023-02-08,979.01,157.06,Incoming
84746166,2023-02-09,2181.91,1202.9,Incoming
84746166,2023-02-11,2213.91,32.0,Incoming
84746166,2023-02-13,2338.56,124.65,Incoming
84746166,2023-02-14,2436.59,98.03,Incoming
84778718,2023-01-31,521.14,,-
84778718,2023-02-03,483.65,37.49,Outgoing
84778718,2023-02-05,382.19,101.46,Outgoing
84778718,2023-02-09,248.76,133.43,Outgoing
84778718,2023-02-11,327.01,78.25,Incoming
84778718,2023-02-12,-856.79,1183.8,Outgoing
84778718,2023-02-13,-927.37,70.58,Outgoing
84822607,2023-01-31,425.79,,-
84822607,2023-02-02,518.95,93.16,Incoming
84822607,2023-02-03,453.80000000000007,65.15,Outgoing
84822607,2023-02-07,375.8400000000001,77.96,Outgoing
84822607,2023-02-07,585.57,209.73,Incoming
84822607,2023-02-08,451.39000000000004,134.18,Outgoing
84822607,2023-02-10,361.06000000000006,90.33,Outgoing
84853260,2023-01-31,925.31,,-
84853260,2023-02-07,1000.06,74.75,Incoming
84853260,2023-02-09,1072.36,72.3,Incoming
84853260,2023-02-13,943.5199999999999,128.84,Outgoing
84853260,2023-02-14,800.9499999999998,142.57,Outgoing
84928531,2023-01-31,236.36,,-
84928531,2023-02-01,311.45000000000005,75.09,Incoming
84928531,2023-02-04,125.44000000000005,186.01,Outgoing
84928531,2023-02-06,212.64000000000004,87.2,Incoming
84928531,2023-02-06,74.32000000000005,138.32,Outgoing
84928531,2023-02-09,143.73000000000005,69.41,Incoming
84951477,2023-01-31,316.2,,-
84951477,2023-02-02,384.37,68.17,Incoming
84951477,2023-02-03,344.47,39.9,Outgoing
84951477,2023-02-06,199.79000000000002,144.68,Outgoing
84951477,2023-02-10,25.080000000000013,174.71,Outgoing
84951477,2023-02-10,-115.97999999999999,141.06,Outgoing
84951477,2023-02-10,435.62,551.6,Incoming
84951477,2023-02-13,496.96000000000004,61.34,Incoming
84964879,2023-01-31,629.81,,-
84964879,2023-02-01,523.1299999999999,106.68,Outgoing
84964879,2023-02-03,508.0099999999999,15.12,Outgoing
84964879,2023-02-05,462.58999999999986,45.42,Outgoing
84964879,2023-02-07,-1190.71,1653.3,Outgoing
84964879,2023-02-08,-1076.73,113.98,Incoming
84964879,2023-02-11,-1017.63,59.1,Incoming
84969883,2023-01-31,672.74,,-
84969883,2023-02-02,800.87,128.13,Incoming
84969883,2023-02-03,1979.87,1179.0,Incoming
84969883,2023-02-05,1840.53,139.34,Outgoing
84969883,2023-02-12,995.53,845.0,Outgoing
84969883,2023-02-13,938.36,57.17,Outgoing
84969883,2023-02-14,1645.6599999999999,707.3,Incoming
84969883,2023-02-14,1762.9999999999998,117.34,Incoming
84995019,2023-01-31,731.41,,-
84995019,2023-02-01,820.42,89.01,Incoming
84995019,2023-02-01,946.48,126.06,Incoming
84995019,2023-02-02,1064.8,118.32,Incoming
84995019,2023-02-03,869.17,195.63,Outgoing
84995019,2023-02-03,804.74,64.43,Outgoing
84995019,2023-02-04,671.28,133.46,Outgoing
84995019,2023-02-04,736.21,64.93,Incoming
84995019,2023-02-04,253.51000000000005,482.7,Outgoing
84995019,2023-02-04,168.01000000000005,85.5,Outgoing
84995019,2023-02-05,21.80000000000004,146.21,Outgoing
84995019,2023-02-10,-126.28999999999996,148.09,Outgoing
84995019,2023-02-11,-57.179999999999964,69.11,Incoming
84995019,2023-02-14,-115.76999999999997,58.59,Outgoing
85001424,2023-01-31,653.31,,-
85001424,2023-02-01,756.99,103.68,Incoming
85001424,2023-02-06,839.5,82.51,Incoming
85001424,2023-02-09,965.7,126.2,Incoming
85001424,2023-02-11,815.86,149.84,Outgoing
85001424,2023-02-11,923.37,107.51,Incoming
85001424,2023-02-14,828.82,94.55,Outgoing
85001424,2023-02-14,784.4200000000001,44.4,Outgoing
85057916,2023-01-31,656.89,,-
85057916,2023-02-03,638.61,18.28,Outgoing
85057916,2023-02-05,564.09,74.52,Outgoing
85057916,2023-02-09,537.83,26.26,Outgoing
85057916,2023-02-10,705.52,167.69,Incoming
85057916,2023-02-10,629.46,76.06,Outgoing
85057916,2023-02-10,479.07000000000005,150.39,Outgoing
85128569,2023-01-31,340.68,,-
85128569,2023-02-03,226.10000000000002,114.58,Outgoing
85128569,2023-02-07,291.47,65.37,Incoming
85128569,2023-02-11,396.74,105.27,Incoming
85128569,2023-02-14,519.71,122.97,Incoming
85140734,2023-01-31,699.57,,-
85140734,2023-02-01,493.68000000000006,205.89,Outgoing
85140734,2023-02-01,362.32000000000005,131.36,Outgoing
85140734,2023-02-02,291.69000000000005,70.63,Outgoing
85140734,2023-02-03,371.06000000000006,79.37,Incoming
85140734,2023-02-04,293.93000000000006,77.13,Outgoing
85140734,2023-02-08,2407.2300000000005,2113.3,Incoming
85140734,2023-02-12,2550.2300000000005,143.0,Incoming
85140734,2023-02-12,2478.5800000000004,71.65,Outgoing
85156953,2023-01-31,900.09,,-
85156953,2023-02-02,916.83,16.74,Incoming
85156953,2023-02-03,835.1,81.73,Outgoing
85156953,2023-02-05,731.8100000000001,103.29,Outgoing
85156953,2023-02-10,563.6200000000001,168.19,Outgoing
85156953,2023-02-12,657.0400000000001,93.42,Incoming
85156953,2023-02-13,588.1100000000001,68.93,Outgoing
85156953,2023-02-14,-1546.4899999999998,2134.6,Outgoing
85177718,2023-01-31,478.18,,-
85177718,2023-02-03,-35.11999999999995,513.3,Outgoing
85177718,2023-02-05,96.24000000000007,131.36,Incoming
85177718,2023-02-14,-28.789999999999935,125.03,Outgoing
85182642,2023-01-31,451.38,,-
85182642,2023-02-07,559.47,108.09,Incoming
85182642,2023-02-08,655.89,96.42,Incoming
85182642,2023-02-11,556.54,99.35,Outgoing
85192761,2023-01-31,982.48,,-
85192761,2023-02-04,886.72,95.76,Outgoing
85192761,2023-02-05,2809.2200000000003,1922.5,Incoming
85192761,2023-02-08,2756.7700000000004,52.45,Outgoing
85192761,2023-02-12,2605.6800000000003,151.09,Outgoing
85238291,2023-01-31,665.68,,-
85238291,2023-02-01,808.66,142.98,Incoming
85238291,2023-02-02,1454.46,645.8,Incoming
85238291,2023-02-02,1483.45,28.99,Incoming
85238291,2023-02-05,1578.29,94.84,Incoming
85238291,2023-02-07,1414.49,163.8,Outgoing
85238291,2023-02-08,1216.53,197.96,Outgoing
85238291,2023-02-13,1100.6299999999999,115.9,Outgoing
85250129,2023-01-31,400.91,,-
85250129,2023-02-01,520.12,119.21,Incoming
85250129,2023-02-02,442.98,77.14,Outgoing
85250129,2023-02-06,530.3100000000001,87.33,Incoming
85250129,2023-02-08,649.07,118.76,Incoming
85250129,2023-02-08,-302.92999999999995,952.0,Outgoing
85250129,2023-02-10,-167.71999999999994,135.21,Incoming
85250129,2023-02-12,-111.34999999999994,56.37,Incoming
85265080,2023-01-31,992.6,,-
85265080,2023-02-01,1070.82,78.22,Incoming
85265080,2023-02-01,1197.1799999999998,126.36,Incoming
85265080,2023-02-12,2308.58,1111.4,Incoming
85310930,2023-01-31,688.91,,-
85310930,2023-02-07,580.8199999999999,108.09,Outgoing
85310930,2023-02-09,459.31999999999994,121.5,Outgoing
85310930,2023-02-11,540.7399999999999,81.42,Incoming
85336547,2023-01-31,785.57,,-
85336547,2023-02-03,664.8100000000001,120.76,Outgoing
85336547,2023-02-08,748.0100000000001,83.2,Incoming
85336547,2023-02-10,525.6100000000001,222.4,Outgoing
85341369,2023-01-31,932.11,,-
85341369,2023-02-01,785.72,146.39,Outgoing
85341369,2023-02-02,973.12,187.4,Incoming
85341369,2023-02-02,1122.48,149.36,Incoming
85341369,2023-02-05,1085.92,36.56,Outgoing
85341369,2023-02-06,1120.3000000000002,34.38,Incoming
85341369,2023-02-06,941.9000000000002,178.4,Outgoing
85341369,2023-02-09,874.0600000000002,67.84,Outgoing
85341369,2023-02-11,845.7200000000001,28.34,Outgoing
85341369,2023-02-13,708.0900000000001,137.63,Outgoing
85344981,2023-01-31,874.46,,-
85344981,2023-02-05,959.5400000000001,85.08,Incoming
85344981,2023-02-06,-64.65999999999997,1024.2,Outgoing
85344981,2023-02-08,-267.76,203.1,Outgoing
85344981,2023-02-09,-388.91999999999996,121.16,Outgoing
85344981,2023-02-11,-509.9,120.98,Outgoing
85344981,2023-02-12,618.8000000000001,1128.7,Incoming
85344981,2023-02-13,513.09,105.71,Outgoing
85344981,2023-02-14,448.87,64.22,Outgoing
85362253,2023-01-31,790.41,,-
85362253,2023-02-01,853.6899999999999,63.28,Incoming
85362253,2023-02-03,1032.23,178.54,Incoming
85362253,2023-02-04,1093.29,61.06,Incoming
85362253,2023-02-07,1014.4399999999999,78.85,Outgoing
85362253,2023-02-08,922.01,92.43,Outgoing
85362253,2023-02-12,998.87,76.86,Incoming
85362253,2023-02-14,454.87,544.0,Outgoing
85399459,2023-01-31,705.94,,-
85399459,2023-02-02,795.6400000000001,89.7,Incoming
85399459,2023-02-07,964.7600000000001,169.12,Incoming
85399459,2023-02-10,926.9300000000001,37.83,Outgoing
85399459,2023-02-11,1963.93,1037.0,Incoming
85399459,2023-02-13,2053.03,89.1,Incoming
85420056,2023-01-31,107.03,,-
85420056,2023-02-04,80.27,26.76,Outgoing
85420056,2023-02-08,200.38,120.11,Incoming
85420056,2023-02-09,105.57,94.81,Outgoing
85420056,2023-02-11,-71.53,177.1,Outgoing
85420056,2023-02-13,-120.30000000000001,48.77,Outgoing
85423742,2023-01-31,131.14,,-
85423742,2023-02-02,46.22999999999999,84.91,Outgoing
85423742,2023-02-09,-60.06000000000002,106.29,Outgoing
85423742,2023-02-11,-71.75000000000001,11.69,Outgoing
85423742,2023-02-11,-930.45,858.7,Outgoing
85423742,2023-02-12,-1053.0700000000002,122.62,Outgoing
85423742,2023-02-12,-974.0000000000002,79.07,Incoming
85423742,2023-02-14,-886.4500000000003,87.55,Incoming
85435135,2023-01-31,106.63,,-
85435135,2023-02-02,179.20999999999998,72.58,Incoming
85435135,2023-02-03,51.589999999999975,127.62,Outgoing
85435135,2023-02-03,-5.180000000000028,56.77,Outgoing
85435135,2023-02-03,85.29999999999998,90.48,Incoming
85435135,2023-02-07,-42.630000000000024,127.93,Outgoing
85435135,2023-02-11,-152.91000000000003,110.28,Outgoing
85435135,2023-02-11,-294.66,141.75,Outgoing
85435135,2023-02-12,-116.29000000000002,178.37,Incoming
85435135,2023-02-13,-242.75,126.46,Outgoing
85482194,2023-01-31,997.62,,-
85482194,2023-02-03,837.52,160.1,Outgoing
85482194,2023-02-05,722.99,114.53,Outgoing
85482194,2023-02-07,577.13,145.86,Outgoing
85482194,2023-02-08,531.9,45.23,Outgoing
85482194,2023-02-08,390.03999999999996,141.86,Outgoing
85482194,2023-02-09,1606.6399999999999,1216.6,Incoming
85482194,2023-02-11,1744.07,137.43,Incoming
85482194,2023-02-11,1710.4299999999998,33.64,Outgoing
85490561,2023-01-31,512.78,,-
85490561,2023-02-03,653.28,140.5,Incoming
85490561,2023-02-03,534.0799999999999,119.2,Outgoing
85490561,2023-02-07,458.99999999999994,75.08,Outgoing
85490561,2023-02-08,268.62999999999994,190.37,Outgoing
85490561,2023-02-09,474.36999999999995,205.74,Incoming
85490561,2023-02-09,571.91,97.54,Incoming
85490561,2023-02-13,658.16,86.25,Incoming
85493851,2023-01-31,796.35,,-
85493851,2023-02-05,917.38,121.03,Incoming
85493851,2023-02-06,915.92,1.46,Outgoing
85493851,2023-02-08,818.9699999999999,96.95,Outgoing
85493851,2023-02-09,961.56,142.59,Incoming
85493851,2023-02-09,1096.31,134.75,Incoming
85493851,2023-02-14,1002.6999999999999,93.61,Outgoing
85496714,2023-01-31,353.13,,-
85496714,2023-02-03,482.32,129.19,Incoming
85496714,2023-02-04,573.73,91.41,Incoming
85496714,2023-02-04,691.52,117.79,Incoming
85496714,2023-02-06,631.13,60.39,Outgoing
85496714,2023-02-08,784.92,153.79,Incoming
85496714,2023-02-09,721.88,63.04,Outgoing
85496714,2023-02-10,838.42,116.54,Incoming
85496714,2023-02-11,727.8599999999999,110.56,Outgoing
85496714,2023-02-12,-586.44,1314.3,Outgoing
85496714,2023-02-12,-656.2900000000001,69.85,Outgoing
85496714,2023-02-13,-689.23,32.94,Outgoing
85496714,2023-02-13,-788.6,99.37,Outgoing
85498335,2023-01-31,745.08,,-
85498335,2023-02-04,825.59,80.51,Incoming
85498335,2023-02-07,740.62,84.97,Outgoing
85498335,2023-02-09,590.98,149.64,Outgoing
85498335,2023-02-09,468.19,122.79,Outgoing
85498936,2023-01-31,47.77,,-
85498936,2023-02-03,1983.27,1935.5,Incoming
85498936,2023-02-09,1824.75,158.52,Outgoing
85498936,2023-02-10,1785.3,39.45,Outgoing
85498936,2023-02-13,1784.72,0.58,Outgoing
85501046,2023-01-31,354.76,,-
85501046,2023-02-01,506.79999999999995,152.04,Incoming
85501046,2023-02-05,348.55999999999995,158.24,Outgoing
85501046,2023-02-08,405.87999999999994,57.32,Incoming
85503501,2023-01-31,13.66,,-
85503501,2023-02-01,-39.8,53.46,Outgoing
85503501,2023-02-04,108.28000000000002,148.08,Incoming
85503501,2023-02-05,163.8,55.52,Incoming
85503501,2023-02-05,-22.369999999999976,186.17,Outgoing
85503501,2023-02-06,-416.87,394.5,Outgoing
85503501,2023-02-08,-595.36,178.49,Outgoing
85503501,2023-02-09,-786.04,190.68,Outgoing
85503501,2023-02-13,-845.0799999999999,59.04,Outgoing
85551186,2023-01-31,909.25,,-
85551186,2023-02-07,2108.15,1198.9,Incoming
85551186,2023-02-07,2005.63,102.52,Outgoing
85551186,2023-02-09,1906.0400000000002,99.59,Outgoing
85559926,2023-01-31,423.28,,-
85559926,2023-02-01,548.96,125.68,Incoming
85559926,2023-02-06,532.2900000000001,16.67,Outgoing
85559926,2023-02-07,588.4200000000001,56.13,Incoming
85559926,2023-02-09,-1139.3799999999999,1727.8,Outgoing
85559926,2023-02-10,-1228.4699999999998,89.09,Outgoing
85559926,2023-02-10,-1299.61,71.14,Outgoing
85559926,2023-02-11,-1349.6799999999998,50.07,Outgoing
85559926,2023-02-12,-1172.1599999999999,177.52,Incoming
85559926,2023-02-12,-2243.56,1071.4,Outgoing
85562851,2023-01-31,499.37,,-
85562851,2023-02-02,643.88,144.51,Incoming
85562851,2023-02-03,784.9300000000001,141.05,Incoming
85562851,2023-02-07,1011.7600000000001,226.83,Incoming
85562851,2023-02-07,892.5100000000001,119.25,Outgoing
85562851,2023-02-08,911.6200000000001,19.11,Incoming
85562851,2023-02-08,1097.96,186.34,Incoming
85562851,2023-02-09,939.71,158.25,Outgoing
85562851,2023-02-12,1006.38,66.67,Incoming
85609963,2023-01-31,424.83,,-
85609963,2023-02-04,235.10999999999999,189.72,Outgoing
85609963,2023-02-05,92.32,142.79,Outgoing
85609963,2023-02-10,-63.900000000000006,156.22,Outgoing
85652943,2023-01-31,424.5,,-
85652943,2023-02-02,520.02,95.52,Incoming
85652943,2023-02-03,1374.42,854.4,Incoming
85652943,2023-02-03,1263.8300000000002,110.59,Outgoing
85652943,2023-02-09,1141.88,121.95,Outgoing
85679194,2023-01-31,891.99,,-
85679194,2023-02-06,787.6700000000001,104.32,Outgoing
85679194,2023-02-07,972.69,185.02,Incoming
85679194,2023-02-09,893.24,79.45,Outgoing
85679194,2023-02-10,861.96,31.28,Outgoing
85679194,2023-02-13,823.7,38.26,Outgoing
85709972,2023-01-31,936.57,,-
85709972,2023-02-05,891.47,45.1,Outgoing
85709972,2023-02-11,717.77,173.7,Outgoing
85723355,2023-01-31,745.34,,-
85723355,2023-02-05,752.0600000000001,6.72,Incoming
85723355,2023-02-08,939.3000000000001,187.24,Incoming
85723355,2023-02-12,827.07,112.23,Outgoing
85723355,2023-02-13,857.44,30.37,Incoming
85723355,2023-02-14,2631.04,1773.6,Incoming
85724829,2023-01-31,189.94,,-
85724829,2023-02-02,192.57,2.63,Incoming
85724829,2023-02-02,142.94,49.63,Outgoing
85724829,2023-02-03,166.44,23.5,Incoming
85724829,2023-02-08,57.480000000000004,108.96,Outgoing
85724829,2023-02-08,180.29000000000002,122.81,Incoming
85724829,2023-02-10,38.83000000000001,141.46,Outgoing
85724829,2023-02-10,-109.79999999999998,148.63,Outgoing
85724829,2023-02-10,-35.64999999999998,74.15,Incoming
85724829,2023-02-11,-221.11999999999998,185.47,Outgoing
85724829,2023-02-13,-260.27,39.15,Outgoing
85771346,2023-01-31,458.88,,-
85771346,2023-02-07,660.5799999999999,201.7,Incoming
85771346,2023-02-08,1231.48,570.9,Incoming
85826354,2023-01-31,611.74,,-
85826354,2023-02-02,692.04,80.3,Incoming
85826354,2023-02-03,639.55,52.49,Outgoing
85826354,2023-02-05,538.74,100.81,Outgoing
85826354,2023-02-13,473.89,64.85,Outgoing
85826354,2023-02-13,518.27,44.38,Incoming
85839285,2023-01-31,728.06,,-
85839285,2023-02-01,90.95999999999992,637.1,Outgoing
85839285,2023-02-03,227.38999999999993,136.43,Incoming
85839285,2023-02-06,122.53999999999994,104.85,Outgoing
85839285,2023-02-07,-2.1600000000000676,124.7,Outgoing
85839285,2023-02-09,63.60999999999993,65.77,Incoming
85839285,2023-02-10,256.7299999999999,193.12,Incoming
85839285,2023-02-13,325.5899999999999,68.86,Incoming
85841767,2023-01-31,458.43,,-
85841767,2023-02-01,570.32,111.89,Incoming
85841767,2023-02-03,479.74000000000007,90.58,Outgoing
85841767,2023-02-04,570.1800000000001,90.44,Incoming
85841767,2023-02-04,555.5500000000001,14.63,Outgoing
85841767,2023-02-06,666.21,110.66,Incoming
85841767,2023-02-08,801.09,134.88,Incoming
85841767,2023-02-08,872.01,70.92,Incoming
85841767,2023-02-10,1040.65,168.64,Incoming
85841767,2023-02-13,1257.02,216.37,Incoming
85841767,2023-02-14,1294.76,37.74,Incoming
85846175,2023-01-31,22.88,,-
85846175,2023-02-03,-34.11,56.99,Outgoing
85846175,2023-02-04,-146.24,112.13,Outgoing
85846175,2023-02-04,-28.27000000000001,117.97,Incoming
85846175,2023-02-07,-43.93000000000001,15.66,Outgoing
85846175,2023-02-08,69.72,113.65,Incoming
85846175,2023-02-09,170.98000000000002,101.26,Incoming
85846175,2023-02-11,56.640000000000015,114.34,Outgoing
85846175,2023-02-11,-141.26,197.9,Outgoing
85846175,2023-02-12,-257.13,115.87,Outgoing
85846175,2023-02-14,-421.51,164.38,Outgoing
85848442,2023-01-31,118.46,,-
85848442,2023-02-02,260.43,141.97,Incoming
85848442,2023-02-07,-40.56999999999999,301.0,Outgoing
85848442,2023-02-07,78.35000000000001,118.92,Incoming
85848442,2023-02-08,181.92000000000002,103.57,Incoming
85848442,2023-02-08,1719.02,1537.1,Incoming
85848442,2023-02-10,1644.3,74.72,Outgoing
85848442,2023-02-10,1812.6499999999999,168.35,Incoming
85848442,2023-02-10,1725.3,87.35,Outgoing
85848442,2023-02-11,1802.84,77.54,Incoming
85848442,2023-02-11,1848.51,45.67,Incoming
85874418,2023-01-31,151.83,,-
85874418,2023-02-01,303.24,151.41,Incoming
85874418,2023-02-02,192.72000000000003,110.52,Outgoing
85874418,2023-02-02,225.78000000000003,33.06,Incoming
85874418,2023-02-03,473.42,247.64,Incoming
85874418,2023-02-03,359.88,113.54,Outgoing
85874418,2023-02-06,247.91,111.97,Outgoing
85874418,2023-02-08,2053.5099999999998,1805.6,Incoming
85874418,2023-02-12,2114.87,61.36,Incoming
85902834,2023-01-31,357.94,,-
85902834,2023-02-02,269.08,88.86,Outgoing
85902834,2023-02-03,245.83999999999997,23.24,Outgoing
85902834,2023-02-06,67.46999999999997,178.37,Outgoing
85902834,2023-02-06,175.07999999999998,107.61,Incoming
85902834,2023-02-07,303.01,127.93,Incoming
85902834,2023-02-08,423.36,120.35,Incoming
85902834,2023-02-10,584.08,160.72,Incoming
85902834,2023-02-11,445.6,138.48,Outgoing
85902834,2023-02-13,529.44,83.84,Incoming
85902834,2023-02-13,-201.95999999999992,731.4,Outgoing
85919813,2023-01-31,647.36,,-
85919813,2023-02-01,540.5600000000001,106.8,Outgoing
85919813,2023-02-07,712.01,171.45,Incoming
85919813,2023-02-09,789.67,77.66,Incoming
85919813,2023-02-12,871.5,81.83,Incoming
85924719,2023-01-31,472.05,,-
85924719,2023-02-08,-1400.75,1872.8,Outgoing
85924719,2023-02-09,-1323.42,77.33,Incoming
85924719,2023-02-11,-2334.02,1010.6,Outgoing
85939269,2023-01-31,223.1,,-
85939269,2023-02-01,345.01,121.91,Incoming
85939269,2023-02-02,-189.49,534.5,Outgoing
85939269,2023-02-05,-8.26000000000002,181.23,Incoming
85939269,2023-02-06,143.07,151.33,Incoming
85939269,2023-02-10,317.78,174.71,Incoming
85939269,2023-02-13,163.62999999999997,154.15,Outgoing
85939269,2023-02-13,284.92999999999995,121.3,Incoming
85940057,2023-01-31,521.37,,-
85940057,2023-02-01,-548.33,1069.7,Outgoing
85940057,2023-02-04,-447.80000000000007,100.53,Incoming
85940057,2023-02-05,688.6,1136.4,Incoming
85940057,2023-02-05,638.75,49.85,Outgoing
85940057,2023-02-12,1627.95,989.2,Incoming
85940057,2023-02-12,1738.0900000000001,110.14,Incoming
85951663,2023-01-31,385.0,,-
85951663,2023-02-01,285.55,99.45,Outgoing
85951663,2023-02-02,419.22,133.67,Incoming
85951663,2023-02-02,185.86,233.36,Outgoing
85951663,2023-02-02,1.5700000000000216,184.29,Outgoing
85951663,2023-02-03,123.79000000000002,122.22,Incoming
85951663,2023-02-04,-131.20999999999998,255.0,Outgoing
85951663,2023-02-08,-25.23999999999998,105.97,Incoming
85951663,2023-02-08,189.9,215.14,Incoming
85951663,2023-02-14,314.93,125.03,Incoming
85994636,2023-01-31,819.24,,-
85994636,2023-02-01,933.28,114.04,Incoming
85994636,2023-02-02,1038.07,104.79,Incoming
85994636,2023-02-04,-322.93000000000006,1361.0,Outgoing
85994636,2023-02-04,1087.97,1410.9,Incoming
85994636,2023-02-08,1022.12,65.85,Outgoing
85994636,2023-02-09,1118.2,96.08,Incoming
85994636,2023-02-12,1054.8700000000001,63.33,Outgoing
85994636,2023-02-12,931.6300000000001,123.24,Outgoing
85994636,2023-02-13,826.9300000000001,104.7,Outgoing
86007729,2023-01-31,320.78,,-
86007729,2023-02-05,223.22999999999996,97.55,Outgoing
86007729,2023-02-10,252.74999999999997,29.52,Incoming
86007729,2023-02-12,141.14999999999998,111.6,Outgoing
86007729,2023-02-13,68.33999999999997,72.81,Outgoing
86020532,2023-01-31,972.95,,-
86020532,2023-02-05,1068.93,95.98,Incoming
86020532,2023-02-11,948.74,120.19,Outgoing
86020532,2023-02-12,903.77,44.97,Outgoing
86020532,2023-02-13,960.68,56.91,Incoming
86031592,2023-01-31,637.42,,-
86031592,2023-02-01,513.18,124.24,Outgoing
86031592,2023-02-01,648.18,135.0,Incoming
86031592,2023-02-02,468.02,180.16,Outgoing
86031592,2023-02-02,416.74,51.28,Outgoing
86031592,2023-02-03,473.63,56.89,Incoming
86031592,2023-02-03,402.83,70.8,Outgoing
86031592,2023-02-04,800.9300000000001,398.1,Incoming
86031592,2023-02-05,721.97,78.96,Outgoing
86031592,2023-02-10,577.6800000000001,144.29,Outgoing
86031592,2023-02-11,909.48,331.8,Incoming
86031592,2023-02-13,822.97,86.51,Outgoing
86053438,2023-01-31,303.06,,-
86053438,2023-02-01,-849.8400000000001,1152.9,Outgoing
86053438,2023-02-02,-965.8400000000001,116.0,Outgoing
86053438,2023-02-04,-815.3900000000001,150.45,Incoming
86053438,2023-02-10,-773.2500000000001,42.14,Incoming
86053438,2023-02-13,-850.7700000000001,77.52,Outgoing
86053438,2023-02-13,-998.2700000000001,147.5,Outgoing
86068003,2023-01-31,567.14,,-
86068003,2023-02-03,696.91,129.77,Incoming
86068003,2023-02-03,693.67,3.24,Outgoing
86068003,2023-02-06,629.9699999999999,63.7,Outgoing
86068003,2023-02-07,549.9799999999999,79.99,Outgoing
86068003,2023-02-08,1243.3799999999999,693.4,Incoming
86068003,2023-02-11,1286.33,42.95,Incoming
86068003,2023-02-11,1343.03,56.7,Incoming
86068003,2023-02-12,1259.0,84.03,Outgoing
86068003,2023-02-14,-1361.1,2620.1,Outgoing
86086812,2023-01-31,832.82,,-
86086812,2023-02-02,939.4300000000001,106.61,Incoming
86086812,2023-02-13,1045.17,105.74,Incoming
86092750,2023-01-31,261.57,,-
86092750,2023-02-03,-690.4300000000001,952.0,Outgoing
86092750,2023-02-08,-598.9000000000001,91.53,Incoming
86092750,2023-02-09,-754.1200000000001,155.22,Outgoing
86092750,2023-02-10,-673.2100000000002,80.91,Incoming
86106528,2023-01-31,238.55,,-
86106528,2023-02-02,117.83000000000001,120.72,Outgoing
86106528,2023-02-06,105.89000000000001,11.94,Outgoing
86108287,2023-01-31,523.61,,-
86108287,2023-02-05,462.36,61.25,Outgoing
86108287,2023-02-08,295.01,167.35,Outgoing
86108287,2023-02-10,381.15,86.14,Incoming
86108287,2023-02-10,1591.4499999999998,1210.3,Incoming
86108287,2023-02-11,1551.1499999999999,40.3,Outgoing
86131065,2023-01-31,920.08,,-
86131065,2023-02-05,1034.1000000000001,114.02,Incoming
86131065,2023-02-07,1007.7700000000001,26.33,Outgoing
86131065,2023-02-08,853.5700000000002,154.2,Outgoing
86131065,2023-02-09,927.5500000000002,73.98,Incoming
86155528,2023-01-31,772.38,,-
86155528,2023-02-01,690.8199999999999,81.56,Outgoing
86155528,2023-02-06,529.6999999999999,161.12,Outgoing
86155528,2023-02-08,593.4999999999999,63.8,Incoming
86155528,2023-02-09,701.1299999999999,107.63,Incoming
86155528,2023-02-13,668.0899999999999,33.04,Outgoing
86169883,2023-01-31,452.25,,-
86169883,2023-02-06,505.09000000000003,52.84,Incoming
86169883,2023-02-07,406.43000000000006,98.66,Outgoing
86169883,2023-02-08,572.22,165.79,Incoming
86169883,2023-02-12,723.28,151.06,Incoming
86169883,2023-02-12,887.31,164.03,Incoming
86169883,2023-02-12,1078.92,191.61,Incoming
86169883,2023-02-13,1136.0900000000001,57.17,Incoming
86169883,2023-02-14,1066.3000000000002,69.79,Outgoing
86169883,2023-02-14,1210.13,143.83,Incoming
86190489,2023-01-31,237.72,,-
86190489,2023-02-03,345.81,108.09,Incoming
86190489,2023-02-05,-514.8900000000001,860.7,Outgoing
86190489,2023-02-07,-330.60000000000014,184.29,Incoming
86190489,2023-02-07,-148.33000000000013,182.27,Incoming
86190489,2023-02-13,-58.910000000000124,89.42,Incoming
86190489,2023-02-13,77.75999999999986,136.67,Incoming
86190489,2023-02-14,-113.33000000000014,191.09,Outgoing
86207903,2023-01-31,911.44,,-
86207903,2023-02-01,1042.71,131.27,Incoming
86207903,2023-02-01,1083.89,41.18,Incoming
86207903,2023-02-05,1181.44,97.55,Incoming
86207903,2023-02-06,96.03999999999996,1085.4,Outgoing
86207903,2023-02-06,150.74999999999997,54.71,Incoming
86207903,2023-02-07,340.37,189.62,Incoming
86207903,2023-02-10,449.18,108.81,Incoming
86207903,2023-02-11,1484.28,1035.1,Incoming
86207903,2023-02-12,1576.81,92.53,Incoming
86218347,2023-01-31,481.16,,-
86218347,2023-02-01,315.5,165.66,Outgoing
86218347,2023-02-07,-1266.3,1581.8,Outgoing
86218347,2023-02-07,-1185.83,80.47,Incoming
86218347,2023-02-09,-1133.1,52.73,Incoming
86218347,2023-02-10,330.5,1463.6,Incoming
86218347,2023-02-10,184.38,146.12,Outgoing
86218347,2023-02-11,84.14999999999999,100.23,Outgoing
86218347,2023-02-14,-71.87000000000002,156.02,Outgoing
86228741,2023-01-31,562.04,,-
86228741,2023-02-06,676.15,114.11,Incoming
86228741,2023-02-10,815.8,139.65,Incoming
86228741,2023-02-13,659.31,156.49,Outgoing
86263956,2023-01-31,852.67,,-
86263956,2023-02-10,933.4399999999999,80.77,Incoming
86263956,2023-02-12,1045.12,111.68,Incoming
86266595,2023-01-31,539.96,,-
86266595,2023-02-01,696.69,156.73,Incoming
86266595,2023-02-02,581.6400000000001,115.05,Outgoing
86266595,2023-02-05,223.74000000000012,357.9,Outgoing
86266595,2023-02-05,383.04000000000013,159.3,Incoming
86266595,2023-02-09,430.1100000000001,47.07,Incoming
86266595,2023-02-09,438.4900000000001,8.38,Incoming
86266595,2023-02-10,315.83000000000015,122.66,Outgoing
86266595,2023-02-11,376.20000000000016,60.37,Incoming
86266595,2023-02-13,476.25000000000017,100.05,Incoming
86266595,2023-02-14,512.4500000000002,36.2,Incoming
86268635,2023-01-31,679.32,,-
86268635,2023-02-02,601.7800000000001,77.54,Outgoing
86268635,2023-02-03,517.6600000000001,84.12,Outgoing
86268635,2023-02-04,365.18000000000006,152.48,Outgoing
86272488,2023-01-31,11.73,,-
86272488,2023-02-01,102.52000000000001,90.79,Incoming
86272488,2023-02-03,258.87,156.35,Incoming
86272488,2023-02-03,245.26,13.61,Outgoing
86272488,2023-02-05,101.16,144.1,Outgoing
86272488,2023-02-14,12.810000000000002,88.35,Outgoing
86297017,2023-01-31,803.81,,-
86297017,2023-02-01,700.77,103.04,Outgoing
86297017,2023-02-03,781.03,80.26,Incoming
86297017,2023-02-04,848.9399999999999,67.91,Incoming
86297017,2023-02-10,133.43999999999994,715.5,Outgoing
86297017,2023-02-11,-397.96000000000004,531.4,Outgoing
86297017,2023-02-13,-308.66,89.3,Incoming
86339581,2023-01-31,91.76,,-
86339581,2023-02-02,-34.39999999999999,126.16,Outgoing
86339581,2023-02-03,-82.63,48.23,Outgoing
86339581,2023-02-04,-35.3,47.33,Incoming
86339581,2023-02-06,211.51999999999998,246.82,Incoming
86339581,2023-02-07,319.61,108.09,Incoming
86339581,2023-02-08,153.25,166.36,Outgoing
86339581,2023-02-10,227.85,74.6,Incoming
86339581,2023-02-11,1334.9499999999998,1107.1,Incoming
86339581,2023-02-11,1201.36,133.59,Outgoing
86339899,2023-01-31,460.69,,-
86339899,2023-02-01,-155.10999999999996,615.8,Outgoing
86339899,2023-02-01,446.5900000000001,601.7,Incoming
86339899,2023-02-03,274.6000000000001,171.99,Outgoing
86339899,2023-02-04,402.4000000000001,127.8,Incoming
86339899,2023-02-06,-1390.3,1792.7,Outgoing
86339899,2023-02-06,-1251.98,138.32,Incoming
86339899,2023-02-07,-1322.99,71.01,Outgoing
86339899,2023-02-10,-1403.57,80.58,Outgoing
86339899,2023-02-10,-1339.29,64.28,Incoming
86339899,2023-02-11,-1224.45,114.84,Incoming
86406958,2023-01-31,842.43,,-
86406958,2023-02-02,870.12,27.69,Incoming
86406958,2023-02-06,1557.22,687.1,Incoming
86406958,2023-02-10,1522.23,34.99,Outgoing
86406958,2023-02-13,1429.09,93.14,Outgoing
86406958,2023-02-14,1360.3899999999999,68.7,Outgoing
86406958,2023-02-14,1293.5099999999998,66.88,Outgoing
86439949,2023-01-31,782.42,,-
86439949,2023-02-02,716.0,66.42,Outgoing
86439949,2023-02-02,703.13,12.87,Outgoing
86439949,2023-02-03,760.12,56.99,Incoming
86439949,2023-02-03,788.0,27.88,Incoming
86439949,2023-02-05,897.7,109.7,Incoming
86439949,2023-02-09,1632.8000000000002,735.1,Incoming
86489618,2023-01-31,488.7,,-
86489618,2023-02-03,494.01,5.31,Incoming
86489618,2023-02-06,456.11,37.9,Outgoing
86489618,2023-02-09,289.95000000000005,166.16,Outgoing
86489618,2023-02-13,287.95000000000005,2.0,Outgoing
86496446,2023-01-31,124.84,,-
86496446,2023-02-01,210.45,85.61,Incoming
86496446,2023-02-07,72.94,137.51,Outgoing
86496446,2023-02-08,-65.37,138.31,Outgoing
86496446,2023-02-11,-216.54,151.17,Outgoing
86496446,2023-02-14,-312.40999999999997,95.87,Outgoing
86530050,2023-01-31,447.17,,-
86530050,2023-02-01,344.01,103.16,Outgoing
86530050,2023-02-03,434.66999999999996,90.66,Incoming
86530050,2023-02-04,562.93,128.26,Incoming
86530050,2023-02-07,732.18,169.25,Incoming
86530050,2023-02-09,789.54,57.36,Incoming
86530050,2023-02-09,757.67,31.87,Outgoing
86530050,2023-02-09,860.02,102.35,Incoming
86530050,2023-02-09,721.17,138.85,Outgoing
86530050,2023-02-14,562.8399999999999,158.33,Outgoing
86530050,2023-02-14,681.9399999999999,119.1,Incoming
86530050,2023-02-14,651.1999999999999,30.74,Outgoing
86596620,2023-01-31,512.69,,-
86596620,2023-02-04,469.95000000000005,42.74,Outgoing
86596620,2023-02-07,494.29,24.34,Incoming
86596620,2023-02-10,564.72,70.43,Incoming
86596620,2023-02-11,480.37,84.35,Outgoing
86596620,2023-02-12,623.23,142.86,Incoming
86624158,2023-01-31,818.29,,-
86624158,2023-02-04,942.52,124.23,Incoming
86624158,2023-02-05,844.97,97.55,Outgoing
86624158,2023-02-07,675.94,169.03,Outgoing
86624158,2023-02-08,777.83,101.89,Incoming
86624158,2023-02-09,721.8000000000001,56.03,Outgoing
86624158,2023-02-10,816.2500000000001,94.45,Incoming
86624158,2023-02-11,636.9800000000001,179.27,Outgoing
86624158,2023-02-11,510.5600000000001,126.42,Outgoing
86637863,2023-01-31,672.86,,-
86637863,2023-02-03,567.75,105.11,Outgoing
86637863,2023-02-04,412.12,155.63,Outgoing
86637863,2023-02-05,490.48,78.36,Incoming
86637863,2023-02-06,518.04,27.56,Incoming
86637863,2023-02-08,430.30999999999995,87.73,Outgoing
86637863,2023-02-12,521.54,91.23,Incoming
86655008,2023-01-31,671.72,,-
86655008,2023-02-01,724.62,52.9,Incoming
86655008,2023-02-01,640.55,84.07,Outgoing
86655008,2023-02-03,838.8399999999999,198.29,Incoming
86655008,2023-02-04,1739.54,900.7,Incoming
86655008,2023-02-09,1806.37,66.83,Incoming
86655008,2023-02-09,1708.06,98.31,Outgoing
86655008,2023-02-13,1851.05,142.99,Incoming
86655008,2023-02-14,1735.67,115.38,Outgoing
86698396,2023-01-31,314.21,,-
86698396,2023-02-03,200.52999999999997,113.68,Outgoing
86728138,2023-01-31,175.36,,-
86728138,2023-02-04,390.14,214.78,Incoming
86728138,2023-02-07,227.91,162.23,Outgoing
86728138,2023-02-07,341.51,113.6,Incoming
86728138,2023-02-08,499.27,157.76,Incoming
86737119,2023-01-31,432.69,,-
86737119,2023-02-04,188.56,244.13,Outgoing
86737119,2023-02-04,347.53999999999996,158.98,Incoming
86737119,2023-02-05,1120.04,772.5,Incoming
86737119,2023-02-06,1313.31,193.27,Incoming
86737119,2023-02-07,1465.94,152.63,Incoming
86737119,2023-02-07,1342.26,123.68,Outgoing
86737119,2023-02-07,1265.42,76.84,Outgoing
86737119,2023-02-07,1068.3000000000002,197.12,Outgoing
86737119,2023-02-09,891.7400000000002,176.56,Outgoing
86737119,2023-02-13,743.1700000000003,148.57,Outgoing
86737119,2023-02-14,669.4000000000003,73.77,Outgoing
86765156,2023-01-31,290.53,,-
86765156,2023-02-02,171.65999999999997,118.87,Outgoing
86765156,2023-02-05,237.33999999999997,65.68,Incoming
86765156,2023-02-09,61.04999999999998,176.29,Outgoing
86765156,2023-02-09,-36.74000000000002,97.79,Outgoing
86785126,2023-01-31,148.21,,-
86785126,2023-02-02,373.55,225.34,Incoming
86785126,2023-02-03,268.6,104.95,Outgoing
86785126,2023-02-04,372.41,103.81,Incoming
86785126,2023-02-05,453.24,80.83,Incoming
86785126,2023-02-07,306.20000000000005,147.04,Outgoing
86785126,2023-02-11,354.18000000000006,47.98,Incoming
86785126,2023-02-14,-289.7199999999999,643.9,Outgoing
86785126,2023-02-14,123.0800000000001,412.8,Incoming
86788651,2023-01-31,593.38,,-
86788651,2023-02-01,441.34000000000003,152.04,Outgoing
86788651,2023-02-01,223.20000000000005,218.14,Outgoing
86788651,2023-02-04,308.70000000000005,85.5,Incoming
86788651,2023-02-07,409.77000000000004,101.07,Incoming
86788651,2023-02-07,693.1700000000001,283.4,Incoming
86788651,2023-02-13,564.4100000000001,128.76,Outgoing
86788651,2023-02-14,726.7600000000001,162.35,Incoming
86788651,2023-02-14,817.5500000000001,90.79,Incoming
86795912,2023-01-31,295.95,,-
86795912,2023-02-05,415.7,119.75,Incoming
86795912,2023-02-08,513.7,98.0,Incoming
86795912,2023-02-09,381.22,132.48,Outgoing
86795912,2023-02-12,1258.72,877.5,Incoming
86795912,2023-02-14,1087.94,170.78,Outgoing
86816054,2023-01-31,391.59,,-
86816054,2023-02-03,281.72999999999996,109.86,Outgoing
86816054,2023-02-06,364.98999999999995,83.26,Incoming
86816054,2023-02-07,1620.89,1255.9,Incoming
86816054,2023-02-09,1456.17,164.72,Outgoing
86816054,2023-02-09,1387.17,69.0,Outgoing
86816054,2023-02-12,1306.73,80.44,Outgoing
86864320,2023-01-31,611.14,,-
86864320,2023-02-01,714.72,103.58,Incoming
86864320,2023-02-05,531.3000000000001,183.42,Outgoing
86864320,2023-02-06,393.1600000000001,138.14,Outgoing
86864320,2023-02-06,456.5900000000001,63.43,Incoming
86864320,2023-02-13,356.7900000000001,99.8,Outgoing
86864320,2023-02-14,230.0800000000001,126.71,Outgoing
86870860,2023-01-31,987.14,,-
86870860,2023-02-02,856.21,130.93,Outgoing
86870860,2023-02-02,2413.11,1556.9,Incoming
86870860,2023-02-05,2559.4,146.29,Incoming
86870860,2023-02-06,2746.98,187.58,Incoming
86870860,2023-02-07,2668.08,78.9,Outgoing
86870860,2023-02-10,2766.71,98.63,Incoming
86870860,2023-02-12,2538.33,228.38,Outgoing
86870860,2023-02-13,2671.68,133.35,Incoming
86870860,2023-02-14,2803.21,131.53,Incoming
86893452,2023-01-31,641.84,,-
86893452,2023-02-01,533.6700000000001,108.17,Outgoing
86893452,2023-02-01,1686.5700000000002,1152.9,Incoming
86893452,2023-02-04,1732.7000000000003,46.13,Incoming
86893452,2023-02-06,1613.1200000000003,119.58,Outgoing
86893452,2023-02-07,1460.4900000000002,152.63,Outgoing
86893452,2023-02-08,1368.2400000000002,92.25,Outgoing
86893452,2023-02-09,1464.5200000000002,96.28,Incoming
86893452,2023-02-10,1510.8100000000002,46.29,Incoming
86893452,2023-02-10,1431.0400000000002,79.77,Outgoing
86893452,2023-02-12,1525.0700000000002,94.03,Incoming
86893452,2023-02-14,1649.5500000000002,124.48,Incoming
86941058,2023-01-31,337.99,,-
86941058,2023-02-01,187.03,150.96,Outgoing
86941058,2023-02-01,38.06999999999999,148.96,Outgoing
86941058,2023-02-01,-428.63,466.7,Outgoing
86941058,2023-02-01,-335.78,92.85,Incoming
86941058,2023-02-03,-314.75,21.03,Incoming
86941058,2023-02-05,-1548.45,1233.7,Outgoing
86941058,2023-02-07,-1494.8500000000001,53.6,Incoming
86941058,2023-02-07,-1430.8300000000002,64.02,Incoming
86941058,2023-02-07,-1540.88,110.05,Outgoing
86941058,2023-02-08,259.91999999999985,1800.8,Incoming
86941058,2023-02-09,154.58999999999986,105.33,Outgoing
86941058,2023-02-09,257.17999999999984,102.59,Incoming
86941058,2023-02-09,342.21999999999986,85.04,Incoming
86941058,2023-02-11,169.06999999999985,173.15,Outgoing
86941058,2023-02-13,9.429999999999865,159.64,Outgoing
86941058,2023-02-14,-496.1700000000002,505.6,Outgoing
86941058,2023-02-14,-348.1000000000002,148.07,Incoming
86995846,2023-01-31,956.26,,-
86995846,2023-02-04,1006.95,50.69,Incoming
86995846,2023-02-06,874.6600000000001,132.29,Outgoing
86995846,2023-02-07,778.58,96.08,Outgoing
86995846,2023-02-09,867.3100000000001,88.73,Incoming
86995846,2023-02-09,821.61,45.7,Outgoing
86995846,2023-02-10,947.76,126.15,Incoming
87010556,2023-01-31,175.33,,-
87010556,2023-02-03,134.29000000000002,41.04,Outgoing
87010556,2023-02-07,22.07000000000002,112.22,Outgoing
87010556,2023-02-07,-83.45999999999998,105.53,Outgoing
87010556,2023-02-11,-173.82,90.36,Outgoing
87010556,2023-02-12,-273.38,99.56,Outgoing
87010556,2023-02-13,-272.8,0.58,Incoming
87101816,2023-01-31,862.87,,-
87101816,2023-02-01,1013.83,150.96,Incoming
87101816,2023-02-04,1581.5300000000002,567.7,Incoming
87101816,2023-02-07,1416.6800000000003,164.85,Outgoing
87101816,2023-02-08,1408.7400000000002,7.94,Outgoing
87101816,2023-02-10,1225.8700000000003,182.87,Outgoing
87101816,2023-02-11,1148.1200000000003,77.75,Outgoing
87101816,2023-02-14,1248.0700000000004,99.95,Incoming
87101816,2023-02-14,1329.8100000000004,81.74,Incoming
87121270,2023-01-31,122.09,,-
87121270,2023-02-04,208.99,86.9,Incoming
87121270,2023-02-04,303.71000000000004,94.72,Incoming
87121270,2023-02-08,479.68000000000006,175.97,Incoming
87121270,2023-02-12,589.33,109.65,Incoming
87133080,2023-01-31,947.42,,-
87133080,2023-02-05,1144.6399999999999,197.22,Incoming
87133080,2023-02-07,2295.74,1151.1,Incoming
87133080,2023-02-08,2381.72,85.98,Incoming
87133080,2023-02-10,2254.3799999999997,127.34,Outgoing
87133080,2023-02-14,2321.8499999999995,67.47,Incoming
87171530,2023-01-31,705.41,,-
87171530,2023-02-01,808.3199999999999,102.91,Incoming
87171530,2023-02-03,700.52,107.8,Outgoing
87171530,2023-02-05,755.9,55.38,Incoming
87171530,2023-02-06,734.78,21.12,Outgoing
87171530,2023-02-06,1519.08,784.3,Incoming
87171530,2023-02-10,1558.56,39.48,Incoming
87171530,2023-02-10,1446.2,112.36,Outgoing
87171530,2023-02-11,1263.52,182.68,Outgoing
87171530,2023-02-13,1299.95,36.43,Incoming
87171530,2023-02-14,1413.73,113.78,Incoming
87179572,2023-01-31,527.23,,-
87179572,2023-02-01,-765.27,1292.5,Outgoing
87179572,2023-02-02,-657.8,107.47,Incoming
87179572,2023-02-03,-732.3,74.5,Outgoing
87179572,2023-02-04,-917.93,185.63,Outgoing
87179572,2023-02-05,-848.0,69.93,Incoming
87179572,2023-02-07,-738.5699999999999,109.43,Incoming
87179572,2023-02-07,-695.29,43.28,Incoming
87179572,2023-02-13,-786.72,91.43,Outgoing
87179572,2023-02-13,-1010.6,223.88,Outgoing
87195449,2023-01-31,493.58,,-
87195449,2023-02-09,366.77,126.81,Outgoing
87195449,2023-02-10,255.86999999999998,110.9,Outgoing
87195449,2023-02-13,701.67,445.8,Incoming
87231063,2023-01-31,305.69,,-
87231063,2023-02-04,221.74,83.95,Outgoing
87231063,2023-02-07,318.6,96.86,Incoming
87261089,2023-01-31,613.62,,-
87261089,2023-02-13,461.02,152.6,Outgoing
87261106,2023-01-31,203.16,,-
87261106,2023-02-06,261.04,57.88,Incoming
87261106,2023-02-08,285.98,24.94,Incoming
87261106,2023-02-09,341.40000000000003,55.42,Incoming
87261106,2023-02-09,468.21000000000004,126.81,Incoming
87261106,2023-02-09,280.43000000000006,187.78,Outgoing
87261106,2023-02-11,429.71000000000004,149.28,Incoming
87261106,2023-02-13,447.75000000000006,18.04,Incoming
87276000,2023-01-31,826.21,,-
87276000,2023-02-01,706.33,119.88,Outgoing
87276000,2023-02-01,526.73,179.6,Outgoing
87276000,2023-02-05,601.1,74.37,Incoming
87276000,2023-02-09,554.8000000000001,46.3,Outgoing
87276000,2023-02-10,595.0000000000001,40.2,Incoming
87276000,2023-02-13,504.60000000000014,90.4,Outgoing
87297577,2023-01-31,351.06,,-
87297577,2023-02-03,241.32,109.74,Outgoing
87297577,2023-02-03,343.07,101.75,Incoming
87297577,2023-02-04,498.64,155.57,Incoming
87297577,2023-02-05,381.09999999999997,117.54,Outgoing
87297577,2023-02-14,430.49999999999994,49.4,Incoming
87325576,2023-01-31,354.27,,-
87325576,2023-02-01,539.72,185.45,Incoming
87325576,2023-02-03,405.59000000000003,134.13,Outgoing
87325576,2023-02-07,484.91,79.32,Incoming
87325576,2023-02-10,681.1500000000001,196.24,Incoming
87325576,2023-02-11,564.7800000000001,116.37,Outgoing
87325576,2023-02-13,562.5200000000001,2.26,Outgoing
87356428,2023-01-31,705.05,,-
87356428,2023-02-06,662.8599999999999,42.19,Outgoing
87356428,2023-02-08,583.6999999999999,79.16,Outgoing
87356428,2023-02-10,481.9599999999999,101.74,Outgoing
87356428,2023-02-10,268.1599999999999,213.8,Outgoing
87373821,2023-01-31,945.0,,-
87373821,2023-02-01,1014.91,69.91,Incoming
87373821,2023-02-01,1178.73,163.82,Incoming
87373821,2023-02-03,1150.85,27.88,Outgoing
87373821,2023-02-06,151.7499999999999,999.1,Outgoing
87373821,2023-02-07,206.0299999999999,54.28,Incoming
87373821,2023-02-08,317.07999999999987,111.05,Incoming
87373821,2023-02-08,183.42999999999986,133.65,Outgoing
87373821,2023-02-14,7.949999999999875,175.48,Outgoing
87433733,2023-01-31,34.77,,-
87433733,2023-02-02,-69.94999999999999,104.72,Outgoing
87433733,2023-02-02,69.30000000000001,139.25,Incoming
87433733,2023-02-05,140.47000000000003,71.17,Incoming
87433733,2023-02-06,224.23000000000002,83.76,Incoming
87433733,2023-02-08,382.9,158.67,Incoming
87433733,2023-02-09,143.79999999999998,239.1,Outgoing
87433733,2023-02-12,283.54999999999995,139.75,Incoming
87433733,2023-02-13,443.18999999999994,159.64,Incoming
87456121,2023-01-31,257.5,,-
87456121,2023-02-01,180.81,76.69,Outgoing
87456121,2023-02-06,210.76,29.95,Incoming
87456121,2023-02-09,269.46999999999997,58.71,Incoming
87456121,2023-02-09,351.60999999999996,82.14,Incoming
87456121,2023-02-10,289.29999999999995,62.31,Outgoing
87456121,2023-02-11,238.11999999999995,51.18,Outgoing
87504607,2023-01-31,605.63,,-
87504607,2023-02-01,519.42,86.21,Outgoing
87504607,2023-02-03,427.44999999999993,91.97,Outgoing
87504607,2023-02-11,510.93999999999994,83.49,Incoming
87504607,2023-02-11,368.40999999999997,142.53,Outgoing
87504607,2023-02-13,206.35999999999996,162.05,Outgoing
87533652,2023-01-31,156.61,,-
87533652,2023-02-03,134.04000000000002,22.57,Outgoing
87533652,2023-02-06,310.44000000000005,176.4,Incoming
87533652,2023-02-07,378.32000000000005,67.88,Incoming
87533652,2023-02-07,178.35000000000005,199.97,Outgoing
87533652,2023-02-10,25.160000000000053,153.19,Outgoing
87533652,2023-02-14,-56.09999999999995,81.26,Outgoing
87543952,2023-01-31,14.85,,-
87543952,2023-02-07,108.72999999999999,93.88,Incoming
87543952,2023-02-08,31.689999999999984,77.04,Outgoing
87543952,2023-02-09,-94.25000000000001,125.94,Outgoing
87543952,2023-02-11,-206.49,112.24,Outgoing
87556975,2023-01-31,657.17,,-
87556975,2023-02-02,714.2099999999999,57.04,Incoming
87556975,2023-02-05,914.4099999999999,200.2,Incoming
87556975,2023-02-06,1087.6799999999998,173.27,Incoming
87556975,2023-02-07,-284.82000000000016,1372.5,Outgoing
87556975,2023-02-13,-384.60000000000014,99.78,Outgoing
87556975,2023-02-14,-1853.9,1469.3,Outgoing
87726203,2023-01-31,55.92,,-
87726203,2023-02-06,-96.24,152.16,Outgoing
87726203,2023-02-07,-74.63,21.61,Incoming
87726203,2023-02-09,49.7,124.33,Incoming
87726203,2023-02-10,107.33000000000001,57.63,Incoming
87726203,2023-02-12,135.9,28.57,Incoming
87735660,2023-01-31,990.25,,-
87735660,2023-02-03,962.25,28.0,Outgoing
87735660,2023-02-04,1045.12,82.87,Incoming
87735660,2023-02-11,1109.9599999999998,64.84,Incoming
87735660,2023-02-11,1248.9499999999998,138.99,Incoming
87735660,2023-02-12,1147.12,101.83,Outgoing
87735660,2023-02-13,994.1999999999999,152.92,Outgoing
87735660,2023-02-13,914.3899999999999,79.81,Outgoing
87746071,2023-01-31,215.91,,-
87746071,2023-02-01,322.21,106.3,Incoming
87746071,2023-02-06,187.17,135.04,Outgoing
87746071,2023-02-14,-72.13000000000002,259.3,Outgoing
87801896,2023-01-31,181.56,,-
87801896,2023-02-03,-1450.44,1632.0,Outgoing
87801896,2023-02-05,-1568.99,118.55,Outgoing
87801896,2023-02-06,-1677.13,108.14,Outgoing
87801896,2023-02-12,-1506.0100000000002,171.12,Incoming
87807990,2023-01-31,317.4,,-
87807990,2023-02-01,244.60999999999996,72.79,Outgoing
87807990,2023-02-02,342.0799999999999,97.47,Incoming
87807990,2023-02-04,-615.4200000000001,957.5,Outgoing
87807990,2023-02-06,-794.3000000000001,178.88,Outgoing
87807990,2023-02-08,-851.6200000000001,57.32,Outgoing
87807990,2023-02-10,-890.5000000000001,38.88,Outgoing
87817645,2023-01-31,983.36,,-
87817645,2023-02-01,802.25,181.11,Outgoing
87817645,2023-02-03,819.51,17.26,Incoming
87817645,2023-02-04,754.5799999999999,64.93,Outgoing
87817645,2023-02-05,869.06,114.48,Incoming
87817645,2023-02-05,1010.5699999999999,141.51,Incoming
87817645,2023-02-06,1670.87,660.3,Incoming
87817645,2023-02-08,1774.76,103.89,Incoming
87817645,2023-02-09,1930.52,155.76,Incoming
87817645,2023-02-10,1849.61,80.91,Outgoing
87817645,2023-02-10,1233.5099999999998,616.1,Outgoing
87827496,2023-01-31,935.66,,-
87827496,2023-02-02,1039.05,103.39,Incoming
87827496,2023-02-05,1146.85,107.8,Incoming
87827496,2023-02-13,1074.1999999999998,72.65,Outgoing
87836000,2023-01-31,937.46,,-
87836000,2023-02-07,1052.6100000000001,115.15,Incoming
87836000,2023-02-13,1146.5800000000002,93.97,Incoming
87876065,2023-01-31,627.15,,-
87876065,2023-02-01,-1194.4499999999998,1821.6,Outgoing
87876065,2023-02-01,-1317.7399999999998,123.29,Outgoing
87876065,2023-02-11,-1457.8899999999999,140.15,Outgoing
87876065,2023-02-11,-1382.2399999999998,75.65,Incoming
87876065,2023-02-12,-1297.8399999999997,84.4,Incoming
87876065,2023-02-14,-1233.3899999999996,64.45,Incoming
87906438,2023-01-31,196.99,,-
87906438,2023-02-05,341.65999999999997,144.67,Incoming
87906438,2023-02-07,340.83,0.83,Outgoing
87906438,2023-02-09,204.35,136.48,Outgoing
87906438,2023-02-10,280.33,75.98,Incoming
87906438,2023-02-10,240.13,40.2,Outgoing
87906438,2023-02-10,65.18,174.95,Outgoing
87906438,2023-02-12,165.17000000000002,99.99,Incoming
87906438,2023-02-12,5.350000000000023,159.82,Outgoing
87911550,2023-01-31,149.29,,-
87911550,2023-02-02,240.82999999999998,91.54,Incoming
87911550,2023-02-04,166.07999999999998,74.75,Outgoing
87911550,2023-02-11,238.83999999999997,72.76,Incoming
87911550,2023-02-13,214.51999999999998,24.32,Outgoing
87913244,2023-01-31,730.48,,-
87913244,2023-02-01,593.53,136.95,Outgoing
87913244,2023-02-02,830.55,237.02,Incoming
87913244,2023-02-06,953.8599999999999,123.31,Incoming
87913244,2023-02-08,1008.4199999999998,54.56,Incoming
87913244,2023-02-08,903.8699999999999,104.55,Outgoing
87913244,2023-02-10,1113.9399999999998,210.07,Incoming
87913244,2023-02-11,1253.0099999999998,139.07,Incoming
87913244,2023-02-12,1384.5899999999997,131.58,Incoming
87967388,2023-01-31,682.7,,-
87967388,2023-02-03,797.3000000000001,114.6,Incoming
87967388,2023-02-05,662.2600000000001,135.04,Outgoing
87967388,2023-02-05,585.2600000000001,77.0,Outgoing
87967388,2023-02-10,-347.03999999999985,932.3,Outgoing
87967388,2023-02-12,535.6600000000002,882.7,Incoming
87967388,2023-02-13,2894.76,2359.1,Incoming
87967388,2023-02-13,2805.53,89.23,Outgoing
87967388,2023-02-13,1412.4300000000003,1393.1,Outgoing
87967388,2023-02-14,1549.8000000000002,137.37,Incoming
88033693,2023-01-31,917.7,,-
88033693,2023-02-06,1031.8500000000001,114.15,Incoming
88033693,2023-02-07,1141.2400000000002,109.39,Incoming
88033693,2023-02-07,1122.0300000000002,19.21,Outgoing
88033693,2023-02-09,1040.8100000000002,81.22,Outgoing
88033693,2023-02-12,1060.3700000000001,19.56,Incoming
88040274,2023-01-31,550.79,,-
88040274,2023-02-03,639.93,89.14,Incoming
88040274,2023-02-05,481.65999999999997,158.27,Outgoing
88040274,2023-02-06,-1261.8400000000001,1743.5,Outgoing
88040274,2023-02-14,-1338.15,76.31,Outgoing
88074391,2023-01-31,851.54,,-
88074391,2023-02-02,962.75,111.21,Incoming
88074391,2023-02-05,1090.27,127.52,Incoming
88074391,2023-02-06,975.0799999999999,115.19,Outgoing
88074391,2023-02-09,1058.34,83.26,Incoming
88074391,2023-02-10,1179.78,121.44,Incoming
88106566,2023-01-31,477.78,,-
88106566,2023-02-02,384.26,93.52,Outgoing
88106566,2023-02-02,172.98999999999998,211.27,Outgoing
88106566,2023-02-03,394.1,221.11,Incoming
88106566,2023-02-05,381.87,12.23,Outgoing
88106566,2023-02-09,241.61,140.26,Outgoing
88106566,2023-02-14,376.3,134.69,Incoming
88160468,2023-01-31,640.07,,-
88160468,2023-02-01,724.1,84.03,Incoming
88160468,2023-02-01,1766.0,1041.9,Incoming
88160468,2023-02-04,1638.2,127.8,Outgoing
88160468,2023-02-07,1591.89,46.31,Outgoing
88160468,2023-02-08,1695.5800000000002,103.69,Incoming
88160468,2023-02-09,1552.9900000000002,142.59,Outgoing
88160468,2023-02-12,1696.4600000000003,143.47,Incoming
88160468,2023-02-13,1652.2900000000002,44.17,Outgoing
88160468,2023-02-14,1803.3100000000002,151.02,Incoming
88229109,2023-01-31,730.76,,-
88229109,2023-02-05,795.86,65.1,Incoming
88229109,2023-02-10,613.05,182.81,Outgoing
88229109,2023-02-12,546.03,67.02,Outgoing
88229109,2023-02-12,469.42999999999995,76.6,Outgoing
88229109,2023-02-12,328.60999999999996,140.82,Outgoing
88229109,2023-02-14,213.28999999999996,115.32,Outgoing
88235115,2023-01-31,150.58,,-
88235115,2023-02-02,287.75,137.17,Incoming
88235115,2023-02-02,339.03,51.28,Incoming
88235115,2023-02-05,171.17999999999998,167.85,Outgoing
88235115,2023-02-07,245.28999999999996,74.11,Incoming
88235115,2023-02-08,155.31999999999996,89.97,Outgoing
88235115,2023-02-08,274.26,118.94,Incoming
88235115,2023-02-09,175.27999999999997,98.98,Outgoing
88235115,2023-02-12,972.98,797.7,Incoming
88235115,2023-02-12,818.4200000000001,154.56,Outgoing
88235115,2023-02-14,1462.3200000000002,643.9,Incoming
88285378,2023-01-31,473.79,,-
88285378,2023-02-03,379.0,94.79,Outgoing
88285378,2023-02-06,-508.9,887.9,Outgoing
88285378,2023-02-08,-689.29,180.39,Outgoing
88285378,2023-02-09,-458.31999999999994,230.97,Incoming
88285378,2023-02-14,-353.78999999999996,104.53,Incoming
88293767,2023-01-31,487.22,,-
88293767,2023-02-04,589.9300000000001,102.71,Incoming
88293767,2023-02-07,672.72,82.79,Incoming
88293767,2023-02-09,738.1,65.38,Incoming
88306714,2023-01-31,808.0,,-
88306714,2023-02-08,771.29,36.71,Outgoing
88306714,2023-02-13,885.8299999999999,114.54,Incoming
88306714,2023-02-14,998.55,112.72,Incoming
88343796,2023-01-31,338.0,,-
88343796,2023-02-02,562.12,224.12,Incoming
88343796,2023-02-08,592.69,30.57,Incoming
88343796,2023-02-11,526.6200000000001,66.07,Outgoing
88381437,2023-01-31,472.65,,-
88381437,2023-02-04,573.5899999999999,100.94,Incoming
88381437,2023-02-05,647.8,74.21,Incoming
88381437,2023-02-05,713.3399999999999,65.54,Incoming
88399132,2023-01-31,751.13,,-
88399132,2023-02-02,695.11,56.02,Outgoing
88399132,2023-02-03,778.8,83.69,Incoming
88399132,2023-02-08,582.8499999999999,195.95,Outgoing
88399132,2023-02-10,513.1599999999999,69.69,Outgoing
88399132,2023-02-10,361.55999999999983,151.6,Outgoing
88399132,2023-02-11,329.55999999999983,32.0,Outgoing
88399132,2023-02-14,488.64999999999986,159.09,Incoming
88436283,2023-01-31,689.71,,-
88436283,2023-02-09,923.62,233.91,Incoming
88466448,2023-01-31,920.61,,-
88466448,2023-02-03,2374.11,1453.5,Incoming
88466448,2023-02-03,3014.51,640.4,Incoming
88466448,2023-02-04,3093.98,79.47,Incoming
88466448,2023-02-04,2962.87,131.11,Outgoing
88466448,2023-02-05,3014.13,51.26,Incoming
88466448,2023-02-05,2387.03,627.1,Outgoing
88466448,2023-02-07,2530.07,143.04,Incoming
88466448,2023-02-08,2588.8900000000003,58.82,Incoming
88466448,2023-02-09,2577.4200000000005,11.47,Outgoing
88466448,2023-02-10,2699.3900000000003,121.97,Incoming
88466448,2023-02-12,2586.8100000000004,112.58,Outgoing
88476961,2023-01-31,524.76,,-
88476961,2023-02-01,448.90999999999997,75.85,Outgoing
88476961,2023-02-04,362.76,86.15,Outgoing
88476961,2023-02-05,224.1,138.66,Outgoing
88476961,2023-02-07,148.14999999999998,75.95,Outgoing
88476961,2023-02-10,203.27999999999997,55.13,Incoming
88476961,2023-02-11,337.05999999999995,133.78,Incoming
88482062,2023-01-31,149.31,,-
88482062,2023-02-01,470.51,321.2,Incoming
88482062,2023-02-07,340.28,130.23,Outgoing
88482062,2023-02-07,255.02999999999997,85.25,Outgoing
88482062,2023-02-08,1351.23,1096.2,Incoming
88482062,2023-02-10,1438.3,87.07,Incoming
88489173,2023-01-31,476.26,,-
88489173,2023-02-01,307.08,169.18,Outgoing
88489173,2023-02-02,422.16999999999996,115.09,Incoming
88489173,2023-02-08,422.64,0.47,Incoming
88489173,2023-02-09,568.35,145.71,Incoming
88489173,2023-02-13,702.32,133.97,Incoming
88538200,2023-01-31,518.77,,-
88538200,2023-02-02,602.66,83.89,Incoming
88538200,2023-02-06,561.75,40.91,Outgoing
88538200,2023-02-10,-832.3499999999999,1394.1,Outgoing
88538200,2023-02-12,-960.18,127.83,Outgoing
88538200,2023-02-12,-2037.48,1077.3,Outgoing
88538200,2023-02-13,-2113.57,76.09,Outgoing
88551691,2023-01-31,979.24,,-
88551691,2023-02-01,889.83,89.41,Outgoing
88551691,2023-02-05,-246.57000000000005,1136.4,Outgoing
88551691,2023-02-07,-171.54000000000005,75.03,Incoming
88551691,2023-02-08,-52.77000000000005,118.77,Incoming
88558016,2023-01-31,156.64,,-
88558016,2023-02-04,72.10999999999999,84.53,Outgoing
88558016,2023-02-09,109.75999999999999,37.65,Incoming
88558016,2023-02-12,24.929999999999993,84.83,Outgoing
88558016,2023-02-12,-51.58000000000001,76.51,Outgoing
88558016,2023-02-14,-128.51000000000002,76.93,Outgoing
88568543,2023-01-31,472.83,,-
88568543,2023-02-01,641.17,168.34,Incoming
88568543,2023-02-02,1364.17,723.0,Incoming
88568543,2023-02-02,1450.79,86.62,Incoming
88568543,2023-02-03,1553.1399999999999,102.35,Incoming
88568543,2023-02-07,1427.11,126.03,Outgoing
88568543,2023-02-10,1492.6499999999999,65.54,Incoming
88568543,2023-02-11,276.8499999999999,1215.8,Outgoing
88568543,2023-02-13,250.6099999999999,26.24,Outgoing
88568543,2023-02-14,267.7199999999999,17.11,Incoming
88570753,2023-01-31,62.48,,-
88570753,2023-02-07,162.04,99.56,Incoming
88570753,2023-02-07,-1278.8600000000001,1440.9,Outgoing
88570753,2023-02-09,-1151.3300000000002,127.53,Incoming
88570753,2023-02-12,-1060.67,90.66,Incoming
88570753,2023-02-14,-1150.5700000000002,89.9,Outgoing
88580402,2023-01-31,118.18,,-
88580402,2023-02-01,13.710000000000008,104.47,Outgoing
88580402,2023-02-03,-45.29999999999999,59.01,Outgoing
88580402,2023-02-06,-188.6,143.3,Outgoing
88580402,2023-02-09,-104.61,83.99,Incoming
88580402,2023-02-14,71.08999999999999,175.7,Incoming
88646863,2023-01-31,250.52,,-
88646863,2023-02-03,215.20000000000002,35.32,Outgoing
88646863,2023-02-08,-732.5999999999999,947.8,Outgoing
88657589,2023-01-31,712.85,,-
88657589,2023-02-03,810.8100000000001,97.96,Incoming
88657589,2023-02-04,716.09,94.72,Outgoing
88657589,2023-02-05,618.0600000000001,98.03,Outgoing
88657589,2023-02-07,567.57,50.49,Outgoing
88657589,2023-02-09,556.37,11.2,Outgoing
88657589,2023-02-09,392.38,163.99,Outgoing
88657589,2023-02-10,521.71,129.33,Incoming
88657589,2023-02-13,495.00000000000006,26.71,Outgoing
88657589,2023-02-14,417.6,77.4,Outgoing
88676459,2023-01-31,285.95,,-
88676459,2023-02-01,191.39,94.56,Outgoing
88676459,2023-02-03,684.89,493.5,Incoming
88676459,2023-02-09,798.39,113.5,Incoming
88676459,2023-02-12,981.92,183.53,Incoming
88676459,2023-02-14,1024.86,42.94,Incoming
88681540,2023-01-31,531.01,,-
88681540,2023-02-01,408.55,122.46,Outgoing
88681540,2023-02-01,567.14,158.59,Incoming
88681540,2023-02-03,578.5,11.36,Incoming
88681540,2023-02-08,675.16,96.66,Incoming
88681540,2023-02-13,530.3399999999999,144.82,Outgoing
88710457,2023-01-31,818.28,,-
88710457,2023-02-03,867.56,49.28,Incoming
88710457,2023-02-03,938.3599999999999,70.8,Incoming
88710457,2023-02-09,782.3299999999999,156.03,Outgoing
88710457,2023-02-11,910.3999999999999,128.07,Incoming
88710457,2023-02-14,1047.77,137.37,Incoming
88732093,2023-01-31,57.56,,-
88732093,2023-02-01,-23.929999999999993,81.49,Outgoing
88732093,2023-02-01,108.59000000000002,132.52,Incoming
88732093,2023-02-06,-769.7099999999999,878.3,Outgoing
88732093,2023-02-06,-2272.31,1502.6,Outgoing
88732093,2023-02-08,-2183.81,88.5,Incoming
88732093,2023-02-12,-2019.52,164.29,Incoming
88824263,2023-01-31,295.9,,-
88824263,2023-02-01,324.84999999999997,28.95,Incoming
88824263,2023-02-02,363.63,38.78,Incoming
88824263,2023-02-09,495.74,132.11,Incoming
88824263,2023-02-12,464.54,31.2,Outgoing
88824263,2023-02-12,331.41,133.13,Outgoing
88831746,2023-01-31,565.27,,-
88831746,2023-02-03,437.02,128.25,Outgoing
88831746,2023-02-04,538.51,101.49,Incoming
88831746,2023-02-07,473.83,64.68,Outgoing
88831746,2023-02-08,653.13,179.3,Incoming
88831746,2023-02-10,448.41999999999996,204.71,Outgoing
88834465,2023-01-31,18.3,,-
88834465,2023-02-05,105.36,87.06,Incoming
88834465,2023-02-06,79.32,26.04,Outgoing
88834465,2023-02-10,479.42,400.1,Incoming
88837750,2023-01-31,269.14,,-
88837750,2023-02-03,152.29999999999998,116.84,Outgoing
88837750,2023-02-04,40.55999999999999,111.74,Outgoing
88837750,2023-02-05,101.80999999999999,61.25,Incoming
88837750,2023-02-06,229.39999999999998,127.59,Incoming
88837750,2023-02-07,255.48999999999998,26.09,Incoming
88837750,2023-02-09,293.83,38.34,Incoming
88837750,2023-02-10,106.13999999999999,187.69,Outgoing
88837750,2023-02-10,255.67,149.53,Incoming
88837750,2023-02-12,178.85,76.82,Outgoing
88857879,2023-01-31,601.01,,-
88857879,2023-02-03,617.4399999999999,16.43,Incoming
88857879,2023-02-08,531.0799999999999,86.36,Outgoing
88857879,2023-02-11,349.8299999999999,181.25,Outgoing
88857879,2023-02-11,435.2399999999999,85.41,Incoming
88926132,2023-01-31,275.1,,-
88926132,2023-02-02,262.45000000000005,12.65,Outgoing
88926132,2023-02-04,644.0500000000001,381.6,Incoming
88926132,2023-02-04,-974.15,1618.2,Outgoing
88926132,2023-02-04,-2005.5500000000002,1031.4,Outgoing
88926132,2023-02-07,-1940.8700000000001,64.68,Incoming
88926132,2023-02-08,-2054.25,113.38,Outgoing
88926132,2023-02-10,-1978.58,75.67,Incoming
88926132,2023-02-13,-1862.06,116.52,Incoming
88926132,2023-02-13,402.24000000000024,2264.3,Incoming
88926132,2023-02-13,249.66000000000022,152.58,Outgoing
88926132,2023-02-14,73.96000000000024,175.7,Outgoing
88933315,2023-01-31,289.79,,-
88933315,2023-02-01,188.71000000000004,101.08,Outgoing
88933315,2023-02-01,73.31000000000003,115.4,Outgoing
88933315,2023-02-06,188.05,114.74,Incoming
88933315,2023-02-09,270.13,82.08,Incoming
88933315,2023-02-09,161.79,108.34,Outgoing
88933315,2023-02-11,312.04999999999995,150.26,Incoming
88933315,2023-02-11,2140.95,1828.9,Incoming
88933315,2023-02-13,2202.14,61.19,Incoming
88933315,2023-02-14,2114.91,87.23,Outgoing
88933315,2023-02-14,2272.3399999999997,157.43,Incoming
88968006,2023-01-31,952.66,,-
88968006,2023-02-02,895.62,57.04,Outgoing
88968006,2023-02-04,1025.32,129.7,Incoming
88968006,2023-02-04,1115.27,89.95,Incoming
88968006,2023-02-08,938.3299999999999,176.94,Outgoing
88974311,2023-01-31,501.47,,-
88974311,2023-02-01,654.0600000000001,152.59,Incoming
88974311,2023-02-02,807.26,153.2,Incoming
89065134,2023-01-31,447.32,,-
89065134,2023-02-02,540.84,93.52,Incoming
89065134,2023-02-02,652.75,111.91,Incoming
89065134,2023-02-02,499.71000000000004,153.04,Outgoing
89065134,2023-02-02,619.6,119.89,Incoming
89065134,2023-02-14,740.0600000000001,120.46,Incoming
89088715,2023-01-31,336.6,,-
89088715,2023-02-02,-843.6,1180.2,Outgoing
89088715,2023-02-03,-879.74,36.14,Outgoing
89088715,2023-02-04,-983.98,104.24,Outgoing
89088715,2023-02-07,-918.02,65.96,Incoming
89088715,2023-02-10,-854.67,63.35,Incoming
89088715,2023-02-11,-933.73,79.06,Outgoing
89088715,2023-02-12,-1011.27,77.54,Outgoing
89088715,2023-02-14,-1128.61,117.34,Outgoing
89117536,2023-01-31,123.22,,-
89117536,2023-02-02,-27.349999999999994,150.57,Outgoing
89117536,2023-02-02,-101.85,74.5,Outgoing
89117536,2023-02-06,-129.41,27.56,Outgoing
89194917,2023-01-31,332.56,,-
89194917,2023-02-08,271.16,61.4,Outgoing
89194917,2023-02-10,370.82000000000005,99.66,Incoming
89194917,2023-02-12,493.14000000000004,122.32,Incoming
89194917,2023-02-13,568.9100000000001,75.77,Incoming
89223056,2023-01-31,139.98,,-
89223056,2023-02-08,-9.659999999999997,149.64,Outgoing
89223056,2023-02-09,29.42,39.08,Incoming
89223056,2023-02-09,127.48,98.06,Incoming
89223056,2023-02-09,268.88,141.4,Incoming
89223056,2023-02-11,220.1,48.78,Outgoing
89223056,2023-02-14,-1440.1000000000001,1660.2,Outgoing
89225677,2023-01-31,660.05,,-
89225677,2023-02-04,712.81,52.76,Incoming
89225677,2023-02-05,793.04,80.23,Incoming
89225677,2023-02-06,768.66,24.38,Outgoing
89225677,2023-02-06,909.72,141.06,Incoming
89225677,2023-02-07,-197.87999999999988,1107.6,Outgoing
89225677,2023-02-09,-74.03999999999988,123.84,Incoming
89225677,2023-02-11,-164.88999999999987,90.85,Outgoing
89225677,2023-02-12,-59.98999999999987,104.9,Incoming
89225677,2023-02-12,-167.98999999999987,108.0,Outgoing
89244577,2023-01-31,706.67,,-
89244577,2023-02-02,151.16999999999996,555.5,Outgoing
89244577,2023-02-05,16.619999999999948,134.55,Outgoing
89244577,2023-02-06,67.47999999999995,50.86,Incoming
89244577,2023-02-06,184.93999999999994,117.46,Incoming
89244577,2023-02-08,281.5199999999999,96.58,Incoming
89244577,2023-02-09,177.7199999999999,103.8,Outgoing
89244577,2023-02-11,299.9299999999999,122.21,Incoming
89244577,2023-02-12,244.0799999999999,55.85,Outgoing
89309725,2023-01-31,858.68,,-
89309725,2023-02-02,982.91,124.23,Incoming
89309725,2023-02-03,-470.59000000000003,1453.5,Outgoing
89309725,2023-02-04,-334.70000000000005,135.89,Incoming
89309725,2023-02-07,-456.61,121.91,Outgoing
89309725,2023-02-08,-520.41,63.8,Outgoing
89309725,2023-02-09,-565.48,45.07,Outgoing
89309725,2023-02-12,-711.72,146.24,Outgoing
89318229,2023-01-31,675.08,,-
89318229,2023-02-02,773.59,98.51,Incoming
89318229,2023-02-02,846.3100000000001,72.72,Incoming
89318229,2023-02-07,636.58,209.73,Outgoing
89318229,2023-02-08,503.98,132.6,Outgoing
89318229,2023-02-09,457.61,46.37,Outgoing
89318229,2023-02-14,543.27,85.66,Incoming
89353946,2023-01-31,809.48,,-
89353946,2023-02-05,667.29,142.19,Outgoing
89353946,2023-02-07,668.3199999999999,1.03,Incoming
89353946,2023-02-07,550.8699999999999,117.45,Outgoing
89353946,2023-02-08,645.8299999999999,94.96,Incoming
89353946,2023-02-11,807.0799999999999,161.25,Incoming
89369216,2023-01-31,404.56,,-
89369216,2023-02-01,503.65,99.09,Incoming
89369216,2023-02-02,446.14,57.51,Outgoing
89369216,2023-02-06,533.96,87.82,Incoming
89369216,2023-02-07,440.77000000000004,93.19,Outgoing
89369216,2023-02-07,582.76,141.99,Incoming
89369216,2023-02-08,502.03999999999996,80.72,Outgoing
89369216,2023-02-10,609.5999999999999,107.56,Incoming
89369216,2023-02-10,548.4399999999999,61.16,Outgoing
89369216,2023-02-10,448.2099999999999,100.23,Outgoing
89369216,2023-02-11,-1496.69,1944.9,Outgoing
89406032,2023-01-31,453.31,,-
89406032,2023-02-05,629.6800000000001,176.37,Incoming
89406032,2023-02-05,753.47,123.79,Incoming
89406032,2023-02-11,895.1800000000001,141.71,Incoming
89407337,2023-01-31,211.2,,-
89438779,2023-01-31,347.92,,-
89438779,2023-02-01,452.49,104.57,Incoming
89438779,2023-02-02,657.71,205.22,Incoming
89438779,2023-02-02,679.4200000000001,21.71,Incoming
89438779,2023-02-07,793.0200000000001,113.6,Incoming
89438779,2023-02-07,652.8800000000001,140.14,Outgoing
89438779,2023-02-07,527.1700000000001,125.71,Outgoing
89438779,2023-02-12,596.6100000000001,69.44,Incoming
89438779,2023-02-12,398.41000000000014,198.2,Outgoing
89438779,2023-02-13,-664.0899999999999,1062.5,Outgoing
89471153,2023-01-31,52.29,,-
89471153,2023-02-12,-101.35,153.64,Outgoing
89471153,2023-02-13,-182.76,81.41,Outgoing
89471153,2023-02-13,-67.97999999999999,114.78,Incoming
89471153,2023-02-14,0.14000000000001478,68.12,Incoming
89497773,2023-01-31,637.02,,-
89497773,2023-02-02,506.0,131.02,Outgoing
89497773,2023-02-03,600.5699999999999,94.57,Incoming
89497773,2023-02-04,700.9599999999999,100.39,Incoming
89497773,2023-02-06,756.4799999999999,55.52,Incoming
89497773,2023-02-07,615.4699999999999,141.01,Outgoing
89497773,2023-02-07,564.54,50.93,Outgoing
89497773,2023-02-09,441.18999999999994,123.35,Outgoing
89497773,2023-02-12,317.80999999999995,123.38,Outgoing
89497773,2023-02-14,490.77,172.96,Incoming
89503991,2023-01-31,204.52,,-
89503991,2023-02-02,109.44000000000001,95.08,Outgoing
89503991,2023-02-09,37.140000000000015,72.3,Outgoing
89503991,2023-02-12,-993.5600000000001,1030.7,Outgoing
89608054,2023-01-31,495.15,,-
89608054,2023-02-04,414.78,80.37,Outgoing
89608054,2023-02-11,322.15999999999997,92.62,Outgoing
89608054,2023-02-12,408.89,86.73,Incoming
89608054,2023-02-12,218.72,190.17,Outgoing
89608054,2023-02-14,334.81,116.09,Incoming
89629293,2023-01-31,292.31,,-
89629293,2023-02-11,416.87,124.56,Incoming
89629293,2023-02-14,608.39,191.52,Incoming
89632856,2023-01-31,557.83,,-
89632856,2023-02-02,683.99,126.16,Incoming
89632856,2023-02-03,803.94,119.95,Incoming
89632856,2023-02-06,753.1,50.84,Outgoing
89632856,2023-02-08,2661.8,1908.7,Incoming
89645445,2023-01-31,287.29,,-
89645445,2023-02-03,399.44000000000005,112.15,Incoming
89645445,2023-02-09,-1326.96,1726.4,Outgoing
89650416,2023-01-31,146.17,,-
89650416,2023-02-01,352.05999999999995,205.89,Incoming
89650416,2023-02-04,479.73999999999995,127.68,Incoming
89650416,2023-02-10,408.29999999999995,71.44,Outgoing
89650416,2023-02-12,528.42,120.12,Incoming
89650416,2023-02-12,473.03,55.39,Outgoing
89689059,2023-01-31,906.88,,-
89689059,2023-02-02,1080.77,173.89,Incoming
89689059,2023-02-03,1179.91,99.14,Incoming
89689059,2023-02-04,1256.3500000000001,76.44,Incoming
89689059,2023-02-06,1156.17,100.18,Outgoing
89689059,2023-02-06,1225.8500000000001,69.68,Incoming
89689059,2023-02-09,2802.45,1576.6,Incoming
89689059,2023-02-14,2698.56,103.89,Outgoing
89697097,2023-01-31,449.71,,-
89697097,2023-02-02,321.34999999999997,128.36,Outgoing
89697097,2023-02-08,2058.75,1737.4,Incoming
89697097,2023-02-13,2014.37,44.38,Outgoing
89697097,2023-02-14,1913.54,100.83,Outgoing
89720252,2023-01-31,672.88,,-
89720252,2023-02-03,581.86,91.02,Outgoing
89720252,2023-02-03,480.33000000000004,101.53,Outgoing
89720252,2023-02-11,535.35,55.02,Incoming
89720252,2023-02-12,342.6,192.75,Outgoing
89720252,2023-02-13,160.46000000000004,182.14,Outgoing
89720252,2023-02-14,120.33000000000004,40.13,Outgoing
89761152,2023-01-31,923.01,,-
89761152,2023-02-05,1089.04,166.03,Incoming
89761152,2023-02-06,1133.47,44.43,Incoming
89761152,2023-02-09,2499.17,1365.7,Incoming
89761152,2023-02-11,2566.23,67.06,Incoming
89761152,2023-02-11,2710.4,144.17,Incoming
89761152,2023-02-12,2620.9700000000003,89.43,Outgoing
89761152,2023-02-12,2535.9300000000003,85.04,Outgoing
89761152,2023-02-14,2635.1400000000003,99.21,Incoming
89905732,2023-01-31,883.38,,-
89905732,2023-02-02,2804.78,1921.4,Incoming
89905732,2023-02-05,2946.07,141.29,Incoming
89905732,2023-02-05,3074.8500000000004,128.78,Incoming
89905732,2023-02-10,1927.3500000000004,1147.5,Outgoing
89905732,2023-02-14,1770.7900000000004,156.56,Outgoing
89916489,2023-01-31,726.43,,-
89916489,2023-02-01,900.43,174.0,Incoming
89916489,2023-02-03,798.68,101.75,Outgoing
89916489,2023-02-06,880.2099999999999,81.53,Incoming
89972805,2023-01-31,456.55,,-
89972805,2023-02-08,421.35,35.2,Outgoing
89983842,2023-01-31,880.93,,-
89983842,2023-02-03,841.56,39.37,Outgoing
89983842,2023-02-05,922.4499999999999,80.89,Incoming
89983842,2023-02-07,862.05,60.4,Outgoing
89983842,2023-02-11,991.7199999999999,129.67,Incoming
89983842,2023-02-11,846.27,145.45,Outgoing
90019913,2023-01-31,430.21,,-
90019913,2023-02-02,499.7,69.49,Incoming
90019913,2023-02-08,2192.9,1693.2,Incoming
90019913,2023-02-09,2036.5600000000002,156.34,Outgoing
90019913,2023-02-10,1964.3500000000001,72.21,Outgoing
90019913,2023-02-12,2586.3500000000004,622.0,Incoming
90019913,2023-02-14,2519.9900000000002,66.36,Outgoing
90044139,2023-01-31,568.28,,-
90044139,2023-02-04,640.3399999999999,72.06,Incoming
90044139,2023-02-05,734.8199999999999,94.48,Incoming
90044139,2023-02-13,873.76,138.94,Incoming
90054505,2023-01-31,586.12,,-
90054505,2023-02-01,715.66,129.54,Incoming
90054505,2023-02-08,627.22,88.44,Outgoing
90054505,2023-02-10,518.62,108.6,Outgoing
90090889,2023-01-31,836.85,,-
90090889,2023-02-04,942.22,105.37,Incoming
90090889,2023-02-05,799.6800000000001,142.54,Outgoing
90090889,2023-02-10,2298.7799999999997,1499.1,Incoming
90090889,2023-02-12,2489.68,190.9,Incoming
90090889,2023-02-14,2626.1099999999997,136.43,Incoming
90118682,2023-01-31,58.16,,-
90118682,2023-02-02,187.93,129.77,Incoming
90118682,2023-02-03,118.67,69.26,Outgoing
90118682,2023-02-03,-30.91000000000001,149.58,Outgoing
90118682,2023-02-05,31.889999999999986,62.8,Incoming
90118682,2023-02-07,-73.49000000000001,105.38,Outgoing
90118682,2023-02-08,-217.06,143.57,Outgoing
90118682,2023-02-09,-13.819999999999993,203.24,Incoming
90118682,2023-02-10,110.12,123.94,Incoming
90118682,2023-02-13,114.78,4.66,Incoming
90168031,2023-01-31,196.48,,-
90168031,2023-02-01,366.83,170.35,Incoming
90168031,2023-02-04,209.57,157.26,Outgoing
90168031,2023-02-09,365.90999999999997,156.34,Incoming
90168031,2023-02-09,440.51,74.6,Incoming
90203948,2023-01-31,689.49,,-
90203948,2023-02-03,586.1700000000001,103.32,Outgoing
90203948,2023-02-03,453.11000000000007,133.06,Outgoing
90203948,2023-02-06,342.4000000000001,110.71,Outgoing
90203948,2023-02-08,-1266.0,1608.4,Outgoing
90203948,2023-02-11,-1149.63,116.37,Incoming
90203948,2023-02-13,-1212.7700000000002,63.14,Outgoing
90233696,2023-01-31,628.02,,-
90233696,2023-02-01,554.88,73.14,Outgoing
90233696,2023-02-02,752.5,197.62,Incoming
90233696,2023-02-05,614.1800000000001,138.32,Outgoing
90233696,2023-02-08,552.0300000000001,62.15,Outgoing
90233696,2023-02-11,592.33,40.3,Incoming
90233696,2023-02-13,631.0300000000001,38.7,Incoming
90287712,2023-01-31,316.17,,-
90287712,2023-02-01,210.92000000000002,105.25,Outgoing
90287712,2023-02-03,257.25,46.33,Incoming
90287712,2023-02-05,365.56,108.31,Incoming
90287712,2023-02-08,249.57,115.99,Outgoing
90287712,2023-02-10,315.09,65.52,Incoming
90287712,2023-02-14,255.28999999999996,59.8,Outgoing
90313378,2023-01-31,743.7,,-
90313378,2023-02-03,120.80000000000007,622.9,Outgoing
90313378,2023-02-03,220.73000000000008,99.93,Incoming
90313378,2023-02-06,51.260000000000076,169.47,Outgoing
90313378,2023-02-07,-6.329999999999927,57.59,Outgoing
90313378,2023-02-08,-30.709999999999926,24.38,Outgoing
90313378,2023-02-11,-3.129999999999928,27.58,Incoming
90313378,2023-02-12,100.66000000000008,103.79,Incoming
90313378,2023-02-13,25.920000000000087,74.74,Outgoing
90336689,2023-01-31,847.88,,-
90336689,2023-02-02,678.24,169.64,Outgoing
90336689,2023-02-03,799.12,120.88,Incoming
90336689,2023-02-04,-174.17999999999995,973.3,Outgoing
90336689,2023-02-07,-126.13999999999996,48.04,Incoming
90336689,2023-02-09,-56.80999999999996,69.33,Incoming
90336689,2023-02-11,897.59,954.4,Incoming
90338454,2023-01-31,748.63,,-
90338454,2023-02-01,910.65,162.02,Incoming
90338454,2023-02-06,853.4,57.25,Outgoing
90338454,2023-02-08,781.25,72.15,Outgoing
90338454,2023-02-10,886.33,105.08,Incoming
90349791,2023-01-31,568.63,,-
90349791,2023-02-06,475.47,93.16,Outgoing
90446254,2023-01-31,930.0,,-
90446254,2023-02-03,1302.2,372.2,Incoming
90446254,2023-02-12,1403.01,100.81,Incoming
90446254,2023-02-13,1495.54,92.53,Incoming
90446254,2023-02-14,1546.2,50.66,Incoming
90480183,2023-01-31,465.06,,-
90480183,2023-02-03,499.78,34.72,Incoming
90480183,2023-02-03,427.75,72.03,Outgoing
90480183,2023-02-05,595.52,167.77,Incoming
90480183,2023-02-05,500.99,94.53,Outgoing
90480183,2023-02-06,641.75,140.76,Incoming
90480183,2023-02-07,567.0,74.75,Outgoing
90549616,2023-01-31,37.69,,-
90549616,2023-02-01,207.37,169.68,Incoming
90549616,2023-02-01,994.57,787.2,Incoming
90549616,2023-02-04,1094.5,99.93,Incoming
90549616,2023-02-04,1067.07,27.43,Outgoing
90549616,2023-02-06,2405.0699999999997,1338.0,Incoming
90549616,2023-02-07,2570.41,165.34,Incoming
90549616,2023-02-08,2535.48,34.93,Outgoing
90549616,2023-02-10,2465.84,69.64,Outgoing
90549616,2023-02-12,2598.9700000000003,133.13,Incoming
90549616,2023-02-14,2462.5400000000004,136.43,Outgoing
90589761,2023-01-31,535.28,,-
90589761,2023-02-02,452.38,82.9,Outgoing
90589761,2023-02-05,344.3,108.08,Outgoing
90589761,2023-02-06,225.82,118.48,Outgoing
90589761,2023-02-11,392.62,166.8,Incoming
90589761,2023-02-12,234.31,158.31,Outgoing
90625637,2023-01-31,477.46,,-
90625637,2023-02-03,588.12,110.66,Incoming
90625637,2023-02-07,548.53,39.59,Outgoing
90625637,2023-02-10,638.62,90.09,Incoming
90625637,2023-02-11,531.56,107.06,Outgoing
90625637,2023-02-13,470.92999999999995,60.63,Outgoing
90625637,2023-02-13,657.28,186.35,Incoming
90717656,2023-01-31,409.99,,-
90717656,2023-02-02,185.08,224.91,Outgoing
90717656,2023-02-04,-483.7199999999999,668.8,Outgoing
90717656,2023-02-09,-444.3299999999999,39.39,Incoming
90717656,2023-02-12,-345.5199999999999,98.81,Incoming
90717656,2023-02-12,-459.7899999999999,114.27,Outgoing
90745743,2023-01-31,375.07,,-
90745743,2023-02-01,518.06,142.99,Incoming
90745743,2023-02-02,406.15999999999997,111.9,Outgoing
90745743,2023-02-03,519.6999999999999,113.54,Incoming
90745743,2023-02-06,420.7799999999999,98.92,Outgoing
90745743,2023-02-10,316.0299999999999,104.75,Outgoing
90745743,2023-02-11,325.2399999999999,9.21,Incoming
90745743,2023-02-13,275.3399999999999,49.9,Outgoing
90824896,2023-01-31,484.11,,-
90824896,2023-02-02,391.75,92.36,Outgoing
90824896,2023-02-04,287.6,104.15,Outgoing
90824896,2023-02-06,361.85,74.25,Incoming
90824896,2023-02-08,371.90000000000003,10.05,Incoming
90851200,2023-01-31,361.43,,-
90851200,2023-02-02,1117.23,755.8,Incoming
90851200,2023-02-06,1033.97,83.26,Outgoing
90851200,2023-02-07,987.7,46.27,Outgoing
90851200,2023-02-10,836.9300000000001,150.77,Outgoing
90851200,2023-02-10,918.6400000000001,81.71,Incoming
90851200,2023-02-13,820.45,98.19,Outgoing
90851200,2023-02-14,906.5500000000001,86.1,Incoming
90871147,2023-01-31,362.86,,-
90871147,2023-02-08,298.59000000000003,64.27,Outgoing
90871147,2023-02-08,375.18000000000006,76.59,Incoming
90871147,2023-02-09,859.1800000000001,484.0,Incoming
90871147,2023-02-10,918.6,59.42,Incoming
90871147,2023-02-10,860.15,58.45,Outgoing
90894195,2023-01-31,157.01,,-
90894195,2023-02-02,66.52,90.49,Outgoing
90894195,2023-02-03,26.389999999999993,40.13,Outgoing
90894195,2023-02-04,176.76999999999998,150.38,Incoming
90894195,2023-02-05,289.11,112.34,Incoming
90894195,2023-02-07,243.28000000000003,45.83,Outgoing
90932350,2023-01-31,480.51,,-
90932350,2023-02-02,382.4,98.11,Outgoing
90932350,2023-02-06,192.55999999999997,189.84,Outgoing
90932350,2023-02-07,258.46,65.9,Incoming
90932350,2023-02-08,283.21999999999997,24.76,Incoming
90932350,2023-02-08,1120.52,837.3,Incoming
90932350,2023-02-09,1052.53,67.99,Outgoing
90932350,2023-02-09,926.0699999999999,126.46,Outgoing
90932350,2023-02-10,1047.78,121.71,Incoming
90951743,2023-01-31,220.81,,-
90951743,2023-02-02,-1338.39,1559.2,Outgoing
90951743,2023-02-02,-1273.49,64.9,Incoming
90951743,2023-02-03,-1190.24,83.25,Incoming
90951743,2023-02-04,357.96000000000004,1548.2,Incoming
90951743,2023-02-05,283.41,74.55,Outgoing
90951743,2023-02-08,202.24,81.17,Outgoing
90951743,2023-02-09,89.93,112.31,Outgoing
90951743,2023-02-11,62.980000000000004,26.95,Outgoing
90951743,2023-02-11,159.86,96.88,Incoming
90982016,2023-01-31,776.15,,-
90982016,2023-02-07,868.9499999999999,92.8,Incoming
90982016,2023-02-09,726.4499999999999,142.5,Outgoing
90982016,2023-02-13,602.0799999999999,124.37,Outgoing
90982016,2023-02-14,699.67,97.59,Incoming
91020929,2023-01-31,348.12,,-
91020929,2023-02-01,455.68,107.56,Incoming
91020929,2023-02-05,355.77,99.91,Outgoing
91020929,2023-02-05,467.31,111.54,Incoming
91020929,2023-02-08,507.44,40.13,Incoming
91020929,2023-02-10,672.85,165.41,Incoming
91020929,2023-02-11,633.46,39.39,Outgoing
91020929,2023-02-13,531.11,102.35,Outgoing
91020929,2023-02-14,646.49,115.38,Incoming
91062192,2023-01-31,211.52,,-
91062192,2023-02-02,382.31,170.79,Incoming
91062192,2023-02-03,513.01,130.7,Incoming
91062192,2023-02-06,-468.89,981.9,Outgoing
91142310,2023-01-31,363.08,,-
91142310,2023-02-06,200.95,162.13,Outgoing
91142310,2023-02-07,1425.95,1225.0,Incoming
91142310,2023-02-14,2092.05,666.1,Incoming
91184544,2023-01-31,64.05,,-
91184544,2023-02-02,51.699999999999996,12.35,Outgoing
91184544,2023-02-07,143.26,91.56,Incoming
91184544,2023-02-08,-16.090000000000003,159.35,Outgoing
91184544,2023-02-09,-87.35000000000001,71.26,Outgoing
91184544,2023-02-11,-1295.05,1207.7,Outgoing
91184544,2023-02-13,-1189.6499999999999,105.4,Incoming
91246568,2023-01-31,147.43,,-
91246568,2023-02-02,337.22,189.79,Incoming
91246568,2023-02-02,248.42000000000002,88.8,Outgoing
91246568,2023-02-02,360.0,111.58,Incoming
91246568,2023-02-06,273.09000000000003,86.91,Outgoing
91246568,2023-02-06,362.0,88.91,Incoming
91246568,2023-02-06,482.78,120.78,Incoming
91246568,2023-02-09,388.0,94.78,Outgoing
91246568,2023-02-13,332.93,55.07,Outgoing
91246568,2023-02-14,253.17000000000002,79.76,Outgoing
91251995,2023-01-31,244.0,,-
91251995,2023-02-05,379.59000000000003,135.59,Incoming
91251995,2023-02-07,560.7,181.11,Incoming
91251995,2023-02-12,468.14000000000004,92.56,Outgoing
91259453,2023-01-31,816.68,,-
91259453,2023-02-02,592.5799999999999,224.1,Outgoing
91259453,2023-02-11,586.3899999999999,6.19,Outgoing
91259453,2023-02-12,-1215.0100000000002,1801.4,Outgoing
91259453,2023-02-13,-1162.7500000000002,52.26,Incoming
91305080,2023-01-31,123.21,,-
91305080,2023-02-01,17.58,105.63,Outgoing
91305080,2023-02-07,84.36,66.78,Incoming
91305080,2023-02-11,210.26999999999998,125.91,Incoming
91305080,2023-02-11,240.02999999999997,29.76,Incoming
91305080,2023-02-14,-1047.97,1288.0,Outgoing
91305080,2023-02-14,-1159.05,111.08,Outgoing
91349198,2023-01-31,669.58,,-
91349198,2023-02-06,671.0400000000001,1.46,Incoming
91349198,2023-02-09,725.73,54.69,Incoming
91349198,2023-02-10,602.07,123.66,Outgoing
91349198,2023-02-11,703.82,101.75,Incoming
91349198,2023-02-12,1852.8200000000002,1149.0,Incoming
91373446,2023-01-31,561.42,,-
91373446,2023-02-01,649.01,87.59,Incoming
91373446,2023-02-03,775.65,126.64,Incoming
91373446,2023-02-05,888.38,112.73,Incoming
91373446,2023-02-05,832.5699999999999,55.81,Outgoing
91373446,2023-02-06,969.67,137.1,Incoming
91373446,2023-02-09,804.2099999999999,165.46,Outgoing
91373446,2023-02-09,869.17,64.96,Incoming
91373446,2023-02-11,1379.37,510.2,Incoming
91373446,2023-02-14,1314.76,64.61,Outgoing
91382872,2023-01-31,782.62,,-
91382872,2023-02-10,686.45,96.17,Outgoing
91382872,2023-02-12,783.0500000000001,96.6,Incoming
91423814,2023-01-31,957.99,,-
91423814,2023-02-06,1017.51,59.52,Incoming
91423814,2023-02-06,1131.05,113.54,Incoming
91445572,2023-01-31,405.88,,-
91445572,2023-02-02,347.48,58.4,Outgoing
91445572,2023-02-03,191.07000000000002,156.41,Outgoing
91576212,2023-01-31,824.71,,-
91576212,2023-02-02,945.1600000000001,120.45,Incoming
91576212,2023-02-03,1062.6200000000001,117.46,Incoming
91576212,2023-02-05,1008.8100000000002,53.81,Outgoing
91576212,2023-02-08,1094.7100000000003,85.9,Incoming
91576212,2023-02-08,-159.98999999999978,1254.7,Outgoing
91576212,2023-02-09,1141.5100000000002,1301.5,Incoming
91576212,2023-02-12,152.31000000000017,989.2,Outgoing
91605034,2023-01-31,560.96,,-
91605034,2023-02-02,398.86,162.1,Outgoing
91605034,2023-02-09,307.04,91.82,Outgoing
91605034,2023-02-12,1337.74,1030.7,Incoming
91621026,2023-01-31,834.74,,-
91621026,2023-02-06,737.95,96.79,Outgoing
91621026,2023-02-10,1477.45,739.5,Incoming
91621026,2023-02-12,1331.9,145.55,Outgoing
91621026,2023-02-12,1202.17,129.73,Outgoing
91621026,2023-02-12,1059.31,142.86,Outgoing
91621026,2023-02-12,993.4,65.91,Outgoing
91658755,2023-01-31,347.59,,-
91658755,2023-02-01,221.52999999999997,126.06,Outgoing
91658755,2023-02-03,162.24999999999997,59.28,Outgoing
91658755,2023-02-03,1179.1499999999999,1016.9,Incoming
91658755,2023-02-08,1248.7099999999998,69.56,Incoming
91658755,2023-02-08,1437.9899999999998,189.28,Incoming
91658755,2023-02-10,555.9899999999998,882.0,Outgoing
91658755,2023-02-11,668.5499999999997,112.56,Incoming
91658755,2023-02-14,501.6799999999997,166.87,Outgoing
91703213,2023-01-31,891.67,,-
91703213,2023-02-01,837.42,54.25,Outgoing
91703213,2023-02-06,793.53,43.89,Outgoing
91703213,2023-02-07,689.3199999999999,104.21,Outgoing
91703213,2023-02-08,751.51,62.19,Incoming
91703213,2023-02-09,953.13,201.62,Incoming
91703213,2023-02-09,1733.83,780.7,Incoming
91703213,2023-02-10,1601.48,132.35,Outgoing
91747441,2023-01-31,356.85,,-
91747441,2023-02-03,269.8,87.05,Outgoing
91747441,2023-02-05,372.97,103.17,Incoming
91747441,2023-02-05,170.86,202.11,Outgoing
91747441,2023-02-09,94.12000000000002,76.74,Outgoing
91747441,2023-02-11,223.78000000000003,129.66,Incoming
91747441,2023-02-11,115.00000000000003,108.78,Outgoing
91747441,2023-02-13,266.93000000000006,151.93,Incoming
91819341,2023-01-31,701.61,,-
91819341,2023-02-02,801.19,99.58,Incoming
91819341,2023-02-07,891.45,90.26,Incoming
91819341,2023-02-07,936.4300000000001,44.98,Incoming
91819341,2023-02-09,1040.31,103.88,Incoming
91819341,2023-02-09,924.42,115.89,Outgoing
91819341,2023-02-10,1094.97,170.55,Incoming
91829198,2023-01-31,103.19,,-
91829198,2023-02-09,1260.0900000000001,1156.9,Incoming
91829198,2023-02-10,-324.90999999999985,1585.0,Outgoing
91829198,2023-02-12,-415.2499999999999,90.34,Outgoing
91829198,2023-02-13,-276.39999999999986,138.85,Incoming
91834926,2023-01-31,793.19,,-
91834926,2023-02-03,739.7700000000001,53.42,Outgoing
91834926,2023-02-04,748.4000000000001,8.63,Incoming
91834926,2023-02-09,869.9000000000001,121.5,Incoming
91834926,2023-02-11,1013.7600000000001,143.86,Incoming
91834926,2023-02-12,938.3200000000002,75.44,Outgoing
91834926,2023-02-14,849.1600000000002,89.16,Outgoing
91859090,2023-01-31,10.38,,-
91859090,2023-02-02,-221.52,231.9,Outgoing
91859090,2023-02-04,-319.36,97.84,Outgoing
91859090,2023-02-06,-434.11,114.75,Outgoing
91859090,2023-02-08,-640.1800000000001,206.07,Outgoing
91859090,2023-02-09,-800.24,160.06,Outgoing
91859090,2023-02-14,-852.97,52.73,Outgoing
91885907,2023-01-31,652.65,,-
91885907,2023-02-03,41.85000000000002,610.8,Outgoing
91885907,2023-02-05,166.90000000000003,125.05,Incoming
91885907,2023-02-05,59.03000000000003,107.87,Outgoing
91885907,2023-02-06,129.13000000000002,70.1,Incoming
91885907,2023-02-08,239.77000000000004,110.64,Incoming
91885907,2023-02-13,354.13000000000005,114.36,Incoming
91939298,2023-01-31,61.59,,-
91939298,2023-02-01,183.28,121.69,Incoming
91939298,2023-02-02,306.09000000000003,122.81,Incoming
91939298,2023-02-04,417.08000000000004,110.99,Incoming
91939298,2023-02-07,330.25000000000006,86.83,Outgoing
91939298,2023-02-12,421.87000000000006,91.62,Incoming
91939298,2023-02-14,295.84000000000003,126.03,Outgoing
91943555,2023-01-31,438.21,,-
91943555,2023-02-04,557.9499999999999,119.74,Incoming
91943555,2023-02-07,356.24999999999994,201.7,Outgoing
91943555,2023-02-13,468.24999999999994,112.0,Incoming
91944915,2023-01-31,601.21,,-
91944915,2023-02-01,501.09000000000003,100.12,Outgoing
91944915,2023-02-10,309.01,192.08,Outgoing
91944915,2023-02-12,377.27,68.26,Incoming
91957838,2023-01-31,587.57,,-
91957838,2023-02-03,507.31000000000006,80.26,Outgoing
91957838,2023-02-05,659.33,152.02,Incoming
91957838,2023-02-05,577.73,81.6,Outgoing
91957838,2023-02-05,678.6,100.87,Incoming
91957838,2023-02-10,888.44,209.84,Incoming
91957838,2023-02-11,719.11,169.33,Outgoing
91971494,2023-01-31,74.37,,-
91971494,2023-02-02,861.97,787.6,Incoming
91971494,2023-02-06,-191.52999999999997,1053.5,Outgoing
91971494,2023-02-09,454.37,645.9,Incoming
91971494,2023-02-10,622.56,168.19,Incoming
91972687,2023-01-31,463.97,,-
91972687,2023-02-07,370.94000000000005,93.03,Outgoing
91972687,2023-02-10,-757.46,1128.4,Outgoing
91972687,2023-02-14,-612.8900000000001,144.57,Incoming
92001688,2023-01-31,339.08,,-
92001688,2023-02-05,439.31,100.23,Incoming
92001688,2023-02-07,378.55,60.76,Outgoing
92001688,2023-02-08,283.64,94.91,Outgoing
92001688,2023-02-08,80.30999999999997,203.33,Outgoing
92001688,2023-02-08,152.35999999999996,72.05,Incoming
92001688,2023-02-11,89.99999999999996,62.36,Outgoing
92001688,2023-02-14,297.35999999999996,207.36,Incoming
92015508,2023-01-31,457.52,,-
92015508,2023-02-04,533.5799999999999,76.06,Incoming
92015508,2023-02-05,585.9399999999999,52.36,Incoming
92015508,2023-02-06,414.27,171.67,Outgoing
92015508,2023-02-07,533.52,119.25,Incoming
92015508,2023-02-10,617.31,83.79,Incoming
92015508,2023-02-11,646.56,29.25,Incoming
92015508,2023-02-14,796.8,150.24,Incoming
92037264,2023-01-31,252.95,,-
92037264,2023-02-03,-878.6499999999999,1131.6,Outgoing
92037264,2023-02-05,-960.4499999999998,81.8,Outgoing
92037264,2023-02-05,-850.8499999999998,109.6,Incoming
92037264,2023-02-09,-858.2499999999998,7.4,Outgoing
92037264,2023-02-09,-729.5099999999998,128.74,Incoming
92037264,2023-02-10,-672.9199999999997,56.59,Incoming
92037264,2023-02-11,-799.4199999999997,126.5,Outgoing
92037264,2023-02-12,-647.9399999999997,151.48,Incoming
92037264,2023-02-14,-574.5399999999997,73.4,Incoming
92037264,2023-02-14,-445.97999999999973,128.56,Incoming
92052516,2023-01-31,466.43,,-
92052516,2023-02-02,-616.27,1082.7,Outgoing
92052516,2023-02-06,-985.17,368.9,Outgoing
92052516,2023-02-07,-1041.49,56.32,Outgoing
92052516,2023-02-12,-1013.59,27.9,Incoming
92052516,2023-02-14,-944.89,68.7,Incoming
92145159,2023-01-31,61.65,,-
92145159,2023-02-01,-60.98,122.63,Outgoing
92145159,2023-02-01,-166.34,105.36,Outgoing
92145159,2023-02-01,-271.95,105.61,Outgoing
92145159,2023-02-06,-167.85,104.1,Incoming
92145159,2023-02-07,-32.859999999999985,134.99,Incoming
92145159,2023-02-10,-169.17,136.31,Outgoing
92145159,2023-02-12,2039.23,2208.4,Incoming
92145159,2023-02-13,668.4300000000001,1370.8,Outgoing
92145159,2023-02-14,1284.0300000000002,615.6,Incoming
92155262,2023-01-31,501.67,,-
92155262,2023-02-03,597.38,95.71,Incoming
92155262,2023-02-08,-453.91999999999996,1051.3,Outgoing
92155262,2023-02-09,-1513.92,1060.0,Outgoing
92155262,2023-02-10,-1648.46,134.54,Outgoing
92155262,2023-02-11,-1823.6200000000001,175.16,Outgoing
92155262,2023-02-12,-1784.2,39.42,Incoming
92155262,2023-02-12,-1842.5900000000001,58.39,Outgoing
92195724,2023-01-31,726.92,,-
92195724,2023-02-01,628.17,98.75,Outgoing
92195724,2023-02-01,752.4399999999999,124.27,Incoming
92195724,2023-02-04,2332.24,1579.8,Incoming
92195724,2023-02-07,2410.3399999999997,78.1,Incoming
92195724,2023-02-08,2631.3399999999997,221.0,Incoming
92212099,2023-01-31,584.21,,-
92212099,2023-02-09,704.6800000000001,120.47,Incoming
92212099,2023-02-12,636.47,68.21,Outgoing
92212099,2023-02-12,644.0600000000001,7.59,Incoming
92212099,2023-02-13,703.5100000000001,59.45,Incoming
92212099,2023-02-14,826.45,122.94,Incoming
92214557,2023-01-31,258.42,,-
92214557,2023-02-01,85.41000000000003,173.01,Outgoing
92214557,2023-02-02,165.54000000000002,80.13,Incoming
92214557,2023-02-04,6.980000000000018,158.56,Outgoing
92214557,2023-02-05,-91.21999999999998,98.2,Outgoing
92214557,2023-02-07,-214.89,123.67,Outgoing
92214557,2023-02-07,-1781.8899999999999,1567.0,Outgoing
92214557,2023-02-12,-1895.61,113.72,Outgoing
92214557,2023-02-13,-1991.32,95.71,Outgoing
92221411,2023-01-31,849.46,,-
92221411,2023-02-01,971.9200000000001,122.46,Incoming
92221411,2023-02-02,995.1400000000001,23.22,Incoming
92221411,2023-02-04,923.0800000000002,72.06,Outgoing
92221411,2023-02-06,826.6800000000002,96.4,Outgoing
92221411,2023-02-08,916.6500000000002,89.97,Incoming
92221411,2023-02-08,794.4700000000003,122.18,Outgoing
92221411,2023-02-12,917.6000000000003,123.13,Incoming
92221411,2023-02-14,996.4300000000003,78.83,Incoming
92232319,2023-01-31,416.11,,-
92232319,2023-02-02,250.81,165.3,Outgoing
92232319,2023-02-04,377.79,126.98,Incoming
92232319,2023-02-05,590.0,212.21,Incoming
92232319,2023-02-08,704.69,114.69,Incoming
92232319,2023-02-10,637.0,67.69,Outgoing
92232319,2023-02-11,540.12,96.88,Outgoing
92234913,2023-01-31,613.18,,-
92234913,2023-02-07,755.78,142.6,Incoming
92234913,2023-02-12,-48.120000000000005,803.9,Outgoing
92234913,2023-02-13,-7.170000000000002,40.95,Incoming
92287463,2023-01-31,257.14,,-
92287463,2023-02-01,342.09999999999997,84.96,Incoming
92287463,2023-02-03,427.71999999999997,85.62,Incoming
92287463,2023-02-06,317.46,110.26,Outgoing
92287463,2023-02-06,426.96999999999997,109.51,Incoming
92287463,2023-02-07,529.1899999999999,102.22,Incoming
92287463,2023-02-09,417.63999999999993,111.55,Outgoing
92287463,2023-02-11,386.2299999999999,31.41,Outgoing
92287463,2023-02-12,307.1799999999999,79.05,Outgoing
92319358,2023-01-31,116.51,,-
92319358,2023-02-01,22.450000000000003,94.06,Outgoing
92319358,2023-02-05,-677.9499999999999,700.4,Outgoing
92319358,2023-02-06,-821.52,143.57,Outgoing
92319358,2023-02-07,-685.8299999999999,135.69,Incoming
92319358,2023-02-07,-589.28,96.55,Incoming
92319358,2023-02-09,-2466.58,1877.3,Outgoing
92319358,2023-02-09,-1841.48,625.1,Incoming
92319358,2023-02-10,-1703.92,137.56,Incoming
92319358,2023-02-10,-1656.17,47.75,Incoming
92319358,2023-02-11,-1813.77,157.6,Outgoing
92319358,2023-02-13,-1687.11,126.66,Incoming
92338537,2023-01-31,316.24,,-
92338537,2023-02-01,391.6,75.36,Incoming
92338537,2023-02-05,220.78000000000003,170.82,Outgoing
92338537,2023-02-05,624.3800000000001,403.6,Incoming
92338537,2023-02-08,594.1700000000001,30.21,Outgoing
92338537,2023-02-13,616.6600000000001,22.49,Incoming
92338537,2023-02-13,354.2600000000001,262.4,Outgoing
92340721,2023-01-31,844.79,,-
92340721,2023-02-05,-323.6100000000001,1168.4,Outgoing
92340721,2023-02-06,-159.96000000000012,163.65,Incoming
92340721,2023-02-07,-903.9600000000002,744.0,Outgoing
92340721,2023-02-07,-938.6100000000001,34.65,Outgoing
92340721,2023-02-08,-1049.2500000000002,110.64,Outgoing
92340721,2023-02-11,-990.8800000000002,58.37,Incoming
92340721,2023-02-11,-803.0800000000002,187.8,Incoming
92340721,2023-02-12,-690.8500000000001,112.23,Incoming
92376825,2023-01-31,323.68,,-
92376825,2023-02-01,165.09,158.59,Outgoing
92376825,2023-02-04,64.7,100.39,Outgoing
92376825,2023-02-05,-132.31,197.01,Outgoing
92376825,2023-02-10,-277.84000000000003,145.53,Outgoing
92376825,2023-02-11,-1492.44,1214.6,Outgoing
92376825,2023-02-12,-1613.3400000000001,120.9,Outgoing
92376825,2023-02-13,-1717.3300000000002,103.99,Outgoing
92390334,2023-01-31,602.62,,-
92390334,2023-02-01,738.84,136.22,Incoming
92390334,2023-02-04,807.71,68.87,Incoming
92423759,2023-01-31,475.1,,-
92423759,2023-02-04,343.82000000000005,131.28,Outgoing
92423759,2023-02-04,1008.4200000000001,664.6,Incoming
92423759,2023-02-06,917.7800000000001,90.64,Outgoing
92437489,2023-01-31,24.19,,-
92437489,2023-02-04,64.34,40.15,Incoming
92437489,2023-02-06,-112.06,176.4,Outgoing
92437489,2023-02-10,-22.070000000000007,89.99,Incoming
92437489,2023-02-10,51.58,73.65,Incoming
92551293,2023-01-31,252.3,,-
92551293,2023-02-03,197.28,55.02,Outgoing
92551293,2023-02-13,320.15,122.87,Incoming
92563438,2023-01-31,965.81,,-
92563438,2023-02-01,1130.75,164.94,Incoming
92563438,2023-02-01,1023.19,107.56,Outgoing
92563438,2023-02-04,883.49,139.7,Outgoing
92563438,2023-02-09,982.6700000000001,99.18,Incoming
92563438,2023-02-10,1100.8000000000002,118.13,Incoming
92563438,2023-02-13,1177.38,76.58,Incoming
92563438,2023-02-14,1244.2600000000002,66.88,Incoming
92684055,2023-01-31,430.86,,-
92684055,2023-02-03,596.37,165.51,Incoming
92684055,2023-02-11,537.07,59.3,Outgoing
92684055,2023-02-11,415.9100000000001,121.16,Outgoing
92684055,2023-02-13,479.3800000000001,63.47,Incoming
92750088,2023-01-31,560.4,,-
92750088,2023-02-01,1630.1,1069.7,Incoming
92750088,2023-02-04,1430.7399999999998,199.36,Outgoing
92750088,2023-02-05,1280.8099999999997,149.93,Outgoing
92750088,2023-02-06,1214.6399999999996,66.17,Outgoing
92750088,2023-02-07,1109.8899999999996,104.75,Outgoing
92770567,2023-01-31,949.66,,-
92770567,2023-02-01,1069.75,120.09,Incoming
92770567,2023-02-04,1138.51,68.76,Incoming
92770567,2023-02-05,1177.82,39.31,Incoming
92770567,2023-02-06,1340.02,162.2,Incoming
92770567,2023-02-07,1442.54,102.52,Incoming
92770567,2023-02-07,1306.92,135.62,Outgoing
92770567,2023-02-13,1451.17,144.25,Incoming
92770567,2023-02-13,1484.92,33.75,Incoming
92770567,2023-02-13,1347.94,136.98,Outgoing
92840827,2023-01-31,403.77,,-
92840827,2023-02-03,297.41999999999996,106.35,Outgoing
92840827,2023-02-10,215.41999999999996,82.0,Outgoing
92840827,2023-02-13,372.8299999999999,157.41,Incoming
92840827,2023-02-13,450.8399999999999,78.01,Incoming
92872571,2023-01-31,933.03,,-
92872571,2023-02-01,836.97,96.06,Outgoing
92872571,2023-02-05,747.35,89.62,Outgoing
92872571,2023-02-09,798.13,50.78,Incoming
92872571,2023-02-12,564.22,233.91,Outgoing
92872571,2023-02-14,439.96000000000004,124.26,Outgoing
92898446,2023-01-31,64.49,,-
92898446,2023-02-07,62.71999999999999,1.77,Outgoing
92898446,2023-02-07,-121.57,184.29,Outgoing
92898446,2023-02-07,-162.92,41.35,Outgoing
92898446,2023-02-08,-116.48999999999998,46.43,Incoming
92898446,2023-02-09,16.090000000000032,132.58,Incoming
92898446,2023-02-09,9.140000000000033,6.95,Outgoing
92898446,2023-02-12,-72.68999999999997,81.83,Outgoing
92910876,2023-01-31,643.19,,-
92910876,2023-02-04,652.0400000000001,8.85,Incoming
92910876,2023-02-05,711.2400000000001,59.2,Incoming
92910876,2023-02-07,537.4500000000002,173.79,Outgoing
92910876,2023-02-11,622.8100000000002,85.36,Incoming
92910876,2023-02-14,709.5400000000002,86.73,Incoming
92910876,2023-02-14,608.8400000000001,100.7,Outgoing
92920645,2023-01-31,644.88,,-
92920645,2023-02-10,680.52,35.64,Incoming
92920645,2023-02-12,838.39,157.87,Incoming
92931020,2023-01-31,754.11,,-
92931020,2023-02-02,907.15,153.04,Incoming
92931020,2023-02-04,941.97,34.82,Incoming
92931020,2023-02-05,1757.67,815.7,Incoming
92931020,2023-02-06,1709.3600000000001,48.31,Outgoing
92931020,2023-02-09,1635.94,73.42,Outgoing
92931020,2023-02-10,1499.8400000000001,136.1,Outgoing
92931020,2023-02-11,3242.54,1742.7,Incoming
92931020,2023-02-12,3363.4,120.86,Incoming
92931020,2023-02-13,3441.35,77.95,Incoming
92943637,2023-01-31,28.23,,-
92943637,2023-02-02,168.79999999999998,140.57,Incoming
92943637,2023-02-03,79.85999999999999,88.94,Outgoing
92943637,2023-02-05,155.89999999999998,76.04,Incoming
92943637,2023-02-08,232.54999999999998,76.65,Incoming
92943637,2023-02-10,343.45,110.9,Incoming
92944470,2023-01-31,445.48,,-
92944470,2023-02-01,292.89,152.59,Outgoing
92944470,2023-02-06,191.98999999999998,100.9,Outgoing
92944470,2023-02-10,295.9,103.91,Incoming
92944470,2023-02-12,185.76,110.14,Outgoing
92963966,2023-01-31,983.65,,-
92963966,2023-02-01,980.61,3.04,Outgoing
92963966,2023-02-06,890.5600000000001,90.05,Outgoing
93009261,2023-01-31,675.04,,-
93009261,2023-02-02,574.68,100.36,Outgoing
93009261,2023-02-05,509.5799999999999,65.1,Outgoing
93009261,2023-02-05,390.1599999999999,119.42,Outgoing
93009261,2023-02-06,-1304.8400000000001,1695.0,Outgoing
93009261,2023-02-07,-1195.96,108.88,Incoming
93009261,2023-02-08,-2365.56,1169.6,Outgoing
93009261,2023-02-09,-2267.7599999999998,97.8,Incoming
93009261,2023-02-09,-2191.02,76.74,Incoming
93009261,2023-02-10,-2284.32,93.3,Outgoing
93009261,2023-02-10,-2431.83,147.51,Outgoing
93009261,2023-02-10,-2218.0,213.83,Incoming
93009261,2023-02-13,-2343.85,125.85,Outgoing
93039862,2023-01-31,806.99,,-
93039862,2023-02-02,745.79,61.2,Outgoing
93039862,2023-02-03,717.9599999999999,27.83,Outgoing
93039862,2023-02-07,784.8399999999999,66.88,Incoming
93039862,2023-02-09,917.3199999999999,132.48,Incoming
93039862,2023-02-10,799.1899999999999,118.13,Outgoing
93039862,2023-02-14,716.4899999999999,82.7,Outgoing
93076057,2023-01-31,218.56,,-
93076057,2023-02-02,74.74000000000001,143.82,Outgoing
93076057,2023-02-04,-12.609999999999985,87.35,Outgoing
93128216,2023-01-31,834.73,,-
93128216,2023-02-03,979.34,144.61,Incoming
93128216,2023-02-03,989.98,10.64,Incoming
93128216,2023-02-10,1034.72,44.74,Incoming
93128216,2023-02-11,865.8000000000001,168.92,Outgoing
93128216,2023-02-14,1002.73,136.93,Incoming
93147630,2023-01-31,403.93,,-
93147630,2023-02-07,255.12,148.81,Outgoing
93147630,2023-02-11,372.04,116.92,Incoming
93147630,2023-02-13,241.86,130.18,Outgoing
93147630,2023-02-13,378.58000000000004,136.72,Incoming
93192347,2023-01-31,298.01,,-
93192347,2023-02-01,1575.21,1277.2,Incoming
93192347,2023-02-04,1417.17,158.04,Outgoing
93192347,2023-02-04,1543.19,126.02,Incoming
93192347,2023-02-05,1491.47,51.72,Outgoing
93192347,2023-02-08,1398.88,92.59,Outgoing
93192347,2023-02-09,73.18000000000006,1325.7,Outgoing
93192347,2023-02-12,2221.08,2147.9,Incoming
93192347,2023-02-14,2847.88,626.8,Incoming
93192347,2023-02-14,3019.13,171.25,Incoming
93248179,2023-01-31,376.57,,-
93248179,2023-02-01,403.93,27.36,Incoming
93248179,2023-02-01,534.04,130.11,Incoming
93248179,2023-02-04,351.38,182.66,Outgoing
93306742,2023-01-31,388.54,,-
93306742,2023-02-11,207.03000000000003,181.51,Outgoing
93306742,2023-02-13,163.16000000000003,43.87,Outgoing
93306742,2023-02-13,101.33000000000003,61.83,Outgoing
93325549,2023-01-31,161.45,,-
93325549,2023-02-01,-16.180000000000007,177.63,Outgoing
93325549,2023-02-05,-806.6800000000001,790.5,Outgoing
93325549,2023-02-08,-974.97,168.29,Outgoing
93325549,2023-02-10,-1081.26,106.29,Outgoing
93325549,2023-02-11,-1013.06,68.2,Incoming
93325549,2023-02-14,-1092.34,79.28,Outgoing
93346040,2023-01-31,816.07,,-
93346040,2023-02-01,885.25,69.18,Incoming
93346040,2023-02-06,898.02,12.77,Incoming
93346040,2023-02-07,1033.72,135.7,Incoming
93346040,2023-02-07,1848.12,814.4,Incoming
93346040,2023-02-07,1837.81,10.31,Outgoing
93346040,2023-02-08,1684.02,153.79,Outgoing
93346040,2023-02-09,1565.56,118.46,Outgoing
93346040,2023-02-10,1447.4299999999998,118.13,Outgoing
93349543,2023-01-31,329.45,,-
93349543,2023-02-01,452.08,122.63,Incoming
93349543,2023-02-03,555.51,103.43,Incoming
93349543,2023-02-04,674.11,118.6,Incoming
93349543,2023-02-05,607.3100000000001,66.8,Outgoing
93349543,2023-02-05,693.45,86.14,Incoming
93355755,2023-01-31,753.84,,-
93355755,2023-02-03,803.38,49.54,Incoming
93355755,2023-02-09,699.1,104.28,Outgoing
93355755,2023-02-10,710.83,11.73,Incoming
93388304,2023-01-31,73.0,,-
93388304,2023-02-04,-89.78999999999999,162.79,Outgoing
93388304,2023-02-04,-155.83999999999997,66.05,Outgoing
93388304,2023-02-08,-194.74999999999997,38.91,Outgoing
93388304,2023-02-09,-352.04999999999995,157.3,Outgoing
93388304,2023-02-11,-349.03,3.02,Incoming
93388304,2023-02-13,-491.06999999999994,142.04,Outgoing
93409343,2023-01-31,748.45,,-
93409343,2023-02-01,-82.25,830.7,Outgoing
93409343,2023-02-05,-1.0499999999999972,81.2,Incoming
93409343,2023-02-06,65.12,66.17,Incoming
93409343,2023-02-08,-29.039999999999992,94.16,Outgoing
93409343,2023-02-12,81.16000000000001,110.2,Incoming
93429066,2023-01-31,652.04,,-
93429066,2023-02-04,798.8599999999999,146.82,Incoming
93429066,2023-02-05,667.4999999999999,131.36,Outgoing
93429066,2023-02-05,816.9099999999999,149.41,Incoming
93429066,2023-02-12,913.1799999999998,96.27,Incoming
93443317,2023-01-31,305.29,,-
93443317,2023-02-01,180.60000000000002,124.69,Outgoing
93443317,2023-02-02,86.13000000000002,94.47,Outgoing
93443317,2023-02-03,227.29000000000002,141.16,Incoming
93443317,2023-02-04,140.16000000000003,87.13,Outgoing
93446276,2023-01-31,184.74,,-
93446276,2023-02-01,326.89,142.15,Incoming
93446276,2023-02-01,139.73999999999998,187.15,Outgoing
93446276,2023-02-01,49.93999999999998,89.8,Outgoing
93446276,2023-02-02,-112.41000000000001,162.35,Outgoing
93446276,2023-02-02,-17.310000000000016,95.1,Incoming
93446276,2023-02-02,-718.4100000000001,701.1,Outgoing
93446276,2023-02-05,-611.7,106.71,Incoming
93446276,2023-02-07,-470.65000000000003,141.05,Incoming
93446276,2023-02-09,-2149.85,1679.2,Outgoing
93446276,2023-02-10,-2303.97,154.12,Outgoing
93529019,2023-01-31,463.32,,-
93529019,2023-02-04,306.27,157.05,Outgoing
93529019,2023-02-05,211.42999999999998,94.84,Outgoing
93529019,2023-02-06,51.349999999999966,160.08,Outgoing
93529019,2023-02-06,-13.730000000000032,65.08,Outgoing
93529019,2023-02-07,-198.68,184.95,Outgoing
93529019,2023-02-08,-139.28,59.4,Incoming
93529019,2023-02-09,-27.450000000000003,111.83,Incoming
93529019,2023-02-10,55.28,82.73,Incoming
93529019,2023-02-11,-1452.1200000000001,1507.4,Outgoing
93529019,2023-02-14,-1294.98,157.14,Incoming
93559470,2023-01-31,210.7,,-
93559470,2023-02-01,337.34,126.64,Incoming
93559470,2023-02-05,272.83,64.51,Outgoing
93559470,2023-02-05,1022.73,749.9,Incoming
93559470,2023-02-08,1130.43,107.7,Incoming
93559470,2023-02-08,967.84,162.59,Outgoing
93559470,2023-02-09,1118.06,150.22,Incoming
93559470,2023-02-10,1044.07,73.99,Outgoing
93559470,2023-02-10,1130.6799999999998,86.61,Incoming
93564856,2023-01-31,234.66,,-
93564856,2023-02-01,117.42,117.24,Outgoing
93564856,2023-02-06,23.659999999999997,93.76,Outgoing
93564856,2023-02-09,-73.89,97.55,Outgoing
93564856,2023-02-10,-141.09,67.2,Outgoing
93564856,2023-02-11,-260.96000000000004,119.87,Outgoing
93564856,2023-02-12,-1951.8600000000001,1690.9,Outgoing
93564856,2023-02-14,-1855.45,96.41,Incoming
93569124,2023-01-31,221.11,,-
93569124,2023-02-10,64.48000000000002,156.63,Outgoing
93569124,2023-02-11,61.460000000000015,3.02,Outgoing
93569124,2023-02-14,142.44000000000003,80.98,Incoming
93624474,2023-01-31,622.14,,-
93624474,2023-02-02,507.27,114.87,Outgoing
93624474,2023-02-03,421.96999999999997,85.3,Outgoing
93624474,2023-02-04,453.90999999999997,31.94,Incoming
93624474,2023-02-04,373.4,80.51,Outgoing
93624474,2023-02-09,1314.3,940.9,Incoming
93624474,2023-02-10,1371.34,57.04,Incoming
93624474,2023-02-11,312.6399999999999,1058.7,Outgoing
93624474,2023-02-14,219.1199999999999,93.52,Outgoing
93630048,2023-01-31,317.95,,-
93630048,2023-02-02,282.05,35.9,Outgoing
93630048,2023-02-03,338.12,56.07,Incoming
93630048,2023-02-03,399.41,61.29,Incoming
93630048,2023-02-14,364.45000000000005,34.96,Outgoing
93630048,2023-02-14,430.81000000000006,66.36,Incoming
93707181,2023-01-31,321.91,,-
93707181,2023-02-01,222.28000000000003,99.63,Outgoing
93707181,2023-02-03,77.46000000000004,144.82,Outgoing
93707181,2023-02-05,-9.599999999999966,87.06,Outgoing
93745446,2023-01-31,574.89,,-
93745446,2023-02-02,-212.71000000000004,787.6,Outgoing
93745446,2023-02-05,-390.38,177.67,Outgoing
93745446,2023-02-08,-527.06,136.68,Outgoing
93745446,2023-02-09,-577.3399999999999,50.28,Outgoing
93745446,2023-02-10,697.96,1275.3,Incoming
93745446,2023-02-12,603.96,94.0,Outgoing
93745446,2023-02-12,667.97,64.01,Incoming
93745446,2023-02-12,759.04,91.07,Incoming
93745446,2023-02-13,944.31,185.27,Incoming
93747938,2023-01-31,724.31,,-
93747938,2023-02-07,1801.11,1076.8,Incoming
93747938,2023-02-08,1745.54,55.57,Outgoing
93747938,2023-02-09,1904.04,158.5,Incoming
93747938,2023-02-10,1963.35,59.31,Incoming
93840154,2023-01-31,159.7,,-
93840154,2023-02-05,254.07999999999998,94.38,Incoming
93840154,2023-02-08,139.71999999999997,114.36,Outgoing
93840154,2023-02-10,230.49999999999997,90.78,Incoming
93840154,2023-02-14,130.54999999999995,99.95,Outgoing
93840154,2023-02-14,153.13999999999996,22.59,Incoming
93932516,2023-01-31,575.82,,-
93932516,2023-02-02,686.34,110.52,Incoming
93932516,2023-02-05,1546.24,859.9,Incoming
93932516,2023-02-07,1413.26,132.98,Outgoing
93932516,2023-02-07,1449.41,36.15,Incoming
93932516,2023-02-08,1231.8300000000002,217.58,Outgoing
93932516,2023-02-08,1247.5400000000002,15.71,Incoming
93932516,2023-02-09,1141.8300000000002,105.71,Outgoing
93932516,2023-02-11,1204.19,62.36,Incoming
93932516,2023-02-13,1357.33,153.14,Incoming
93981472,2023-01-31,175.68,,-
93981472,2023-02-02,-1123.12,1298.8,Outgoing
93981472,2023-02-05,-1301.1999999999998,178.08,Outgoing
93981472,2023-02-08,-703.7999999999998,597.4,Incoming
93981472,2023-02-08,-817.9599999999998,114.16,Outgoing
93981472,2023-02-10,-926.8099999999998,108.85,Outgoing
93981472,2023-02-10,-1058.4299999999998,131.62,Outgoing
93981472,2023-02-10,-976.1999999999998,82.23,Incoming
93981472,2023-02-12,-786.0299999999999,190.17,Incoming
93981472,2023-02-13,-681.3299999999998,104.7,Incoming
93981472,2023-02-14,-546.1899999999998,135.14,Incoming
94044891,2023-01-31,367.77,,-
94044891,2023-02-03,244.17,123.6,Outgoing
94044891,2023-02-05,346.64,102.47,Incoming
94044891,2023-02-06,289.16999999999996,57.47,Outgoing
94044891,2023-02-13,402.04999999999995,112.88,Incoming
94060198,2023-01-31,309.9,,-
94060198,2023-02-01,1973.3000000000002,1663.4,Incoming
94060198,2023-02-02,2139.4,166.1,Incoming
94060198,2023-02-03,2242.7200000000003,103.32,Incoming
94060198,2023-02-05,925.0200000000002,1317.7,Outgoing
94060198,2023-02-09,1007.0700000000002,82.05,Incoming
94060198,2023-02-10,861.2100000000002,145.86,Outgoing
94060198,2023-02-10,801.5500000000002,59.66,Outgoing
94060198,2023-02-13,753.6600000000002,47.89,Outgoing
94082779,2023-01-31,49.87,,-
94082779,2023-02-03,126.28999999999999,76.42,Incoming
94082779,2023-02-06,37.00999999999999,89.28,Outgoing
94082779,2023-02-13,-90.50000000000001,127.51,Outgoing
94096082,2023-01-31,342.2,,-
94096082,2023-02-05,182.73999999999998,159.46,Outgoing
94096082,2023-02-09,317.02,134.28,Incoming
94096082,2023-02-13,-128.78000000000003,445.8,Outgoing
94106013,2023-01-31,844.86,,-
94106013,2023-02-04,757.21,87.65,Outgoing
94106013,2023-02-04,698.6600000000001,58.55,Outgoing
94106013,2023-02-07,579.21,119.45,Outgoing
94106013,2023-02-12,673.2900000000001,94.08,Incoming
94106013,2023-02-14,525.22,148.07,Outgoing
94163785,2023-01-31,953.91,,-
94163785,2023-02-03,67.61000000000001,886.3,Outgoing
94163785,2023-02-04,167.86,100.25,Incoming
94163785,2023-02-06,283.67,115.81,Incoming
94163785,2023-02-07,402.01,118.34,Incoming
94163785,2023-02-12,502.5,100.49,Incoming
94163785,2023-02-14,669.37,166.87,Incoming
94171142,2023-01-31,261.94,,-
94171142,2023-02-01,385.02,123.08,Incoming
94171142,2023-02-02,518.11,133.09,Incoming
94171142,2023-02-02,369.76,148.35,Outgoing
94171142,2023-02-08,892.06,522.3,Incoming
94171142,2023-02-09,957.2099999999999,65.15,Incoming
94171142,2023-02-11,1106.3999999999999,149.19,Incoming
94171142,2023-02-11,1088.5099999999998,17.89,Outgoing
94171142,2023-02-14,1571.7099999999998,483.2,Incoming
94200289,2023-01-31,207.5,,-
94200289,2023-02-05,331.28,123.78,Incoming
94200289,2023-02-05,358.64,27.36,Incoming
94200289,2023-02-06,179.69,178.95,Outgoing
94200289,2023-02-06,194.91,15.22,Incoming
94200289,2023-02-07,265.67,70.76,Incoming
94200289,2023-02-12,111.92000000000002,153.75,Outgoing
94200289,2023-02-14,243.28000000000003,131.36,Incoming
94208888,2023-01-31,97.84,,-
94208888,2023-02-03,262.78,164.94,Incoming
94208888,2023-02-04,153.27999999999997,109.5,Outgoing
94208888,2023-02-11,2098.1800000000003,1944.9,Incoming
94208888,2023-02-12,2207.4400000000005,109.26,Incoming
94212460,2023-01-31,215.27,,-
94228831,2023-01-31,277.02,,-
94228831,2023-02-02,136.40999999999997,140.61,Outgoing
94228831,2023-02-03,268.15,131.74,Incoming
94228831,2023-02-06,378.69,110.54,Incoming
94228831,2023-02-06,269.21,109.48,Outgoing
94228831,2023-02-12,93.17999999999998,176.03,Outgoing
94247629,2023-01-31,308.63,,-
94247629,2023-02-04,268.87,39.76,Outgoing
94247629,2023-02-05,162.96,105.91,Outgoing
94247629,2023-02-07,1901.66,1738.7,Incoming
94247629,2023-02-12,1791.46,110.2,Outgoing
94331180,2023-01-31,89.31,,-
94331180,2023-02-01,144.29,54.98,Incoming
94331180,2023-02-07,42.849999999999994,101.44,Outgoing
94331180,2023-02-11,148.26999999999998,105.42,Incoming
94331180,2023-02-13,219.11999999999998,70.85,Incoming
94342965,2023-01-31,282.51,,-
94342965,2023-02-02,175.0,107.51,Outgoing
94342965,2023-02-05,334.07,159.07,Incoming
94342965,2023-02-09,-873.9300000000001,1208.0,Outgoing
94342965,2023-02-12,-740.4200000000001,133.51,Incoming
94365401,2023-01-31,81.28,,-
94365401,2023-02-02,43.660000000000004,37.62,Outgoing
94365401,2023-02-03,144.91,101.25,Incoming
94365401,2023-02-08,51.14,93.77,Outgoing
94365401,2023-02-11,-71.07,122.21,Outgoing
94365401,2023-02-12,-39.86999999999999,31.2,Incoming
94409941,2023-01-31,642.83,,-
94409941,2023-02-01,735.34,92.51,Incoming
94409941,2023-02-04,106.34000000000003,629.0,Outgoing
94409941,2023-02-12,39.790000000000035,66.55,Outgoing
94409941,2023-02-14,192.48000000000002,152.69,Incoming
94409941,2023-02-14,1059.98,867.5,Incoming
94437482,2023-01-31,415.91,,-
94437482,2023-02-06,321.59000000000003,94.32,Outgoing
94437482,2023-02-06,465.03000000000003,143.44,Incoming
94437482,2023-02-09,519.0,53.97,Incoming
94437482,2023-02-10,565.55,46.55,Incoming
94437482,2023-02-14,-385.1500000000001,950.7,Outgoing
94457332,2023-01-31,764.02,,-
94457332,2023-02-05,871.81,107.79,Incoming
94457332,2023-02-06,724.8499999999999,146.96,Outgoing
94457332,2023-02-14,758.5099999999999,33.66,Incoming
94493359,2023-01-31,17.96,,-
94493359,2023-02-03,151.37,133.41,Incoming
94493359,2023-02-06,263.39,112.02,Incoming
94493359,2023-02-07,434.55999999999995,171.17,Incoming
94493359,2023-02-10,518.49,83.93,Incoming
94493359,2023-02-11,389.14,129.35,Outgoing
94493359,2023-02-11,492.04999999999995,102.91,Incoming
94493359,2023-02-12,598.91,106.86,Incoming
94525216,2023-01-31,635.22,,-
94525216,2023-02-02,590.6600000000001,44.56,Outgoing
94525216,2023-02-05,705.7600000000001,115.1,Incoming
94525216,2023-02-07,573.6200000000001,132.14,Outgoing
94525216,2023-02-07,757.0600000000002,183.44,Incoming
94525216,2023-02-07,659.1100000000001,97.95,Outgoing
94525216,2023-02-09,468.29000000000013,190.82,Outgoing
94525216,2023-02-10,328.78000000000014,139.51,Outgoing
94566140,2023-01-31,31.61,,-
94566140,2023-02-04,85.75999999999999,54.15,Incoming
94566140,2023-02-06,214.67,128.91,Incoming
94566140,2023-02-07,366.9,152.23,Incoming
94566140,2023-02-07,328.02,38.88,Outgoing
94566140,2023-02-09,283.08,44.94,Outgoing
94566140,2023-02-13,387.58,104.5,Incoming
94566140,2023-02-14,349.46,38.12,Outgoing
94615411,2023-01-31,147.21,,-
94615411,2023-02-02,1163.01,1015.8,Incoming
94615411,2023-02-04,1011.69,151.32,Outgoing
94615411,2023-02-08,939.71,71.98,Outgoing
94615411,2023-02-09,762.74,176.97,Outgoing
94615411,2023-02-09,872.25,109.51,Incoming
94615411,2023-02-10,952.02,79.77,Incoming
94615411,2023-02-12,813.66,138.36,Outgoing
94615411,2023-02-12,907.4399999999999,93.78,Incoming
94629877,2023-01-31,908.69,,-
94629877,2023-02-03,842.75,65.94,Outgoing
94629877,2023-02-04,1874.15,1031.4,Incoming
94629877,2023-02-04,989.2500000000001,884.9,Outgoing
94629877,2023-02-04,1675.75,686.5,Incoming
94629877,2023-02-05,1788.68,112.93,Incoming
94629877,2023-02-09,888.8800000000001,899.8,Outgoing
94629877,2023-02-10,707.1700000000001,181.71,Outgoing
94629877,2023-02-12,634.71,72.46,Outgoing
94635297,2023-01-31,353.43,,-
94635297,2023-02-02,379.24,25.81,Incoming
94635297,2023-02-03,263.37,115.87,Outgoing
94635297,2023-02-04,355.64,92.27,Incoming
94635297,2023-02-05,273.0,82.64,Outgoing
94635297,2023-02-08,349.81,76.81,Incoming
94645169,2023-01-31,854.22,,-
94645169,2023-02-01,952.27,98.05,Incoming
94645169,2023-02-03,964.27,12.0,Incoming
94645169,2023-02-07,1039.04,74.77,Incoming
94645169,2023-02-07,913.8,125.24,Outgoing
94645169,2023-02-07,1047.76,133.96,Incoming
94645169,2023-02-11,1221.73,173.97,Incoming
94645169,2023-02-12,1092.79,128.94,Outgoing
94645169,2023-02-13,1220.3,127.51,Incoming
94645169,2023-02-14,1221.03,0.73,Incoming
94660017,2023-01-31,107.29,,-
94660017,2023-02-01,222.43,115.14,Incoming
94660017,2023-02-10,135.68,86.75,Outgoing
94660017,2023-02-12,94.07000000000001,41.61,Outgoing
94660017,2023-02-13,-29.569999999999993,123.64,Outgoing
94660017,2023-02-13,-76.6,47.03,Outgoing
94677908,2023-01-31,343.33,,-
94677908,2023-02-01,227.92,115.41,Outgoing
94677908,2023-02-03,139.77999999999997,88.14,Outgoing
94677908,2023-02-03,22.559999999999974,117.22,Outgoing
94677908,2023-02-04,128.62999999999997,106.07,Incoming
94677908,2023-02-07,250.08999999999997,121.46,Incoming
94677908,2023-02-08,393.93999999999994,143.85,Incoming
94677908,2023-02-09,255.74999999999994,138.19,Outgoing
94677908,2023-02-12,1790.35,1534.6,Incoming
94677908,2023-02-13,1619.56,170.79,Outgoing
94716844,2023-01-31,605.84,,-
94716844,2023-02-01,708.74,102.9,Incoming
94716844,2023-02-04,798.83,90.09,Incoming
94716844,2023-02-04,630.5400000000001,168.29,Outgoing
94716844,2023-02-06,688.71,58.17,Incoming
94716844,2023-02-08,565.6500000000001,123.06,Outgoing
94716844,2023-02-10,502.7100000000001,62.94,Outgoing
94716844,2023-02-11,565.6100000000001,62.9,Incoming
94716844,2023-02-13,484.8700000000001,80.74,Outgoing
94716844,2023-02-13,586.7400000000001,101.87,Incoming
94716844,2023-02-14,492.29000000000013,94.45,Outgoing
94716844,2023-02-14,294.09000000000015,198.2,Outgoing
94729530,2023-01-31,635.76,,-
94729530,2023-02-01,576.8,58.96,Outgoing
94729530,2023-02-01,440.04999999999995,136.75,Outgoing
94729530,2023-02-01,377.09999999999997,62.95,Outgoing
94729530,2023-02-10,519.67,142.57,Incoming
94729530,2023-02-13,415.16999999999996,104.5,Outgoing
94729530,2023-02-13,251.17999999999995,163.99,Outgoing
94732589,2023-01-31,697.54,,-
94732589,2023-02-02,788.4499999999999,90.91,Incoming
94732589,2023-02-03,969.3199999999999,180.87,Incoming
94732589,2023-02-03,1108.9199999999998,139.6,Incoming
94732589,2023-02-04,1006.4799999999998,102.44,Outgoing
94732589,2023-02-06,958.6999999999998,47.78,Outgoing
94732589,2023-02-06,834.4799999999998,124.22,Outgoing
94732589,2023-02-14,954.8999999999997,120.42,Incoming
94748860,2023-01-31,630.6,,-
94748860,2023-02-04,586.5500000000001,44.05,Outgoing
94748860,2023-02-08,555.2500000000001,31.3,Outgoing
94748860,2023-02-08,436.1800000000001,119.07,Outgoing
94796578,2023-01-31,700.49,,-
94796578,2023-02-01,1758.19,1057.7,Incoming
94796578,2023-02-03,1717.8,40.39,Outgoing
94796578,2023-02-03,1652.6599999999999,65.14,Outgoing
94796578,2023-02-05,1539.9699999999998,112.69,Outgoing
94796578,2023-02-06,1429.1399999999999,110.83,Outgoing
94796578,2023-02-06,1344.56,84.58,Outgoing
94796578,2023-02-07,1513.92,169.36,Incoming
94796578,2023-02-08,1681.0300000000002,167.11,Incoming
94796578,2023-02-10,1431.2200000000003,249.81,Outgoing
94796578,2023-02-12,1383.1300000000003,48.09,Outgoing
94796578,2023-02-13,1348.8300000000004,34.3,Outgoing
94796578,2023-02-14,1269.2900000000004,79.54,Outgoing
94796578,2023-02-14,1201.1700000000005,68.12,Outgoing
94814824,2023-01-31,716.75,,-
94814824,2023-02-05,557.45,159.3,Outgoing
94814824,2023-02-07,546.08,11.37,Outgoing
94814824,2023-02-09,634.07,87.99,Incoming
94814824,2023-02-13,753.76,119.69,Incoming
94814824,2023-02-14,693.74,60.02,Outgoing
94893604,2023-01-31,289.19,,-
94893604,2023-02-01,167.12,122.07,Outgoing
94893604,2023-02-02,307.39,140.27,Incoming
94893604,2023-02-04,156.6,150.79,Outgoing
94893604,2023-02-08,66.08,90.52,Outgoing
94893604,2023-02-12,-38.43000000000001,104.51,Outgoing
94935991,2023-01-31,645.53,,-
94935991,2023-02-03,755.27,109.74,Incoming
94935991,2023-02-04,637.0799999999999,118.19,Outgoing
94935991,2023-02-04,630.02,7.06,Outgoing
94935991,2023-02-09,545.99,84.03,Outgoing
94935991,2023-02-10,429.27,116.72,Outgoing
94935991,2023-02-12,-586.53,1015.8,Outgoing
94935991,2023-02-14,-549.93,36.6,Incoming
94973297,2023-01-31,761.68,,-
94973297,2023-02-04,873.81,112.13,Incoming
94973297,2023-02-06,955.41,81.6,Incoming
94973297,2023-02-09,1025.05,69.64,Incoming
94973297,2023-02-10,-250.25,1275.3,Outgoing
94973297,2023-02-10,-177.09,73.16,Incoming
94973297,2023-02-14,1187.91,1365.0,Incoming
95009921,2023-01-31,658.77,,-
95009921,2023-02-01,534.5,124.27,Outgoing
95009921,2023-02-02,431.47,103.03,Outgoing
95009921,2023-02-04,278.19000000000005,153.28,Outgoing
95009921,2023-02-05,119.65000000000006,158.54,Outgoing
95009921,2023-02-06,32.44000000000007,87.21,Outgoing
95009921,2023-02-08,-61.84999999999994,94.29,Outgoing
95009921,2023-02-09,83.08000000000007,144.93,Incoming
95009921,2023-02-12,-4.649999999999935,87.73,Outgoing
95009921,2023-02-14,106.43000000000006,111.08,Incoming
95009921,2023-02-14,-4.229999999999933,110.66,Outgoing
95009921,2023-02-14,-192.52999999999994,188.3,Outgoing
95060122,2023-01-31,771.61,,-
95060122,2023-02-03,888.45,116.84,Incoming
95060122,2023-02-03,1008.1300000000001,119.68,Incoming
95060122,2023-02-04,856.1000000000001,152.03,Outgoing
95060122,2023-02-06,1489.1000000000001,633.0,Incoming
95060122,2023-02-10,1652.4,163.3,Incoming
95060122,2023-02-10,1581.46,70.94,Outgoing
95060122,2023-02-10,1646.48,65.02,Incoming
95060122,2023-02-14,1675.89,29.41,Incoming
95081571,2023-01-31,712.07,,-
95081571,2023-02-01,788.33,76.26,Incoming
95081571,2023-02-02,876.9000000000001,88.57,Incoming
95081571,2023-02-02,1002.8900000000001,125.99,Incoming
95081571,2023-02-07,1171.0600000000002,168.17,Incoming
95081571,2023-02-07,1153.4800000000002,17.58,Outgoing
95081571,2023-02-08,1092.7800000000002,60.7,Outgoing
95081571,2023-02-08,-237.91999999999985,1330.7,Outgoing
95081571,2023-02-09,-394.6299999999999,156.71,Outgoing
95081571,2023-02-13,-498.64999999999986,104.02,Outgoing
95113741,2023-01-31,102.12,,-
95113741,2023-02-02,-11.61,113.73,Outgoing
95113741,2023-02-03,-200.64,189.03,Outgoing
95113741,2023-02-07,-372.16999999999996,171.53,Outgoing
95113741,2023-02-08,-435.5799999999999,63.41,Outgoing
95213279,2023-01-31,441.59,,-
95213279,2023-02-04,527.52,85.93,Incoming
95213279,2023-02-04,534.5799999999999,7.06,Incoming
95213279,2023-02-05,568.43,33.85,Incoming
95213279,2023-02-07,618.92,50.49,Incoming
95213279,2023-02-08,3210.62,2591.7,Incoming
95213279,2023-02-11,3307.54,96.92,Incoming
95258436,2023-01-31,59.55,,-
95258436,2023-02-02,149.42000000000002,89.87,Incoming
95258436,2023-02-02,10.170000000000016,139.25,Outgoing
95258436,2023-02-02,168.49,158.32,Incoming
95258436,2023-02-06,92.94000000000001,75.55,Outgoing
95258436,2023-02-09,-19.109999999999985,112.05,Outgoing
95258436,2023-02-09,-160.92999999999998,141.82,Outgoing
95258436,2023-02-10,-282.74,121.81,Outgoing
95258436,2023-02-14,-1246.24,963.5,Outgoing
95258436,2023-02-14,-1140.26,105.98,Incoming
95258436,2023-02-14,-1038.67,101.59,Incoming
95274344,2023-01-31,990.84,,-
95274344,2023-02-05,1155.88,165.04,Incoming
95274344,2023-02-05,996.0900000000001,159.79,Outgoing
95274344,2023-02-05,1958.0900000000001,962.0,Incoming
95274344,2023-02-06,2057.1200000000003,99.03,Incoming
95274344,2023-02-08,1934.0000000000005,123.12,Outgoing
95274344,2023-02-14,2019.4800000000005,85.48,Incoming
95277712,2023-01-31,235.91,,-
95277712,2023-02-03,152.22,83.69,Outgoing
95277712,2023-02-04,241.05,88.83,Incoming
95277712,2023-02-05,141.8,99.25,Outgoing
95277712,2023-02-07,265.48,123.68,Incoming
95277712,2023-02-11,399.15,133.67,Incoming
95277712,2023-02-12,1333.85,934.7,Incoming
95307629,2023-01-31,502.48,,-
95307629,2023-02-01,413.33000000000004,89.15,Outgoing
95307629,2023-02-05,371.68000000000006,41.65,Outgoing
95307629,2023-02-09,1695.88,1324.2,Incoming
95307629,2023-02-12,1764.25,68.37,Incoming
95307629,2023-02-14,1732.55,31.7,Outgoing
95307629,2023-02-14,1560.86,171.69,Outgoing
95309911,2023-01-31,171.61,,-
95309911,2023-02-01,254.03000000000003,82.42,Incoming
95309911,2023-02-02,143.68000000000004,110.35,Outgoing
95309911,2023-02-05,104.48000000000003,39.2,Outgoing
95309911,2023-02-06,72.14000000000003,32.34,Outgoing
95309911,2023-02-06,-82.60999999999997,154.75,Outgoing
95309911,2023-02-09,15.28000000000003,97.89,Incoming
95309911,2023-02-09,-348.52,363.8,Outgoing
95309911,2023-02-12,-457.78,109.26,Outgoing
95356167,2023-01-31,170.2,,-
95356167,2023-02-08,208.97,38.77,Incoming
95356167,2023-02-10,180.39,28.58,Outgoing
95356167,2023-02-12,76.59999999999998,103.79,Outgoing
95356167,2023-02-14,-47.250000000000014,123.85,Outgoing
95367755,2023-01-31,926.51,,-
95367755,2023-02-04,1548.9099999999999,622.4,Incoming
95367755,2023-02-07,1478.29,70.62,Outgoing
95367755,2023-02-08,1609.0,130.71,Incoming
95367755,2023-02-13,1545.83,63.17,Outgoing
95367755,2023-02-13,1647.49,101.66,Incoming
95390412,2023-01-31,553.04,,-
95390412,2023-02-01,702.8399999999999,149.8,Incoming
95390412,2023-02-02,755.0899999999999,52.25,Incoming
95390412,2023-02-03,675.7399999999999,79.35,Outgoing
95390412,2023-02-07,577.1699999999998,98.57,Outgoing
95390412,2023-02-09,1753.9699999999998,1176.8,Incoming
95390412,2023-02-11,1854.1999999999998,100.23,Incoming
95412973,2023-01-31,892.85,,-
95412973,2023-02-02,1093.28,200.43,Incoming
95412973,2023-02-10,1257.21,163.93,Incoming
95412973,2023-02-13,1290.99,33.78,Incoming
95446510,2023-01-31,581.43,,-
95446510,2023-02-04,781.8499999999999,200.42,Incoming
95446510,2023-02-04,659.8999999999999,121.95,Outgoing
95446510,2023-02-04,571.7499999999999,88.15,Outgoing
95446510,2023-02-06,616.7599999999999,45.01,Incoming
95446510,2023-02-08,746.6299999999999,129.87,Incoming
95446510,2023-02-13,843.0399999999998,96.41,Incoming
95452518,2023-01-31,390.37,,-
95452518,2023-02-06,218.1,172.27,Outgoing
95452518,2023-02-08,328.16999999999996,110.07,Incoming
95452518,2023-02-12,414.34,86.17,Incoming
95467370,2023-01-31,307.45,,-
95467370,2023-02-02,-965.6499999999999,1273.1,Outgoing
95467370,2023-02-03,-996.6499999999999,31.0,Outgoing
95467370,2023-02-04,-1047.34,50.69,Outgoing
95467370,2023-02-05,-1027.03,20.31,Incoming
95467370,2023-02-06,-902.86,124.17,Incoming
95467370,2023-02-09,-829.26,73.6,Incoming
95467370,2023-02-10,-991.5799999999999,162.32,Outgoing
95527674,2023-01-31,688.37,,-
95527674,2023-02-01,523.4300000000001,164.94,Outgoing
95527674,2023-02-03,669.4000000000001,145.97,Incoming
95527674,2023-02-07,755.9100000000001,86.51,Incoming
95527674,2023-02-09,632.0300000000001,123.88,Outgoing
95527674,2023-02-09,734.1700000000001,102.14,Incoming
95527674,2023-02-11,627.5500000000001,106.62,Outgoing
95527674,2023-02-11,493.96000000000004,133.59,Outgoing
95527674,2023-02-11,386.39000000000004,107.57,Outgoing
95527674,2023-02-14,554.23,167.84,Incoming
95564462,2023-01-31,643.45,,-
95564462,2023-02-04,478.0300000000001,165.42,Outgoing
95564462,2023-02-06,501.0200000000001,22.99,Incoming
95564462,2023-02-12,422.1300000000001,78.89,Outgoing
95600095,2023-01-31,400.05,,-
95600095,2023-02-07,274.93,125.12,Outgoing
95600095,2023-02-12,183.12,91.81,Outgoing
95600095,2023-02-13,308.28,125.16,Incoming
95642341,2023-01-31,695.88,,-
95642341,2023-02-01,149.58000000000004,546.3,Outgoing
95642341,2023-02-05,247.03000000000003,97.45,Incoming
95642341,2023-02-07,303.52000000000004,56.49,Incoming
95642341,2023-02-10,1678.82,1375.3,Incoming
95642341,2023-02-12,1544.4099999999999,134.41,Outgoing
95642341,2023-02-13,1502.1499999999999,42.26,Outgoing
95642341,2023-02-13,1397.6399999999999,104.51,Outgoing
95642341,2023-02-14,1573.12,175.48,Incoming
95645055,2023-01-31,645.58,,-
95645055,2023-02-06,566.97,78.61,Outgoing
95645055,2023-02-10,467.69000000000005,99.28,Outgoing
95645055,2023-02-11,508.40000000000003,40.71,Incoming
95645055,2023-02-11,484.22,24.18,Outgoing
95674888,2023-01-31,838.92,,-
95674888,2023-02-01,714.06,124.86,Outgoing
95674888,2023-02-08,733.65,19.59,Incoming
95674888,2023-02-13,-524.4499999999999,1258.1,Outgoing
95674888,2023-02-13,-474.55999999999995,49.89,Incoming
95674888,2023-02-13,-552.03,77.47,Outgoing
95674888,2023-02-13,-556.6899999999999,4.66,Outgoing
95674888,2023-02-14,-735.15,178.46,Outgoing
95710324,2023-01-31,978.16,,-
95710324,2023-02-02,1060.8799999999999,82.72,Incoming
95710324,2023-02-02,1090.8899999999999,30.01,Incoming
95710324,2023-02-09,1279.0299999999997,188.14,Incoming
95710324,2023-02-10,1421.1599999999999,142.13,Incoming
95710324,2023-02-10,-63.04000000000019,1484.2,Outgoing
95710324,2023-02-10,-136.6900000000002,73.65,Outgoing
95723006,2023-01-31,861.2,,-
95723006,2023-02-04,-223.5999999999999,1084.8,Outgoing
95723006,2023-02-06,-139.76999999999992,83.83,Incoming
95723006,2023-02-09,-42.94999999999993,96.82,Incoming
95723006,2023-02-10,-134.82999999999993,91.88,Outgoing
95723006,2023-02-10,-263.78999999999996,128.96,Outgoing
95723006,2023-02-11,-190.12999999999997,73.66,Incoming
95743658,2023-01-31,586.9,,-
95743658,2023-02-01,528.72,58.18,Outgoing
95743658,2023-02-02,615.4100000000001,86.69,Incoming
95743658,2023-02-03,762.4200000000001,147.01,Incoming
95743658,2023-02-07,707.7900000000001,54.63,Outgoing
95743658,2023-02-07,600.0000000000001,107.79,Outgoing
95743658,2023-02-07,-334.19999999999993,934.2,Outgoing
95743658,2023-02-09,-213.03999999999994,121.16,Incoming
95743658,2023-02-09,-116.51999999999994,96.52,Incoming
95743658,2023-02-11,-212.67999999999995,96.16,Outgoing
95743658,2023-02-12,-240.41999999999996,27.74,Outgoing
95743658,2023-02-13,-321.42999999999995,81.01,Outgoing
95759022,2023-01-31,78.02,,-
95759022,2023-02-01,1.6299999999999955,76.39,Outgoing
95759022,2023-02-02,29.809999999999995,28.18,Incoming
95759022,2023-02-05,-4.040000000000006,33.85,Outgoing
95759022,2023-02-06,-183.12,179.08,Outgoing
95759022,2023-02-09,-667.12,484.0,Outgoing
95759022,2023-02-09,-511.03999999999996,156.08,Incoming
95868007,2023-01-31,974.32,,-
95868007,2023-02-01,1063.47,89.15,Incoming
95868007,2023-02-02,1132.88,69.41,Incoming
95868007,2023-02-03,1400.5800000000002,267.7,Incoming
95868007,2023-02-05,1535.13,134.55,Incoming
95868007,2023-02-06,1627.8300000000002,92.7,Incoming
95868007,2023-02-06,1723.14,95.31,Incoming
95868007,2023-02-06,1667.0600000000002,56.08,Outgoing
95868007,2023-02-07,1587.7400000000002,79.32,Outgoing
95868007,2023-02-11,1722.2400000000002,134.5,Incoming
95898143,2023-01-31,197.65,,-
95898143,2023-02-05,100.28,97.37,Outgoing
95898143,2023-02-09,150.91,50.63,Incoming
95898143,2023-02-10,933.11,782.2,Incoming
95898143,2023-02-12,823.21,109.9,Outgoing
95993993,2023-01-31,95.41,,-
95993993,2023-02-03,1362.1100000000001,1266.7,Incoming
95993993,2023-02-07,1248.3200000000002,113.79,Outgoing
95993993,2023-02-13,1209.6200000000001,38.7,Outgoing
95993993,2023-02-14,71.92000000000007,1137.7,Outgoing
96050548,2023-01-31,299.46,,-
96050548,2023-02-04,372.28999999999996,72.83,Incoming
96050548,2023-02-08,246.37999999999997,125.91,Outgoing
96050548,2023-02-09,144.05999999999997,102.32,Outgoing
96050548,2023-02-09,228.60999999999996,84.55,Incoming
96050548,2023-02-11,336.46999999999997,107.86,Incoming
96051784,2023-01-31,21.7,,-
96051784,2023-02-01,-90.19,111.89,Outgoing
96051784,2023-02-05,1031.31,1121.5,Incoming
96051784,2023-02-06,932.0,99.31,Outgoing
96051784,2023-02-07,854.54,77.46,Outgoing
96051784,2023-02-13,996.0,141.46,Incoming
96121732,2023-01-31,771.81,,-
96121732,2023-02-01,873.49,101.68,Incoming
96121732,2023-02-01,788.81,84.68,Outgoing
96121732,2023-02-04,718.05,70.76,Outgoing
96121732,2023-02-04,799.99,81.94,Incoming
96121732,2023-02-05,898.29,98.3,Incoming
96121732,2023-02-05,799.99,98.3,Outgoing
96121732,2023-02-05,899.14,99.15,Incoming
96121732,2023-02-10,796.4,102.74,Outgoing
96121732,2023-02-11,871.56,75.16,Incoming
96121732,2023-02-11,-798.1400000000001,1669.7,Outgoing
96121732,2023-02-13,-962.1400000000001,164.0,Outgoing
96121732,2023-02-13,-1061.2,99.06,Outgoing
96121732,2023-02-14,-896.82,164.38,Incoming
96153427,2023-01-31,24.33,,-
96153427,2023-02-01,-59.75,84.08,Outgoing
96153427,2023-02-03,-180.31,120.56,Outgoing
96153427,2023-02-07,-265.65999999999997,85.35,Outgoing
96197628,2023-01-31,829.37,,-
96197628,2023-02-04,934.28,104.91,Incoming
96197628,2023-02-08,961.81,27.53,Incoming
96197628,2023-02-13,826.8399999999999,134.97,Outgoing
96200049,2023-01-31,959.58,,-
96200049,2023-02-01,898.35,61.23,Outgoing
96200049,2023-02-02,870.1700000000001,28.18,Outgoing
96200049,2023-02-02,775.6700000000001,94.5,Outgoing
96200049,2023-02-03,732.07,43.6,Outgoing
96200049,2023-02-03,591.0300000000001,141.04,Outgoing
96200049,2023-02-13,567.6600000000001,23.37,Outgoing
96208050,2023-01-31,171.46,,-
96208050,2023-02-01,310.64,139.18,Incoming
96208050,2023-02-01,359.63,48.99,Incoming
96208050,2023-02-08,459.82,100.19,Incoming
96208050,2023-02-09,360.64,99.18,Outgoing
96208050,2023-02-10,476.38,115.74,Incoming
96208050,2023-02-11,387.15999999999997,89.22,Outgoing
96208050,2023-02-12,294.22999999999996,92.93,Outgoing
96224831,2023-01-31,926.76,,-
96224831,2023-02-02,973.22,46.46,Incoming
96224831,2023-02-03,865.9200000000001,107.3,Outgoing
96224831,2023-02-06,932.08,66.16,Incoming
96224831,2023-02-09,1040.44,108.36,Incoming
96224831,2023-02-10,871.8000000000001,168.64,Outgoing
96224831,2023-02-11,779.8700000000001,91.93,Outgoing
96224831,2023-02-12,-485.2299999999998,1265.1,Outgoing
96224831,2023-02-14,-372.1599999999998,113.07,Incoming
96227490,2023-01-31,242.11,,-
96227490,2023-02-05,123.88000000000001,118.23,Outgoing
96227490,2023-02-07,-821.32,945.2,Outgoing
96227490,2023-02-07,-658.8100000000001,162.51,Incoming
96227490,2023-02-12,633.09,1291.9,Incoming
96227490,2023-02-13,681.86,48.77,Incoming
96227490,2023-02-14,758.79,76.93,Incoming
96236719,2023-01-31,999.32,,-
96236719,2023-02-02,-16.479999999999905,1015.8,Outgoing
96236719,2023-02-03,161.19000000000008,177.67,Incoming
96236719,2023-02-09,105.36000000000008,55.83,Outgoing
96236719,2023-02-13,-1264.7399999999998,1370.1,Outgoing
96278865,2023-01-31,930.45,,-
96278865,2023-02-06,-138.54999999999995,1069.0,Outgoing
96278865,2023-02-06,-239.25999999999993,100.71,Outgoing
96278865,2023-02-07,-308.4799999999999,69.22,Outgoing
96278865,2023-02-07,990.4200000000002,1298.9,Incoming
96278865,2023-02-09,952.5200000000002,37.9,Outgoing
96281358,2023-01-31,463.07,,-
96281358,2023-02-06,413.53,49.54,Outgoing
96281358,2023-02-08,249.59999999999997,163.93,Outgoing
96281358,2023-02-11,305.76,56.16,Incoming
96291927,2023-01-31,227.22,,-
96291927,2023-02-01,147.82,79.4,Outgoing
96291927,2023-02-03,232.51999999999998,84.7,Incoming
96291927,2023-02-07,379.28,146.76,Incoming
96291927,2023-02-09,478.71999999999997,99.44,Incoming
96291927,2023-02-09,602.5999999999999,123.88,Incoming
96291927,2023-02-12,454.42999999999995,148.17,Outgoing
96291927,2023-02-14,416.03,38.4,Outgoing
96319450,2023-01-31,779.16,,-
96319450,2023-02-01,592.71,186.45,Outgoing
96319450,2023-02-09,576.59,16.12,Outgoing
96319450,2023-02-10,615.5400000000001,38.95,Incoming
96319450,2023-02-11,823.4200000000001,207.88,Incoming
96319450,2023-02-13,703.73,119.69,Outgoing
96367781,2023-01-31,880.44,,-
96367914,2023-01-31,528.67,,-
96367914,2023-02-09,372.97999999999996,155.69,Outgoing
96367914,2023-02-12,391.93999999999994,18.96,Incoming
96401230,2023-01-31,21.44,,-
96401230,2023-02-01,-1641.96,1663.4,Outgoing
96401230,2023-02-02,-1443.68,198.28,Incoming
96401230,2023-02-03,-1358.44,85.24,Incoming
96401230,2023-02-03,-1313.8500000000001,44.59,Incoming
96401230,2023-02-07,-1289.44,24.41,Incoming
96401230,2023-02-08,-492.24,797.2,Incoming
96401230,2023-02-08,-588.57,96.33,Outgoing
96401230,2023-02-11,1225.0299999999997,1813.6,Incoming
96510893,2023-01-31,396.83,,-
96510893,2023-02-02,211.57,185.26,Outgoing
96510893,2023-02-09,137.16,74.41,Outgoing
96510893,2023-02-11,919.36,782.2,Incoming
96510893,2023-02-14,1028.01,108.65,Incoming
96605778,2023-01-31,70.72,,-
96605778,2023-02-01,183.7,112.98,Incoming
96605778,2023-02-02,300.59,116.89,Incoming
96605778,2023-02-02,458.87,158.28,Incoming
96605778,2023-02-04,762.27,303.4,Incoming
96605778,2023-02-08,64.47000000000003,697.8,Outgoing
96605778,2023-02-09,291.01,226.54,Incoming
96605778,2023-02-09,215.62,75.39,Outgoing
96605778,2023-02-09,163.65,51.97,Outgoing
96649120,2023-01-31,307.91,,-
96649120,2023-02-04,201.98000000000002,105.93,Outgoing
96649120,2023-02-05,248.32000000000002,46.34,Incoming
96649120,2023-02-05,375.31,126.99,Incoming
96649120,2023-02-07,295.78,79.53,Outgoing
96649120,2023-02-07,197.01,98.77,Outgoing
96649120,2023-02-08,332.91999999999996,135.91,Incoming
96649120,2023-02-12,369.24999999999994,36.33,Incoming
96649120,2023-02-13,315.91999999999996,53.33,Outgoing
96689242,2023-01-31,896.22,,-
96689242,2023-02-01,850.52,45.7,Outgoing
96689242,2023-02-03,764.9,85.62,Outgoing
96689242,2023-02-05,622.78,142.12,Outgoing
96689242,2023-02-06,1875.8799999999999,1253.1,Incoming
96689242,2023-02-11,1793.7299999999998,82.15,Outgoing
96719450,2023-01-31,633.74,,-
96719450,2023-02-07,1377.74,744.0,Incoming
96719450,2023-02-08,1258.8,118.94,Outgoing
96719450,2023-02-08,1362.81,104.01,Incoming
96719450,2023-02-10,1280.48,82.33,Outgoing
96719450,2023-02-10,-81.61999999999989,1362.1,Outgoing
96719450,2023-02-11,-22.459999999999894,59.16,Incoming
96719450,2023-02-11,731.84,754.3,Incoming
96719450,2023-02-11,818.7,86.86,Incoming
96756719,2023-01-31,601.68,,-
96756719,2023-02-04,670.7299999999999,69.05,Incoming
96756719,2023-02-05,720.5699999999999,49.84,Incoming
96756719,2023-02-06,1608.4699999999998,887.9,Incoming
96756719,2023-02-06,1673.0899999999997,64.62,Incoming
96756719,2023-02-07,1559.4899999999998,113.6,Outgoing
96756719,2023-02-07,1715.1799999999998,155.69,Incoming
96756719,2023-02-08,1819.7299999999998,104.55,Incoming
96756719,2023-02-10,948.5299999999997,871.2,Outgoing
96756719,2023-02-12,886.5799999999997,61.95,Outgoing
96756719,2023-02-13,1041.1599999999996,154.58,Incoming
96837696,2023-01-31,889.9,,-
96837696,2023-02-05,2021.6999999999998,1131.8,Incoming
96837696,2023-02-07,2186.3999999999996,164.7,Incoming
96837696,2023-02-08,2167.2899999999995,19.11,Outgoing
96837696,2023-02-11,2340.9899999999993,173.7,Incoming
96847078,2023-01-31,412.48,,-
96847078,2023-02-01,306.54,105.94,Outgoing
96847078,2023-02-02,486.21000000000004,179.67,Incoming
96847078,2023-02-08,510.59000000000003,24.38,Incoming
96847078,2023-02-08,404.92,105.67,Outgoing
96847078,2023-02-10,523.05,118.13,Incoming
96847078,2023-02-10,401.37999999999994,121.67,Outgoing
96847078,2023-02-13,381.2099999999999,20.17,Outgoing
96948178,2023-01-31,217.26,,-
96948178,2023-02-07,130.74,86.52,Outgoing
96948178,2023-02-07,201.92000000000002,71.18,Incoming
96948178,2023-02-08,98.03000000000002,103.89,Outgoing
96948178,2023-02-10,178.61,80.58,Incoming
96948178,2023-02-12,44.25,134.36,Outgoing
97010482,2023-01-31,542.39,,-
97010482,2023-02-01,458.62,83.77,Outgoing
97010482,2023-02-05,355.24,103.38,Outgoing
97010482,2023-02-09,397.01,41.77,Incoming
97010482,2023-02-13,319.0,78.01,Outgoing
97036090,2023-01-31,349.78,,-
97036090,2023-02-03,511.15,161.37,Incoming
97036090,2023-02-04,392.78,118.37,Outgoing
97036090,2023-02-06,305.83,86.95,Outgoing
97036090,2023-02-09,240.07,65.76,Outgoing
97036090,2023-02-09,-710.9300000000001,951.0,Outgoing
97048058,2023-01-31,977.42,,-
97048058,2023-02-03,393.12,584.3,Outgoing
97048058,2023-02-03,296.18,96.94,Outgoing
97048058,2023-02-08,373.41,77.23,Incoming
97048058,2023-02-09,494.75,121.34,Incoming
97048058,2023-02-10,391.15999999999997,103.59,Outgoing
97098684,2023-01-31,463.91,,-
97098684,2023-02-01,464.87,0.96,Incoming
97098684,2023-02-03,392.1,72.77,Outgoing
97098684,2023-02-04,315.16,76.94,Outgoing
97098684,2023-02-05,170.78000000000003,144.38,Outgoing
97098684,2023-02-07,239.64000000000004,68.86,Incoming
97098684,2023-02-08,34.73000000000005,204.91,Outgoing
97187999,2023-01-31,170.66,,-
97187999,2023-02-01,127.00999999999999,43.65,Outgoing
97187999,2023-02-03,221.51,94.5,Incoming
97187999,2023-02-05,249.39,27.88,Incoming
97187999,2023-02-10,319.5,70.11,Incoming
97187999,2023-02-11,328.75,9.25,Incoming
97187999,2023-02-13,-189.54999999999995,518.3,Outgoing
97187999,2023-02-14,535.45,725.0,Incoming
97187999,2023-02-14,595.47,60.02,Incoming
97258853,2023-01-31,348.49,,-
97258853,2023-02-01,242.16000000000003,106.33,Outgoing
97258853,2023-02-02,-915.24,1157.4,Outgoing
97258853,2023-02-03,-993.9,78.66,Outgoing
97258853,2023-02-06,-2906.8,1912.9,Outgoing
97258853,2023-02-06,-2072.9,833.9,Incoming
97258853,2023-02-11,-2229.9500000000003,157.05,Outgoing
97258853,2023-02-12,-2148.32,81.63,Incoming
97258853,2023-02-14,-2100.48,47.84,Incoming
97265555,2023-01-31,73.24,,-
97265555,2023-02-01,-64.01,137.25,Outgoing
97265555,2023-02-03,-163.43,99.42,Outgoing
97265555,2023-02-04,-85.77000000000001,77.66,Incoming
97265555,2023-02-09,73.28,159.05,Incoming
97265555,2023-02-13,231.31,158.03,Incoming
97294152,2023-01-31,700.06,,-
97294152,2023-02-01,696.51,3.55,Outgoing
97294152,2023-02-01,575.5799999999999,120.93,Outgoing
97294152,2023-02-01,-618.8200000000002,1194.4,Outgoing
97294152,2023-02-03,-378.27000000000015,240.55,Incoming
97294152,2023-02-04,-224.96000000000015,153.31,Incoming
97294152,2023-02-07,-387.47000000000014,162.51,Outgoing
97294152,2023-02-11,-228.38000000000014,159.09,Incoming
97294152,2023-02-12,-132.77000000000015,95.61,Incoming
97294152,2023-02-13,-20.81000000000016,111.96,Incoming
97294152,2023-02-14,129.08999999999986,149.9,Incoming
97305293,2023-01-31,241.02,,-
97305293,2023-02-03,44.07000000000002,196.95,Outgoing
97305293,2023-02-09,-100.94999999999999,145.02,Outgoing
97305293,2023-02-10,57.99000000000001,158.94,Incoming
97305293,2023-02-11,157.55,99.56,Incoming
97305293,2023-02-14,223.05,65.5,Incoming
97328154,2023-01-31,535.51,,-
97328154,2023-02-03,626.15,90.64,Incoming
97328154,2023-02-07,705.05,78.9,Incoming
97328154,2023-02-08,848.27,143.22,Incoming
97328154,2023-02-09,713.0899999999999,135.18,Outgoing
97328154,2023-02-11,820.6599999999999,107.57,Incoming
97328154,2023-02-11,764.9899999999999,55.67,Outgoing
97405607,2023-01-31,981.02,,-
97405607,2023-02-02,887.93,93.09,Outgoing
97405607,2023-02-06,882.5799999999999,5.35,Outgoing
97405607,2023-02-06,355.17999999999995,527.4,Outgoing
97405607,2023-02-08,502.26,147.08,Incoming
97405607,2023-02-10,600.5799999999999,98.32,Incoming
97405607,2023-02-11,544.2199999999999,56.36,Outgoing
97405607,2023-02-12,422.0899999999999,122.13,Outgoing
97405607,2023-02-12,561.6599999999999,139.57,Incoming
97405607,2023-02-13,417.08999999999986,144.57,Outgoing
97426293,2023-01-31,771.74,,-
97426293,2023-02-03,815.99,44.25,Incoming
97426293,2023-02-08,820.83,4.84,Incoming
97426293,2023-02-10,849.0600000000001,28.23,Incoming
97426293,2023-02-11,965.2,116.14,Incoming
97426293,2023-02-12,1077.83,112.63,Incoming
97426293,2023-02-12,1104.73,26.9,Incoming
97426293,2023-02-14,1184.27,79.54,Incoming
97439311,2023-01-31,196.91,,-
97439311,2023-02-06,122.66,74.25,Outgoing
97439311,2023-02-06,166.25,43.59,Incoming
97439311,2023-02-07,-52.25,218.5,Outgoing
97439311,2023-02-10,-758.15,705.9,Outgoing
97439311,2023-02-13,-756.15,2.0,Incoming
97439311,2023-02-14,-893.0799999999999,136.93,Outgoing
97445899,2023-01-31,195.42,,-
97445899,2023-02-01,669.12,473.7,Incoming
97445899,2023-02-04,574.51,94.61,Outgoing
97445899,2023-02-04,697.63,123.12,Incoming
97445899,2023-02-06,655.09,42.54,Outgoing
97445899,2023-02-08,1342.19,687.1,Incoming
97487639,2023-01-31,403.96,,-
97487639,2023-02-01,293.51,110.45,Outgoing
97487639,2023-02-01,413.48,119.97,Incoming
97487639,2023-02-02,261.89,151.59,Outgoing
97487639,2023-02-03,213.1,48.79,Outgoing
97487639,2023-02-08,56.06,157.04,Outgoing
97487639,2023-02-09,1638.36,1582.3,Incoming
97487639,2023-02-10,1437.3999999999999,200.96,Outgoing
97501557,2023-01-31,572.14,,-
97501557,2023-02-05,424.04999999999995,148.09,Outgoing
97501557,2023-02-08,538.17,114.12,Incoming
97501557,2023-02-10,496.52,41.65,Outgoing
97501557,2023-02-10,583.87,87.35,Incoming
97501557,2023-02-10,439.51,144.36,Outgoing
97501557,2023-02-10,506.49,66.98,Incoming
97521278,2023-01-31,833.78,,-
97521278,2023-02-06,920.73,86.95,Incoming
97521278,2023-02-08,1086.3,165.57,Incoming
97521278,2023-02-10,964.38,121.92,Outgoing
97521278,2023-02-13,1030.47,66.09,Incoming
97521278,2023-02-14,1150.63,120.16,Incoming
97526378,2023-01-31,540.88,,-
97526378,2023-02-02,604.3,63.42,Incoming
97526378,2023-02-03,1373.6,769.3,Incoming
97526378,2023-02-04,1173.1799999999998,200.42,Outgoing
97526378,2023-02-07,1228.4599999999998,55.28,Incoming
97526378,2023-02-12,1318.1599999999999,89.7,Incoming
97541080,2023-01-31,677.34,,-
97541080,2023-02-03,575.1800000000001,102.16,Outgoing
97541080,2023-02-11,2936.7799999999997,2361.6,Incoming
97542348,2023-01-31,768.87,,-
97542348,2023-02-01,671.51,97.36,Outgoing
97542348,2023-02-01,593.5699999999999,77.94,Outgoing
97542348,2023-02-02,560.51,33.06,Outgoing
97542348,2023-02-03,471.13,89.38,Outgoing
97542348,2023-02-05,1368.63,897.5,Incoming
97542348,2023-02-06,1254.3000000000002,114.33,Outgoing
97542348,2023-02-06,1447.3600000000001,193.06,Incoming
97542348,2023-02-14,1634.66,187.3,Incoming
97555037,2023-01-31,405.29,,-
97555037,2023-02-05,264.0,141.29,Outgoing
97555037,2023-02-10,196.93,67.07,Outgoing
97555037,2023-02-14,21.870000000000005,175.06,Outgoing
97555037,2023-02-14,99.27000000000001,77.4,Incoming
97558121,2023-01-31,699.28,,-
97558121,2023-02-05,563.6899999999999,135.59,Outgoing
97558121,2023-02-08,682.76,119.07,Incoming
97558121,2023-02-14,549.85,132.91,Outgoing
97558121,2023-02-14,496.58000000000004,53.27,Outgoing
97558121,2023-02-14,391.47,105.11,Outgoing
97571696,2023-01-31,622.92,,-
97571696,2023-02-01,-738.08,1361.0,Outgoing
97571696,2023-02-08,-753.7900000000001,15.71,Outgoing
97581232,2023-01-31,608.89,,-
97581232,2023-02-07,473.57,135.32,Outgoing
97581232,2023-02-09,-692.8300000000002,1166.4,Outgoing
97581232,2023-02-11,-827.5500000000002,134.72,Outgoing
97581232,2023-02-12,-683.6400000000002,143.91,Incoming
97581232,2023-02-12,-537.4000000000002,146.24,Incoming
97624673,2023-01-31,481.09,,-
97624673,2023-02-07,573.9,92.81,Incoming
97624673,2023-02-08,478.82,95.08,Outgoing
97624673,2023-02-11,348.49,130.33,Outgoing
97624673,2023-02-13,231.82,116.67,Outgoing
97738591,2023-01-31,254.4,,-
97738591,2023-02-09,153.14,101.26,Outgoing
97738591,2023-02-12,241.54999999999998,88.41,Incoming
97738591,2023-02-14,160.39999999999998,81.15,Outgoing
97762952,2023-01-31,411.87,,-
97762952,2023-02-01,450.78,38.91,Incoming
97762952,2023-02-02,466.21999999999997,15.44,Incoming
97762952,2023-02-04,564.16,97.94,Incoming
97762952,2023-02-08,435.88,128.28,Outgoing
97762952,2023-02-09,537.41,101.53,Incoming
97762952,2023-02-11,65.60999999999996,471.8,Outgoing
97762952,2023-02-13,178.90999999999997,113.3,Incoming
97773835,2023-01-31,165.51,,-
97773835,2023-02-03,237.95,72.44,Incoming
97773835,2023-02-09,372.47,134.52,Incoming
97843608,2023-01-31,19.05,,-
97843608,2023-02-03,-330.55,349.6,Outgoing
97843608,2023-02-04,-442.02,111.47,Outgoing
97843608,2023-02-06,-464.19,22.17,Outgoing
97843608,2023-02-12,-568.88,104.69,Outgoing
97843608,2023-02-13,-381.08,187.8,Incoming
97844854,2023-01-31,547.15,,-
97844854,2023-02-02,690.0999999999999,142.95,Incoming
97844854,2023-02-12,823.55,133.45,Incoming
97844854,2023-02-14,915.28,91.73,Incoming
97870414,2023-01-31,818.88,,-
97870414,2023-02-01,979.49,160.61,Incoming
97870414,2023-02-01,1892.99,913.5,Incoming
97870414,2023-02-03,2088.62,195.63,Incoming
97870414,2023-02-06,2463.12,374.5,Incoming
97870414,2023-02-07,2627.99,164.87,Incoming
97870414,2023-02-12,2709.52,81.53,Incoming
97913385,2023-01-31,498.49,,-
97913385,2023-02-01,447.94,50.55,Outgoing
97913385,2023-02-01,349.68,98.26,Outgoing
97913385,2023-02-03,231.82,117.86,Outgoing
97913385,2023-02-05,310.44,78.62,Incoming
97913385,2023-02-08,673.04,362.6,Incoming
97913385,2023-02-10,700.76,27.72,Incoming
97913385,2023-02-10,490.14,210.62,Outgoing
97913385,2023-02-13,415.84,74.3,Outgoing
97935683,2023-01-31,40.96,,-
97935683,2023-02-06,193.12,152.16,Incoming
97935683,2023-02-14,367.0,173.88,Incoming
97939041,2023-01-31,320.97,,-
97939041,2023-02-04,254.8,66.17,Outgoing
97939041,2023-02-06,323.68,68.88,Incoming
97939041,2023-02-11,342.07,18.39,Incoming
97939041,2023-02-11,-450.33,792.4,Outgoing
97939041,2023-02-13,-305.23,145.1,Incoming
97939041,2023-02-13,-385.33000000000004,80.1,Outgoing
97944124,2023-01-31,258.19,,-
97944124,2023-02-14,358.35,100.16,Incoming
97954732,2023-01-31,506.16,,-
97954732,2023-02-04,649.04,142.88,Incoming
97954732,2023-02-11,532.12,116.92,Outgoing
97954732,2023-02-14,377.77,154.35,Outgoing
97970258,2023-01-31,309.14,,-
97970258,2023-02-01,345.02,35.88,Incoming
97970258,2023-02-01,434.16999999999996,89.15,Incoming
97970258,2023-02-03,544.55,110.38,Incoming
97970258,2023-02-08,609.42,64.87,Incoming
97970258,2023-02-11,682.24,72.82,Incoming
97970258,2023-02-12,776.29,94.05,Incoming
97970258,2023-02-13,813.5999999999999,37.31,Incoming
97983552,2023-01-31,584.92,,-
97983552,2023-02-01,-85.18000000000006,670.1,Outgoing
97983552,2023-02-03,129.34999999999994,214.53,Incoming
97983552,2023-02-06,2042.25,1912.9,Incoming
97983552,2023-02-10,2861.25,819.0,Incoming
97985291,2023-01-31,234.19,,-
97985291,2023-02-02,287.19,53.0,Incoming
97985291,2023-02-03,207.68,79.51,Outgoing
97985291,2023-02-05,75.96000000000001,131.72,Outgoing
97985291,2023-02-08,-111.70999999999998,187.67,Outgoing
97985291,2023-02-08,-48.82999999999998,62.88,Incoming
97985291,2023-02-13,74.22000000000003,123.05,Incoming
97988499,2023-01-31,344.28,,-
97988499,2023-02-01,441.65,97.37,Incoming
97988499,2023-02-05,336.7,104.95,Outgoing
97988499,2023-02-06,496.87,160.17,Incoming
97988499,2023-02-08,-529.93,1026.8,Outgoing
97988499,2023-02-12,-431.78,98.15,Incoming
97988499,2023-02-12,-558.8299999999999,127.05,Outgoing
98043237,2023-01-31,491.59,,-
98043237,2023-02-02,590.93,99.34,Incoming
98043237,2023-02-08,745.1299999999999,154.2,Incoming
98043237,2023-02-08,1218.33,473.2,Incoming
98043237,2023-02-13,1293.35,75.02,Incoming
98043237,2023-02-13,1214.4399999999998,78.91,Outgoing
98070849,2023-01-31,993.94,,-
98070849,2023-02-01,1100.74,106.8,Incoming
98070849,2023-02-01,975.6,125.14,Outgoing
98070849,2023-02-01,920.62,54.98,Outgoing
98070849,2023-02-01,780.35,140.27,Outgoing
98070849,2023-02-04,647.4200000000001,132.93,Outgoing
98070849,2023-02-08,205.12000000000006,442.3,Outgoing
98070849,2023-02-08,315.6700000000001,110.55,Incoming
98070849,2023-02-11,218.77000000000007,96.9,Outgoing
98070849,2023-02-11,150.57000000000005,68.2,Outgoing
98070849,2023-02-14,30.110000000000056,120.46,Outgoing
98107200,2023-01-31,325.82,,-
98107200,2023-02-02,185.48,140.34,Outgoing
98107200,2023-02-03,252.38,66.9,Incoming
98107200,2023-02-03,261.40999999999997,9.03,Incoming
98107200,2023-02-10,206.23999999999995,55.17,Outgoing
98112233,2023-01-31,123.26,,-
98112233,2023-02-01,177.76,54.5,Incoming
98112233,2023-02-04,14.72999999999999,163.03,Outgoing
98112233,2023-02-04,-60.22000000000001,74.95,Outgoing
98112233,2023-02-04,-172.10000000000002,111.88,Outgoing
98112233,2023-02-04,-42.73000000000002,129.37,Incoming
98112233,2023-02-05,-189.02,146.29,Outgoing
98112233,2023-02-05,-144.24,44.78,Incoming
98112233,2023-02-06,-219.4,75.16,Outgoing
98112233,2023-02-06,519.9,739.3,Incoming
98112233,2023-02-13,406.49,113.41,Outgoing
98112233,2023-02-13,292.13,114.36,Outgoing
98112233,2023-02-13,393.62,101.49,Incoming
98119030,2023-01-31,179.3,,-
98119030,2023-02-04,130.67000000000002,48.63,Outgoing
98119030,2023-02-04,55.420000000000016,75.25,Outgoing
98119030,2023-02-07,-33.72999999999999,89.15,Outgoing
98119030,2023-02-14,47.640000000000015,81.37,Incoming
98138904,2023-01-31,885.18,,-
98138904,2023-02-08,926.15,40.97,Incoming
98138904,2023-02-10,879.86,46.29,Outgoing
98138904,2023-02-13,1005.9300000000001,126.07,Incoming
98138904,2023-02-14,1124.6200000000001,118.69,Incoming
98156945,2023-01-31,449.81,,-
98156945,2023-02-02,404.59000000000003,45.22,Outgoing
98156945,2023-02-06,-306.61,711.2,Outgoing
98156945,2023-02-07,1260.3899999999999,1567.0,Incoming
98156945,2023-02-08,1109.8899999999999,150.5,Outgoing
98156945,2023-02-12,1065.0099999999998,44.88,Outgoing
98156945,2023-02-14,1004.0899999999998,60.92,Outgoing
98159348,2023-01-31,703.62,,-
98159348,2023-02-02,765.07,61.45,Incoming
98159348,2023-02-04,1268.67,503.6,Incoming
98159348,2023-02-10,1140.6100000000001,128.06,Outgoing
98159348,2023-02-11,1077.6000000000001,63.01,Outgoing
98159348,2023-02-14,985.0100000000001,92.59,Outgoing
98221133,2023-01-31,596.52,,-
98221133,2023-02-01,498.59999999999997,97.92,Outgoing
98221133,2023-02-03,554.23,55.63,Incoming
98221133,2023-02-05,442.69,111.54,Outgoing
98221133,2023-02-06,409.37,33.32,Outgoing
98221133,2023-02-06,438.08,28.71,Incoming
98221133,2023-02-08,-563.9200000000001,1002.0,Outgoing
98221133,2023-02-09,-431.1700000000001,132.75,Incoming
98221133,2023-02-09,-520.6500000000001,89.48,Outgoing
98221133,2023-02-11,36.34999999999991,557.0,Incoming
98221133,2023-02-12,-1.0000000000000924,37.35,Outgoing
98221133,2023-02-12,61.62999999999991,62.63,Incoming
98221133,2023-02-14,20.899999999999913,40.73,Outgoing
98237008,2023-01-31,437.26,,-
98237008,2023-02-02,-428.14,865.4,Outgoing
98237008,2023-02-04,-489.2,61.06,Outgoing
98237008,2023-02-05,-561.73,72.53,Outgoing
98237008,2023-02-08,-623.02,61.29,Outgoing
98237008,2023-02-09,415.48,1038.5,Incoming
98237008,2023-02-12,322.32000000000005,93.16,Outgoing
98237008,2023-02-13,484.37000000000006,162.05,Incoming
98237008,2023-02-13,284.80000000000007,199.57,Outgoing
98336782,2023-01-31,266.46,,-
98336782,2023-02-06,300.65999999999997,34.2,Incoming
98336782,2023-02-06,396.36999999999995,95.71,Incoming
98336782,2023-02-08,503.23999999999995,106.87,Incoming
98336782,2023-02-11,375.14,128.1,Outgoing
98336782,2023-02-13,319.88,55.26,Outgoing
98353764,2023-01-31,763.6,,-
98353764,2023-02-03,943.14,179.54,Incoming
98353764,2023-02-04,1028.34,85.2,Incoming
98353764,2023-02-13,948.2499999999999,80.09,Outgoing
98372749,2023-01-31,136.21,,-
98372749,2023-02-01,5.77000000000001,130.44,Outgoing
98372749,2023-02-01,50.88000000000001,45.11,Incoming
98372749,2023-02-07,152.67000000000002,101.79,Incoming
98372749,2023-02-09,228.13,75.46,Incoming
98372749,2023-02-10,155.51999999999998,72.61,Outgoing
98372749,2023-02-12,200.48999999999998,44.97,Incoming
98377332,2023-01-31,343.09,,-
98377332,2023-02-03,215.64999999999998,127.44,Outgoing
98377332,2023-02-08,-1563.5500000000002,1779.2,Outgoing
98377332,2023-02-14,-1430.64,132.91,Incoming
98459176,2023-01-31,168.19,,-
98459176,2023-02-01,397.99,229.8,Incoming
98459176,2023-02-03,485.43,87.44,Incoming
98459176,2023-02-03,574.01,88.58,Incoming
98459176,2023-02-05,709.89,135.88,Incoming
98459176,2023-02-06,627.14,82.75,Outgoing
98459176,2023-02-07,1364.54,737.4,Incoming
98459176,2023-02-12,1519.71,155.17,Incoming
98459176,2023-02-13,1583.69,63.98,Incoming
98517701,2023-01-31,277.91,,-
98517701,2023-02-07,223.39000000000001,54.52,Outgoing
98517701,2023-02-09,374.53,151.14,Incoming
98568929,2023-01-31,396.03,,-
98568929,2023-02-04,238.34999999999997,157.68,Outgoing
98568929,2023-02-05,98.59999999999997,139.75,Outgoing
98568929,2023-02-09,182.06999999999996,83.47,Incoming
98568929,2023-02-13,-939.23,1121.3,Outgoing
98568929,2023-02-14,-819.75,119.48,Incoming
98575383,2023-01-31,937.72,,-
98575383,2023-02-01,1090.31,152.59,Incoming
98575383,2023-02-03,1100.84,10.53,Incoming
98575383,2023-02-08,1188.1799999999998,87.34,Incoming
98575383,2023-02-09,1212.2999999999997,24.12,Incoming
98575383,2023-02-11,1295.3099999999997,83.01,Incoming
98575383,2023-02-11,1328.6299999999997,33.32,Incoming
98575383,2023-02-11,1428.0499999999997,99.42,Incoming
98575383,2023-02-13,1572.6199999999997,144.57,Incoming
98575383,2023-02-13,1712.3799999999997,139.76,Incoming
98596312,2023-01-31,768.92,,-
98596312,2023-02-03,943.23,174.31,Incoming
98596312,2023-02-06,1101.3400000000001,158.11,Incoming
98596312,2023-02-07,1221.96,120.62,Incoming
98596312,2023-02-09,1133.57,88.39,Outgoing
98596312,2023-02-09,1167.25,33.68,Incoming
98611122,2023-01-31,595.22,,-
98611122,2023-02-01,679.6600000000001,84.44,Incoming
98611122,2023-02-01,667.45,12.21,Outgoing
98611122,2023-02-03,-246.3499999999999,913.8,Outgoing
98611122,2023-02-06,-322.38999999999993,76.04,Outgoing
98611122,2023-02-07,-199.02999999999992,123.36,Incoming
98611122,2023-02-09,-141.83999999999992,57.19,Incoming
98611122,2023-02-09,-268.0399999999999,126.2,Outgoing
98611122,2023-02-13,-97.24999999999991,170.79,Incoming
98611122,2023-02-13,-215.74999999999991,118.5,Outgoing
98611122,2023-02-14,-111.85999999999991,103.89,Incoming
98620342,2023-01-31,976.13,,-
98620342,2023-02-05,-557.37,1533.5,Outgoing
98620342,2023-02-10,-596.85,39.48,Outgoing
98620342,2023-02-12,-688.78,91.93,Outgoing
98620342,2023-02-12,-1695.28,1006.5,Outgoing
98620342,2023-02-14,-1847.97,152.69,Outgoing
98671410,2023-01-31,218.46,,-
98671410,2023-02-01,302.09000000000003,83.63,Incoming
98671410,2023-02-01,347.73,45.64,Incoming
98671410,2023-02-02,252.29000000000002,95.44,Outgoing
98671410,2023-02-02,53.84000000000003,198.45,Outgoing
98671410,2023-02-03,-963.06,1016.9,Outgoing
98671410,2023-02-05,-1053.12,90.06,Outgoing
98671410,2023-02-06,-1020.7499999999999,32.37,Incoming
98671410,2023-02-13,-946.8899999999999,73.86,Incoming
98717357,2023-01-31,183.63,,-
98717357,2023-02-03,335.36,151.73,Incoming
98717357,2023-02-04,1704.96,1369.6,Incoming
98717357,2023-02-06,1756.71,51.75,Incoming
98717357,2023-02-06,1860.71,104.0,Incoming
98776498,2023-01-31,79.4,,-
98821521,2023-01-31,906.51,,-
98821521,2023-02-01,961.22,54.71,Incoming
98821521,2023-02-02,1048.28,87.06,Incoming
98821521,2023-02-07,963.52,84.76,Outgoing
98821521,2023-02-08,1052.08,88.56,Incoming
98821521,2023-02-13,1204.6799999999998,152.6,Incoming
98821521,2023-02-13,1064.6999999999998,139.98,Outgoing
98849007,2023-01-31,58.26,,-
98849007,2023-02-01,53.809999999999995,4.45,Outgoing
98849007,2023-02-11,-49.6,103.41,Outgoing
98849007,2023-02-12,-233.13,183.53,Outgoing
98882065,2023-01-31,630.68,,-
98882065,2023-02-01,706.53,75.85,Incoming
98882065,2023-02-01,613.72,92.81,Outgoing
98882065,2023-02-06,1679.32,1065.6,Incoming
98882065,2023-02-07,1594.51,84.81,Outgoing
98882065,2023-02-07,1719.63,125.12,Incoming
98882065,2023-02-09,1663.3400000000001,56.29,Outgoing
98882065,2023-02-11,1709.18,45.84,Incoming
98882225,2023-01-31,881.65,,-
98882225,2023-02-05,728.06,153.59,Outgoing
98882225,2023-02-05,2440.26,1712.2,Incoming
98882225,2023-02-11,2180.8700000000003,259.39,Outgoing
98882225,2023-02-13,2124.0200000000004,56.85,Outgoing
98886699,2023-01-31,300.31,,-
98886699,2023-02-01,147.45,152.86,Outgoing
98886699,2023-02-04,191.51,44.06,Incoming
98886699,2023-02-04,110.75999999999999,80.75,Outgoing
98886699,2023-02-10,1235.66,1124.9,Incoming
98886699,2023-02-11,1203.6200000000001,32.04,Outgoing
98886699,2023-02-12,1023.1800000000001,180.44,Outgoing
98931016,2023-01-31,561.33,,-
98931016,2023-02-02,491.9200000000001,69.41,Outgoing
98931016,2023-02-02,1247.22,755.3,Incoming
98931016,2023-02-02,1157.42,89.8,Outgoing
98931016,2023-02-10,1061.0800000000002,96.34,Outgoing
98931016,2023-02-14,711.9800000000001,349.1,Outgoing
98940578,2023-01-31,59.28,,-
98940578,2023-02-06,-973.02,1032.3,Outgoing
98940578,2023-02-06,-878.77,94.25,Incoming
98940578,2023-02-07,-978.51,99.74,Outgoing
98940578,2023-02-08,-934.02,44.49,Incoming
99000939,2023-01-31,155.29,,-
99000939,2023-02-04,213.6,58.31,Incoming
99000939,2023-02-06,351.74,138.14,Incoming
99000939,2023-02-07,444.44,92.7,Incoming
99000939,2023-02-07,455.79,11.35,Incoming
99000939,2023-02-09,540.3000000000001,84.51,Incoming
99015119,2023-01-31,443.55,,-
99015119,2023-02-03,-121.65000000000003,565.2,Outgoing
99015119,2023-02-03,-9.19000000000004,112.46,Incoming
99015119,2023-02-05,-58.39000000000004,49.2,Outgoing
99015119,2023-02-06,17.609999999999957,76.0,Incoming
99015119,2023-02-09,-129.51000000000005,147.12,Outgoing
99015119,2023-02-11,-4.2000000000000455,125.31,Incoming
99015119,2023-02-12,14.789999999999953,18.99,Incoming
99244906,2023-01-31,965.33,,-
99244906,2023-02-01,1053.98,88.65,Incoming
99244906,2023-02-02,1002.7,51.28,Outgoing
99244906,2023-02-04,1107.8700000000001,105.17,Incoming
99244906,2023-02-08,1241.6100000000001,133.74,Incoming
99244906,2023-02-10,1292.13,50.52,Incoming
99244906,2023-02-13,1365.0700000000002,72.94,Incoming
99261094,2023-01-31,475.8,,-
99261094,2023-02-01,595.3,119.5,Incoming
99261094,2023-02-04,510.09999999999997,85.2,Outgoing
99261094,2023-02-06,-136.40000000000003,646.5,Outgoing
99261094,2023-02-10,-111.23000000000003,25.17,Incoming
99261094,2023-02-12,-149.56000000000003,38.33,Outgoing
99261094,2023-02-12,-359.54,209.98,Outgoing
99261094,2023-02-14,-247.71000000000004,111.83,Incoming
99261094,2023-02-14,-149.60000000000002,98.11,Incoming
99296816,2023-01-31,814.56,,-
99296816,2023-02-01,1060.6999999999998,246.14,Incoming
99296816,2023-02-02,1694.8999999999999,634.2,Incoming
99296816,2023-02-05,1771.2099999999998,76.31,Incoming
99296816,2023-02-06,1715.12,56.09,Outgoing
99296816,2023-02-06,1792.35,77.23,Incoming
99296816,2023-02-08,1725.75,66.6,Outgoing
99296816,2023-02-10,1547.74,178.01,Outgoing
99296816,2023-02-14,1631.07,83.33,Incoming
99481977,2023-01-31,940.06,,-
99481977,2023-02-01,826.02,114.04,Outgoing
99481977,2023-02-02,-869.48,1695.5,Outgoing
99481977,2023-02-07,939.02,1808.5,Incoming
99481977,2023-02-07,982.3299999999999,43.31,Incoming
99481977,2023-02-09,1071.81,89.48,Incoming
99481977,2023-02-13,1201.09,129.28,Incoming
99481977,2023-02-14,1241.9099999999999,40.82,Incoming
99496896,2023-01-31,431.32,,-
99496896,2023-02-08,365.5,65.82,Outgoing
99514298,2023-01-31,154.78,,-
99514298,2023-02-01,227.92000000000002,73.14,Incoming
99514298,2023-02-02,116.34000000000002,111.58,Outgoing
99514298,2023-02-04,178.59000000000003,62.25,Incoming
99514298,2023-02-05,259.64000000000004,81.05,Incoming
99514298,2023-02-06,335.5400000000001,75.9,Incoming
99514298,2023-02-07,-786.36,1121.9,Outgoing
99514298,2023-02-07,-682.15,104.21,Incoming
99514298,2023-02-10,-534.64,147.51,Incoming
99514298,2023-02-12,-386.47,148.17,Incoming
99514298,2023-02-14,172.32999999999993,558.8,Incoming
99553778,2023-01-31,621.65,,-
99553778,2023-02-04,441.36,180.29,Outgoing
99553778,2023-02-04,582.69,141.33,Incoming
99553778,2023-02-04,477.7800000000001,104.91,Outgoing
99553778,2023-02-04,313.82000000000005,163.96,Outgoing
99553778,2023-02-05,1288.62,974.8,Incoming
99553778,2023-02-10,1190.7199999999998,97.9,Outgoing
99553778,2023-02-12,1254.4099999999999,63.69,Incoming
99553778,2023-02-13,1301.9499999999998,47.54,Incoming
99553778,2023-02-14,1378.2599999999998,76.31,Incoming
99611232,2023-01-31,849.72,,-
99611232,2023-02-01,969.46,119.74,Incoming
99611232,2023-02-04,1087.06,117.6,Incoming
99611232,2023-02-06,1017.2199999999999,69.84,Outgoing
99611232,2023-02-09,1178.4099999999999,161.19,Incoming
99611232,2023-02-10,1216.79,38.38,Incoming
99611232,2023-02-14,1167.24,49.55,Outgoing
99657974,2023-01-31,263.32,,-
99657974,2023-02-01,377.78999999999996,114.47,Incoming
99657974,2023-02-03,535.22,157.43,Incoming
99657974,2023-02-06,533.64,1.58,Outgoing
99657974,2023-02-08,372.65,160.99,Outgoing
99657974,2023-02-09,290.51,82.14,Outgoing
99657974,2023-02-10,233.47,57.04,Outgoing
99657974,2023-02-14,99.05000000000001,134.42,Outgoing
99678854,2023-01-31,664.0,,-
99678854,2023-02-06,535.87,128.13,Outgoing
99678854,2023-02-07,459.52,76.35,Outgoing
99678854,2023-02-07,260.11,199.41,Outgoing
99678854,2023-02-14,148.96,111.15,Outgoing
99685765,2023-01-31,43.01,,-
99685765,2023-02-02,32.91,10.1,Outgoing
99685765,2023-02-04,-58.2,91.11,Outgoing
99685765,2023-02-06,62.39999999999999,120.6,Incoming
99685765,2023-02-08,1020.1999999999999,957.8,Incoming
99685765,2023-02-09,986.03,34.17,Outgoing
99685765,2023-02-10,1084.72,98.69,Incoming
99685765,2023-02-11,-730.28,1815.0,Outgoing
99709741,2023-01-31,98.23,,-
99709741,2023-02-07,85.54,12.69,Outgoing
99709741,2023-02-09,11.720000000000013,73.82,Outgoing
99709741,2023-02-13,150.12,138.4,Incoming
99729369,2023-01-31,751.01,,-
99729369,2023-02-01,1945.41,1194.4,Incoming
99729369,2023-02-02,1821.2,124.21,Outgoing
99729369,2023-02-03,3440.8,1619.6,Incoming
99729369,2023-02-03,3681.0600000000004,240.26,Incoming
99729369,2023-02-04,3553.3800000000006,127.68,Outgoing
99729369,2023-02-06,3643.0100000000007,89.63,Incoming
99729369,2023-02-07,3504.6300000000006,138.38,Outgoing
99729369,2023-02-10,3648.9600000000005,144.33,Incoming
99730589,2023-01-31,988.44,,-
99730589,2023-02-03,930.21,58.23,Outgoing
99730589,2023-02-09,774.87,155.34,Outgoing
99730589,2023-02-10,712.61,62.26,Outgoing
99734848,2023-01-31,354.29,,-
99734848,2023-02-04,-149.31,503.6,Outgoing
99734848,2023-02-12,1193.0900000000001,1342.4,Incoming
99734848,2023-02-14,1272.8500000000001,79.76,Incoming
99760030,2023-01-31,988.0,,-
99760030,2023-02-02,2016.8,1028.8,Incoming
99760030,2023-02-02,1400.1,616.7,Outgoing
99760030,2023-02-07,1573.6499999999999,173.55,Incoming
99760030,2023-02-08,1493.52,80.13,Outgoing
99760030,2023-02-11,1375.17,118.35,Outgoing
99760030,2023-02-12,1514.93,139.76,Incoming
99760030,2023-02-14,1374.8600000000001,140.07,Outgoing
99791709,2023-01-31,15.05,,-
99791709,2023-02-03,104.42999999999999,89.38,Incoming
99791709,2023-02-04,-38.45,142.88,Outgoing
99791709,2023-02-04,-35.59,2.86,Incoming
99791709,2023-02-06,1323.41,1359.0,Incoming
99791709,2023-02-11,1245.0900000000001,78.32,Outgoing
99791709,2023-02-13,444.19000000000017,800.9,Outgoing
99877007,2023-01-31,582.0,,-
99877007,2023-02-01,685.16,103.16,Incoming
99877007,2023-02-02,495.37,189.79,Outgoing
99877007,2023-02-05,567.7,72.33,Incoming
99877007,2023-02-07,413.2900000000001,154.41,Outgoing
99877007,2023-02-11,328.70000000000005,84.59,Outgoing
99937043,2023-01-31,918.42,,-
99937043,2023-02-01,847.1999999999999,71.22,Outgoing
99937043,2023-02-02,989.6499999999999,142.45,Incoming
99937043,2023-02-03,1042.1399999999999,52.49,Incoming
99937043,2023-02-04,919.0199999999999,123.12,Outgoing
99937043,2023-02-05,866.6599999999999,52.36,Outgoing
99937043,2023-02-06,959.0799999999998,92.42,Incoming
99937043,2023-02-09,1081.9899999999998,122.91,Incoming
99937043,2023-02-11,1207.3199999999997,125.33,Incoming
99937043,2023-02-13,1132.1599999999996,75.16,Outgoing
